ğŸ˜€	cara, cara feliz, contento, divertido, sonrisa
ğŸ˜ƒ	boca abierta, cara, divertido, risa, sonrisa, sonrisa con boca abierta
ğŸ˜„	boca abierta, boca y ojos sonrientes, cara, divertido, risa, sonrisa
ğŸ˜	cara, cara y ojos sonrientes, divertido, risa, sonrisa
ğŸ˜†	boca abierta, cara, sonrisa con boca abierta y ojos cerrados
ğŸ˜…	boca abierta, cara, sonrisa, sonrisa boca abierta, sonrisa y sudor frÃ­o, sudor frÃ­o
ğŸ¤£	cara, cara llorando de risa, carcajada, risa, sonrisa
ğŸ˜‚	cara, cara llorando, cara llorando de risa, felicidad, lÃ¡grima, risa
ğŸ™‚	cara, cara sonriendo levemente, leve sonrisa, sonrisa
ğŸ˜‰	cara, cara con guiÃ±o, guiÃ±o
ğŸ˜Š	cara, cara alegre, ojos sonrientes, sonrisa
ğŸ˜‡	aureola, cara, cara sonriendo con aureola, inocente, sonriente con aureola, sonrisa, Ã¡ngel
ğŸ˜˜	besos, cara, cara lanzando un beso, cara manda un beso, corazÃ³n
ğŸ˜—	cara besando, cara dando un beso
â˜ºï¸	cara, relajado, sonriente, sonrisa
ğŸ˜š	beso, beso con ojos cerrados, cara, cerrados, ojos
ğŸ˜™	beso, beso y sonrisa, cara, cara besando con ojos sonrientes, ojos, sonriente
ğŸ˜‹	broma, cara, cara de broma, delicioso, rico, sonriente
ğŸ˜›	broma, cara, cara sacando la lengua, divertido, lengua, sacar, sacar la lengua
ğŸ˜œ	broma, cara, cara sacando la lengua y guiÃ±ando un ojo, divertido, guiÃ±o, lengua, sacar lengua y guiÃ±ar
ğŸ˜	asco, broma, cara, cara con los ojos bien cerrados y sacando la lengua, horrible, lengua, sacar la lengua
ğŸ¤‘	cara, cara con lengua de dinero, dinero, lengua, pensando en dinero
ğŸ¤—	abrazo, cara, cara con manos abrazando
ğŸ¤­	cara con mano sobre la boca, chanfle, uy, vaya
ğŸ¤”	cara, cara pensante, duda, pensar
ğŸ¤	boca, boca cerrada, cara, cara con la boca cerrada con cierre, cierre
ğŸ˜ï¸	cara, indiferente, neutral, neutro
ğŸ˜‘	cara, cara sin expresiÃ³n, inexpresivo, nada
ğŸ˜	cara, cara sonriendo con superioridad, creÃ­do, gesto de superioridad, sarcÃ¡stico, sonrisa
ğŸ˜’	aburrido, cara, cara de desaprobaciÃ³n, enojado
ğŸ™„	cara, cara revoleando los ojos, ojos, revoleando
ğŸ˜¬	cara, cara haciendo una mueca
ğŸ¤¥	cara, cara de mentiroso, mentira, nariz, pinocho
ğŸ˜Œ	aliviado, alivio, cara, cara de alivio
ğŸ˜”	cara, cara desanimada, cara pensativa, deprimido, pensativo, triste
ğŸ˜ª	cara, cara de sueÃ±o, gota, sueÃ±o
ğŸ¤¤	baba, cara, cara babeando
ğŸ˜´	cara, cara durmiendo, dormir, sueÃ±o
ğŸ˜·	barbijo, cara, cara con barbijo, enfermo, resfrÃ­o
ğŸ¤•	cabeza vendada, cara, dolor, herido, vendas
ğŸ¤¢	cara, cara de nÃ¡useas, nÃ¡useas, vÃ³mito
ğŸ¤§	cara, cara de estornudo, estornudar, estornudo, resfrÃ­o
ğŸ˜µ	cara, cara de mareado, mareado
ğŸ˜	cara, cara sonriendo con lentes de sol, lentes, lentes de sol, onda, sol
ğŸ¤“	anteojos, cara, cara de nerd, geek, nerd
ğŸ˜•	cara, cara de confusiÃ³n, confundido, confusiÃ³n, triste
ğŸ˜Ÿ	cara, cara de preocupaciÃ³n, preocupado
ğŸ™	cara, cara con el ceÃ±o ligeramente fruncido, triste
â˜¹ï¸	cara, cara con el ceÃ±o fruncido, triste
ğŸ˜®	abierta, boca, cara, cara con boca abierta, empatÃ­a, sorpresa
ğŸ˜¯	cara, cara estupefacta, sorprendido, sorpresa
ğŸ˜²	asombro, cara, cara asombrada, horrorizado, sorprendido
ğŸ˜¦	abierta, boca, cara, cara boquiabierta
ğŸ˜§	angustiado, cara, cara de angustia, sufrir
ğŸ˜¨	cara, cara de miedo, horror, miedo, temor, terror
ğŸ˜°	abierta, boca, cara con ansiedad y sudor, en aprietos, frÃ­o, miedo, sudor, temor
ğŸ˜¥	aliviado, alivio, cara, cara triste pero aliviada, decepcionado, decepciÃ³n, sudor
ğŸ˜¢	cara, cara con llanto, llanto, llorar, triste, tristeza
ğŸ˜­	cara, cara llorando fuerte, llorar, lÃ¡grimas
ğŸ˜±	cara, cara de terror, grito, horror, miedo, terror
ğŸ˜–	cara, cara de frustraciÃ³n, enojo, frustraciÃ³n, tristeza
ğŸ˜£	cara, cara perseverante, equivocado, me equivoquÃ©, perdÃ³n, perseverar
ğŸ˜	cara, cara de decepciÃ³n, decepcionado, decepciÃ³n
ğŸ˜©	agotado, cansado, cara, cara de cansancio, exhausto
ğŸ˜«	agotado, cansado, cara, cara cansada, cara de exhausto, exhausto
ğŸ˜¤	cara, ganÃ©, mirada de triunfo, triunfo, victoria
ğŸ˜¡	cara, cara de odio, enojado, enojo, ira, odio, rojo
ğŸ˜ 	cara, cara de enojado, enojado, enojo
ğŸ˜ˆ	cara, cuernos, diablo, pÃ­caro, sonriente con cuernos, sonrisa
ğŸ‘¿	cara, diablo, fantasÃ­a, granuja
ğŸ’€	calavera, cara, crÃ¡neo, miedo, monstruo, muerte
â˜ ï¸	calavera, cara, huesos
ğŸ’©	caca, cara, estiÃ©rcol, gracioso
ğŸ‘¹	cara, cara de ogro japonÃ©s, cuento, fantasÃ­a, japonÃ©s, ogro, oni
ğŸ‘º	cara, cara de demonio japonÃ©s, cuento, demonio, japonÃ©s, tengu
ğŸ‘»	cuento, fantasma, fantasÃ­a, monstruo
ğŸ‘½ï¸	OVNI, alien, cara, cuento, espacial, espacio, extraterrestre, fantasÃ­a, monstruo
ğŸ‘¾	OVNI, alien, cara, cuento, espacial, espacio, extraterrestre, fantasÃ­a, monstruo, monstruo extraterrestre
ğŸ˜º	abierta, boca, cara, gato, gato sonriente
ğŸ˜¸	cara, gato, gato llorando de risa, gato sonriendo con ojos sonrientes, sonriente, sonrisa
ğŸ˜¹	alegrÃ­a, cara, gato, gato llorando de risa, llorando, lÃ¡grimas
ğŸ˜»	amor, cara, corazones, gato, gato sonriente con corazones
ğŸ˜¼	cara, gato, gato sarcÃ¡stico, irÃ³nico, sarcÃ¡stico, sonrisa
ğŸ˜½	beso, cara, cerrados, gato, gato mandando un beso, ojos
ğŸ™€	cara de gato asustado, gato asustado
ğŸ˜¿	cara de gato llorando, gato llorando
ğŸ˜¾	cara de gato enfadado
ğŸ™ˆ	cara, mono, mono con ojos tapados, no, ojos, tapados, ver
ğŸ™‰	cara, mono, mono con orejas tapadas, no, orejas, oÃ­r, tapadas
ğŸ™Š	boca, callado, cara, hablar, mono, mono con boca tapada, no, secreto, silencio, tapada
ğŸ’Œ	carta, carta de amor, corazÃ³n, romance, sobre con corazÃ³n
ğŸ’	amor, corazÃ³n, corazÃ³n con moÃ±o, emociÃ³n, moÃ±o
ğŸ’—	amor, corazÃ³n, corazÃ³n que crece, emociÃ³n, entusiasmado, nervioso
ğŸ’“	amor, corazÃ³n, corazÃ³n que palpita, emociÃ³n, latidos, palpitar
ğŸ’	amor, corazones que giran, corazÃ³n, emociÃ³n, girar, vueltas
ğŸ’•	amor, corazÃ³n, dos corazones, enamorado
ğŸ’Ÿ	corazÃ³n, corazÃ³n de decoraciÃ³n
â£ï¸	corazÃ³n, exclamaciÃ³n, exclamaciÃ³n con forma de corazÃ³n
ğŸ’”	corazÃ³n roto
â¤ï¸	corazÃ³n rojo
ğŸ’›	corazÃ³n amarillo
ğŸ’š	corazÃ³n verde
ğŸ’™	corazÃ³n azul
ğŸ’œ	corazÃ³n morado
ğŸ’¯	100 puntos
ğŸ’¢	cÃ³mics, emociÃ³n, enojo, seÃ±al de enojo
ğŸ’¥	choque, colisiÃ³n, cÃ³mic, emociÃ³n, explosiÃ³n
ğŸ’«	cÃ³mic, emociÃ³n, estrellas, mareado, mareo, ver
ğŸ’¦	cÃ³mics, emociÃ³n, gotas de sudor, sudar
ğŸ’¬	burbuja, cÃ³mic, diÃ¡logo, globo, globo de diÃ¡logo, hablar
ğŸ‘â€ğŸ—¨	bocadillo de texto, ojo, ojo en una burbuja de texto, testigo
ğŸ—¨ï¸	burbuja, cÃ³mic, diÃ¡logo, globo, globo de diÃ¡logo izquierdo, izquierdo
ğŸ—¯ï¸	burbuja, cÃ³mic, derecho, enojado, enojo, globo, globo de enojo derecho
ğŸ’­	burbuja, cÃ³mic, globo, globo de pensamiento, pensamiento, pensar
ğŸ’¤	cÃ³mics, dormido, emociÃ³n, estar durmiendo, roncar, sÃ­mbolo de sueÃ±o
ğŸ¤š	mano, palma, palma de la mano
ğŸ¤šğŸ»	mano, palma, palma de la mano, palma de la mano: tono de piel claro, tono de piel claro
ğŸ¤šğŸ¼	mano, palma, palma de la mano, palma de la mano: tono de piel claro medio, tono de piel claro medio
ğŸ¤šğŸ½	mano, palma, palma de la mano, palma de la mano: tono de piel medio, tono de piel medio
ğŸ¤šğŸ¾	mano, palma, palma de la mano, palma de la mano: tono de piel oscuro medio, tono de piel oscuro medio
ğŸ¤šğŸ¿	mano, palma, palma de la mano, palma de la mano: tono de piel oscuro, tono de piel oscuro
ğŸ–ï¸	abierta, dedos, mano, palma, yo
ğŸ–ğŸ»	abierta, dedos, mano, palma, tono de piel claro, yo
ğŸ–ğŸ¼	abierta, dedos, mano, palma, tono de piel claro medio, yo
ğŸ–ğŸ½	abierta, dedos, mano, palma, tono de piel medio, yo
ğŸ–ğŸ¾	abierta, dedos, mano, palma, tono de piel oscuro medio, yo
ğŸ–ğŸ¿	abierta, dedos, mano, palma, tono de piel oscuro, yo
âœ‹	abierta, mano, mano levantada, palma, papel
âœ‹ğŸ»	abierta, mano, mano levantada, palma, papel, tono de piel claro
âœ‹ğŸ¼	abierta, mano, mano levantada, palma, papel, tono de piel claro medio
âœ‹ğŸ½	abierta, mano, mano levantada, palma, papel, tono de piel medio
âœ‹ğŸ¾	abierta, mano, mano levantada, palma, papel, tono de piel oscuro medio
âœ‹ğŸ¿	abierta, mano, mano levantada, palma, papel, tono de piel oscuro
ğŸ––	dedos, mano, saludo, spock, star, trek, vulcano
ğŸ––ğŸ»	dedos, mano, saludo, spock, star, tono de piel claro, trek, vulcano
ğŸ––ğŸ¼	dedos, mano, saludo, spock, star, tono de piel claro medio, trek, vulcano
ğŸ––ğŸ½	dedos, mano, saludo, spock, star, tono de piel medio, trek, vulcano
ğŸ––ğŸ¾	dedos, mano, saludo, spock, star, tono de piel oscuro medio, trek, vulcano
ğŸ––ğŸ¿	dedos, mano, saludo, spock, star, tono de piel oscuro, trek, vulcano
ğŸ‘Œ	gesto, mano, ok, seÃ±al de OK
ğŸ‘ŒğŸ»	gesto, mano, ok, seÃ±al de OK, seÃ±al de OK: tono de piel claro, tono de piel claro
ğŸ‘ŒğŸ¼	gesto, mano, ok, seÃ±al de OK, seÃ±al de OK: tono de piel claro medio, tono de piel claro medio
ğŸ‘ŒğŸ½	gesto, mano, ok, seÃ±al de OK, seÃ±al de OK: tono de piel medio, tono de piel medio
ğŸ‘ŒğŸ¾	gesto, mano, ok, seÃ±al de OK, seÃ±al de OK: tono de piel oscuro medio, tono de piel oscuro medio
ğŸ‘ŒğŸ¿	gesto, mano, ok, seÃ±al de OK, seÃ±al de OK: tono de piel oscuro, tono de piel oscuro
âœŒï¸	V, dedos, gesto de victoria, mano, tijera, victoria
âœŒğŸ»	V, dedos, gesto de victoria, gesto de victoria: tono de piel claro, mano, tijera, tono de piel claro, victoria
âœŒğŸ¼	V, dedos, gesto de victoria, gesto de victoria: tono de piel claro medio, mano, tijera, tono de piel claro medio, victoria
âœŒğŸ½	V, dedos, gesto de victoria, gesto de victoria: tono de piel medio, mano, tijera, tono de piel medio, victoria
âœŒğŸ¾	V, dedos, gesto de victoria, gesto de victoria: tono de piel oscuro medio, mano, tijera, tono de piel oscuro medio, victoria
âœŒğŸ¿	V, dedos, gesto de victoria, gesto de victoria: tono de piel oscuro, mano, tijera, tono de piel oscuro, victoria
ğŸ¤˜	cuernos, dedos, gesto de cuernos, mano, rock, roll
ğŸ¤˜ğŸ»	cuernos, dedos, gesto de cuernos, gesto de cuernos: tono de piel claro, mano, rock, roll, tono de piel claro
ğŸ¤˜ğŸ¼	cuernos, dedos, gesto de cuernos, gesto de cuernos: tono de piel claro medio, mano, rock, roll, tono de piel claro medio
ğŸ¤˜ğŸ½	cuernos, dedos, gesto de cuernos, gesto de cuernos: tono de piel medio, mano, rock, roll, tono de piel medio
ğŸ¤˜ğŸ¾	cuernos, dedos, gesto de cuernos, gesto de cuernos: tono de piel oscuro medio, mano, rock, roll, tono de piel oscuro medio
ğŸ¤˜ğŸ¿	cuernos, dedos, gesto de cuernos, gesto de cuernos: tono de piel oscuro, mano, rock, roll, tono de piel oscuro
ğŸ¤™	gesto, gesto de llamada, llamada, mano
ğŸ¤™ğŸ»	gesto, gesto de llamada, gesto de llamada: tono de piel claro, llamada, mano, tono de piel claro
ğŸ¤™ğŸ¼	gesto, gesto de llamada, gesto de llamada: tono de piel claro medio, llamada, mano, tono de piel claro medio
ğŸ¤™ğŸ½	gesto, gesto de llamada, gesto de llamada: tono de piel medio, llamada, mano, tono de piel medio
ğŸ¤™ğŸ¾	gesto, gesto de llamada, gesto de llamada: tono de piel oscuro medio, llamada, mano, tono de piel oscuro medio
ğŸ¤™ğŸ¿	gesto, gesto de llamada, gesto de llamada: tono de piel oscuro, llamada, mano, tono de piel oscuro
ğŸ‘ˆï¸	apuntar, dedo, dorso, dorso de mano con Ã­ndice a la izquierda, izquierda, mano, seÃ±alar, Ã­ndice, Ã­ndice hacia la izquierda
ğŸ‘ˆğŸ»	apuntar, dedo, dorso, dorso de mano con Ã­ndice a la izquierda, izquierda, mano, seÃ±alar, tono de piel claro, Ã­ndice, Ã­ndice hacia la izquierda
ğŸ‘ˆğŸ¼	apuntar, dedo, dorso, dorso de mano con Ã­ndice a la izquierda, izquierda, mano, seÃ±alar, tono de piel claro medio, Ã­ndice, Ã­ndice hacia la izquierda
ğŸ‘ˆğŸ½	apuntar, dedo, dorso, dorso de mano con Ã­ndice a la izquierda, izquierda, mano, seÃ±alar, tono de piel medio, Ã­ndice, Ã­ndice hacia la izquierda
ğŸ‘ˆğŸ¾	apuntar, dedo, dorso, dorso de mano con Ã­ndice a la izquierda, izquierda, mano, seÃ±alar, tono de piel oscuro medio, Ã­ndice, Ã­ndice hacia la izquierda
ğŸ‘ˆğŸ¿	apuntar, dedo, dorso, dorso de mano con Ã­ndice a la izquierda, izquierda, mano, seÃ±alar, tono de piel oscuro, Ã­ndice, Ã­ndice hacia la izquierda
ğŸ‘†ï¸	apuntar, arriba, dedo, dorso de mano con dedo Ã­ndice hacia arriba, dorso de mano con Ã­ndice hacia arriba, mano
ğŸ‘†ğŸ»	apuntar, arriba, dedo, dorso de mano con dedo Ã­ndice hacia arriba, dorso de mano con dedo Ã­ndice hacia arriba: tono de piel claro, dorso de mano con Ã­ndice hacia arriba, mano, tono de piel claro
ğŸ‘†ğŸ¼	apuntar, arriba, dedo, dorso de mano con dedo Ã­ndice hacia arriba, dorso de mano con dedo Ã­ndice hacia arriba: tono de piel claro medio, dorso de mano con Ã­ndice hacia arriba, mano, tono de piel claro medio
ğŸ‘†ğŸ½	apuntar, arriba, dedo, dorso de mano con dedo Ã­ndice hacia arriba, dorso de mano con dedo Ã­ndice hacia arriba: tono de piel medio, dorso de mano con Ã­ndice hacia arriba, mano, tono de piel medio
ğŸ‘†ğŸ¾	apuntar, arriba, dedo, dorso de mano con dedo Ã­ndice hacia arriba, dorso de mano con dedo Ã­ndice hacia arriba: tono de piel oscuro medio, dorso de mano con Ã­ndice hacia arriba, mano, tono de piel oscuro medio
ğŸ‘†ğŸ¿	apuntar, arriba, dedo, dorso de mano con dedo Ã­ndice hacia arriba, dorso de mano con dedo Ã­ndice hacia arriba: tono de piel oscuro, dorso de mano con Ã­ndice hacia arriba, mano, tono de piel oscuro
ğŸ–•	dedo, dorso de mano con dedo medio hacia arriba, insulto, mano, medio
ğŸ–•ğŸ»	dedo, dorso de mano con dedo medio hacia arriba, dorso de mano con dedo medio hacia arriba: tono de piel claro, insulto, mano, medio, tono de piel claro
ğŸ–•ğŸ¼	dedo, dorso de mano con dedo medio hacia arriba, dorso de mano con dedo medio hacia arriba: tono de piel claro medio, insulto, mano, medio, tono de piel claro medio
ğŸ–•ğŸ½	dedo, dorso de mano con dedo medio hacia arriba, dorso de mano con dedo medio hacia arriba: tono de piel medio, insulto, mano, medio, tono de piel medio
ğŸ–•ğŸ¾	dedo, dorso de mano con dedo medio hacia arriba, dorso de mano con dedo medio hacia arriba: tono de piel oscuro medio, insulto, mano, medio, tono de piel oscuro medio
ğŸ–•ğŸ¿	dedo, dorso de mano con dedo medio hacia arriba, dorso de mano con dedo medio hacia arriba: tono de piel oscuro, insulto, mano, medio, tono de piel oscuro
ğŸ‘‡ï¸	dorso de mano con dedo Ã­ndice hacia abajo
ğŸ‘‡ğŸ»	dorso de mano con dedo Ã­ndice hacia abajo, dorso de mano con dedo Ã­ndice hacia abajo: tono de piel claro, tono de piel claro
ğŸ‘‡ğŸ¼	dorso de mano con dedo Ã­ndice hacia abajo, dorso de mano con dedo Ã­ndice hacia abajo: tono de piel claro medio, tono de piel claro medio
ğŸ‘‡ğŸ½	dorso de mano con dedo Ã­ndice hacia abajo, dorso de mano con dedo Ã­ndice hacia abajo: tono de piel medio, tono de piel medio
ğŸ‘‡ğŸ¾	dorso de mano con dedo Ã­ndice hacia abajo, dorso de mano con dedo Ã­ndice hacia abajo: tono de piel oscuro medio, tono de piel oscuro medio
ğŸ‘‡ğŸ¿	dorso de mano con dedo Ã­ndice hacia abajo, dorso de mano con dedo Ã­ndice hacia abajo: tono de piel oscuro, tono de piel oscuro
â˜ï¸	apuntar, arriba, dedo, dedo hacia arriba, dedo Ã­ndice hacia arriba, mano, palma, seÃ±alar, Ã­ndice
â˜ğŸ»	apuntar, arriba, dedo, dedo hacia arriba, dedo Ã­ndice hacia arriba, mano, palma, seÃ±alar, tono de piel claro, Ã­ndice
â˜ğŸ¼	apuntar, arriba, dedo, dedo hacia arriba, dedo Ã­ndice hacia arriba, mano, palma, seÃ±alar, tono de piel claro medio, Ã­ndice
â˜ğŸ½	apuntar, arriba, dedo, dedo hacia arriba, dedo Ã­ndice hacia arriba, mano, palma, seÃ±alar, tono de piel medio, Ã­ndice
â˜ğŸ¾	apuntar, arriba, dedo, dedo hacia arriba, dedo Ã­ndice hacia arriba, mano, palma, seÃ±alar, tono de piel oscuro medio, Ã­ndice
â˜ğŸ¿	apuntar, arriba, dedo, dedo hacia arriba, dedo Ã­ndice hacia arriba, mano, palma, seÃ±alar, tono de piel oscuro, Ã­ndice
ğŸ‘ï¸	+1, arriba, mano, pulgar, pulgar hacia arriba
ğŸ‘ğŸ»	+1, arriba, mano, pulgar, pulgar hacia arriba, tono de piel claro
ğŸ‘ğŸ¼	+1, arriba, mano, pulgar, pulgar hacia arriba, tono de piel claro medio
ğŸ‘ğŸ½	+1, arriba, mano, pulgar, pulgar hacia arriba, tono de piel medio
ğŸ‘ğŸ¾	+1, arriba, mano, pulgar, pulgar hacia arriba, tono de piel oscuro medio
ğŸ‘ğŸ¿	+1, arriba, mano, pulgar, pulgar hacia arriba, tono de piel oscuro
ğŸ‘ï¸	-1, abajo, mano, pulgar, pulgar hacia abajo
ğŸ‘ğŸ»	-1, abajo, mano, pulgar, pulgar hacia abajo, tono de piel claro
ğŸ‘ğŸ¼	-1, abajo, mano, pulgar, pulgar hacia abajo, tono de piel claro medio
ğŸ‘ğŸ½	-1, abajo, mano, pulgar, pulgar hacia abajo, tono de piel medio
ğŸ‘ğŸ¾	-1, abajo, mano, pulgar, pulgar hacia abajo, tono de piel oscuro medio
ğŸ‘ğŸ¿	-1, abajo, mano, pulgar, pulgar hacia abajo, tono de piel oscuro
âœŠ	cerrada, mano, piedra, puÃ±o, puÃ±o levantado
âœŠğŸ»	cerrada, mano, piedra, puÃ±o, puÃ±o levantado, puÃ±o levantado: tono de piel claro, tono de piel claro
âœŠğŸ¼	cerrada, mano, piedra, puÃ±o, puÃ±o levantado, puÃ±o levantado: tono de piel claro medio, tono de piel claro medio
âœŠğŸ½	cerrada, mano, piedra, puÃ±o, puÃ±o levantado, puÃ±o levantado: tono de piel medio, tono de piel medio
âœŠğŸ¾	cerrada, mano, piedra, puÃ±o, puÃ±o levantado, puÃ±o levantado: tono de piel oscuro medio, tono de piel oscuro medio
âœŠğŸ¿	cerrada, mano, piedra, puÃ±o, puÃ±o levantado, puÃ±o levantado: tono de piel oscuro, tono de piel oscuro
ğŸ¤›	izquierda, puÃ±o, puÃ±o a la izquierda
ğŸ¤›ğŸ»	izquierda, puÃ±o, puÃ±o a la izquierda, puÃ±o a la izquierda: tono de piel claro, tono de piel claro
ğŸ¤›ğŸ¼	izquierda, puÃ±o, puÃ±o a la izquierda, puÃ±o a la izquierda: tono de piel claro medio, tono de piel claro medio
ğŸ¤›ğŸ½	izquierda, puÃ±o, puÃ±o a la izquierda, puÃ±o a la izquierda: tono de piel medio, tono de piel medio
ğŸ¤›ğŸ¾	izquierda, puÃ±o, puÃ±o a la izquierda, puÃ±o a la izquierda: tono de piel oscuro medio, tono de piel oscuro medio
ğŸ¤›ğŸ¿	izquierda, puÃ±o, puÃ±o a la izquierda, puÃ±o a la izquierda: tono de piel oscuro, tono de piel oscuro
ğŸ¤œ	derecha, puÃ±o, puÃ±o a la derecha
ğŸ¤œğŸ»	derecha, puÃ±o, puÃ±o a la derecha, puÃ±o a la derecha: tono de piel claro, tono de piel claro
ğŸ¤œğŸ¼	derecha, puÃ±o, puÃ±o a la derecha, puÃ±o a la derecha: tono de piel claro medio, tono de piel claro medio
ğŸ¤œğŸ½	derecha, puÃ±o, puÃ±o a la derecha, puÃ±o a la derecha: tono de piel medio, tono de piel medio
ğŸ¤œğŸ¾	derecha, puÃ±o, puÃ±o a la derecha, puÃ±o a la derecha: tono de piel oscuro medio, tono de piel oscuro medio
ğŸ¤œğŸ¿	derecha, puÃ±o, puÃ±o a la derecha, puÃ±o a la derecha: tono de piel oscuro, tono de piel oscuro
ğŸ™Œ	celebrar, chocar, chocar las manos, cinco, festejo, manos
ğŸ™ŒğŸ»	celebrar, chocar, chocar las manos, chocar las manos: tono de piel claro, cinco, festejo, manos, tono de piel claro
ğŸ™ŒğŸ¼	celebrar, chocar, chocar las manos, chocar las manos: tono de piel claro medio, cinco, festejo, manos, tono de piel claro medio
ğŸ™ŒğŸ½	celebrar, chocar, chocar las manos, chocar las manos: tono de piel medio, cinco, festejo, manos, tono de piel medio
ğŸ™ŒğŸ¾	celebrar, chocar, chocar las manos, chocar las manos: tono de piel oscuro medio, cinco, festejo, manos, tono de piel oscuro medio
ğŸ™ŒğŸ¿	celebrar, chocar, chocar las manos, chocar las manos: tono de piel oscuro, cinco, festejo, manos, tono de piel oscuro
ğŸ‘	abiertas, gesto, manos
ğŸ‘ğŸ»	abiertas, gesto, manos, tono de piel claro
ğŸ‘ğŸ¼	abiertas, gesto, manos, tono de piel claro medio
ğŸ‘ğŸ½	abiertas, gesto, manos, tono de piel medio
ğŸ‘ğŸ¾	abiertas, gesto, manos, tono de piel oscuro medio
ğŸ‘ğŸ¿	abiertas, gesto, manos, tono de piel oscuro
ğŸ¤	acuerdo, apretÃ³n, apretÃ³n de manos, manos, reuniÃ³n
ğŸ™	favor, gracias, manos, manos en oraciÃ³n, oraciÃ³n, orar, por, rezar, rezo
ğŸ™ğŸ»	favor, gracias, manos, manos en oraciÃ³n, oraciÃ³n, orar, por, rezar, rezo, tono de piel claro
ğŸ™ğŸ¼	favor, gracias, manos, manos en oraciÃ³n, oraciÃ³n, orar, por, rezar, rezo, tono de piel claro medio
ğŸ™ğŸ½	favor, gracias, manos, manos en oraciÃ³n, oraciÃ³n, orar, por, rezar, rezo, tono de piel medio
ğŸ™ğŸ¾	favor, gracias, manos, manos en oraciÃ³n, oraciÃ³n, orar, por, rezar, rezo, tono de piel oscuro medio
ğŸ™ğŸ¿	favor, gracias, manos, manos en oraciÃ³n, oraciÃ³n, orar, por, rezar, rezo, tono de piel oscuro
ğŸ¤³	autofoto, cÃ¡mara, selfie, telÃ©fono
ğŸ¤³ğŸ»	autofoto, cÃ¡mara, selfie, selfie: tono de piel claro, telÃ©fono, tono de piel claro
ğŸ¤³ğŸ¼	autofoto, cÃ¡mara, selfie, selfie: tono de piel claro medio, telÃ©fono, tono de piel claro medio
ğŸ¤³ğŸ½	autofoto, cÃ¡mara, selfie, selfie: tono de piel medio, telÃ©fono, tono de piel medio
ğŸ¤³ğŸ¾	autofoto, cÃ¡mara, selfie, selfie: tono de piel oscuro medio, telÃ©fono, tono de piel oscuro medio
ğŸ¤³ğŸ¿	autofoto, cÃ¡mara, selfie, selfie: tono de piel oscuro, telÃ©fono, tono de piel oscuro
ğŸ‘¶	bebÃ©, cara, persona
ğŸ‘¶ğŸ»	bebÃ©, cara, persona, tono de piel claro
ğŸ‘¶ğŸ¼	bebÃ©, cara, persona, tono de piel claro medio
ğŸ‘¶ğŸ½	bebÃ©, cara, persona, tono de piel medio
ğŸ‘¶ğŸ¾	bebÃ©, cara, persona, tono de piel oscuro medio
ğŸ‘¶ğŸ¿	bebÃ©, cara, persona, tono de piel oscuro
ğŸ‘¦	cara, chico, joven, nene, niÃ±o, persona
ğŸ‘¦ğŸ»	cara, chico, joven, nene, niÃ±o, persona, tono de piel claro
ğŸ‘¦ğŸ¼	cara, chico, joven, nene, niÃ±o, persona, tono de piel claro medio
ğŸ‘¦ğŸ½	cara, chico, joven, nene, niÃ±o, persona, tono de piel medio
ğŸ‘¦ğŸ¾	cara, chico, joven, nene, niÃ±o, persona, tono de piel oscuro medio
ğŸ‘¦ğŸ¿	cara, chico, joven, nene, niÃ±o, persona, tono de piel oscuro
ğŸ‘±	cara, persona, persona adulta rubia, rubio
ğŸ‘±ğŸ»	cara, persona, persona adulta rubia, rubio, tono de piel claro
ğŸ‘±ğŸ¼	cara, persona, persona adulta rubia, rubio, tono de piel claro medio
ğŸ‘±ğŸ½	cara, persona, persona adulta rubia, rubio, tono de piel medio
ğŸ‘±ğŸ¾	cara, persona, persona adulta rubia, rubio, tono de piel oscuro medio
ğŸ‘±ğŸ¿	cara, persona, persona adulta rubia, rubio, tono de piel oscuro
ğŸ‘¨	cara, hombre, persona, seÃ±or
ğŸ‘¨ğŸ»	cara, hombre, persona, seÃ±or, tono de piel claro
ğŸ‘¨ğŸ¼	cara, hombre, persona, seÃ±or, tono de piel claro medio
ğŸ‘¨ğŸ½	cara, hombre, persona, seÃ±or, tono de piel medio
ğŸ‘¨ğŸ¾	cara, hombre, persona, seÃ±or, tono de piel oscuro medio
ğŸ‘¨ğŸ¿	cara, hombre, persona, seÃ±or, tono de piel oscuro
ğŸ‘¨â€ğŸ¦°	cara, hombre, pelo pelirrojo, persona, seÃ±or
ğŸ‘¨ğŸ»â€ğŸ¦°	cara, hombre, pelo pelirrojo, persona, seÃ±or, tono de piel claro
ğŸ‘¨ğŸ¼â€ğŸ¦°	cara, hombre, pelo pelirrojo, persona, seÃ±or, tono de piel claro medio
ğŸ‘¨ğŸ½â€ğŸ¦°	cara, hombre, pelo pelirrojo, persona, seÃ±or, tono de piel medio
ğŸ‘¨ğŸ¾â€ğŸ¦°	cara, hombre, pelo pelirrojo, persona, seÃ±or, tono de piel oscuro medio
ğŸ‘¨ğŸ¿â€ğŸ¦°	cara, hombre, pelo pelirrojo, persona, seÃ±or, tono de piel oscuro
ğŸ‘¨â€ğŸ¦±	cara, hombre, pelo rizado, persona, seÃ±or
ğŸ‘¨ğŸ»â€ğŸ¦±	cara, hombre, pelo rizado, persona, seÃ±or, tono de piel claro
ğŸ‘¨ğŸ¼â€ğŸ¦±	cara, hombre, pelo rizado, persona, seÃ±or, tono de piel claro medio
ğŸ‘¨ğŸ½â€ğŸ¦±	cara, hombre, pelo rizado, persona, seÃ±or, tono de piel medio
ğŸ‘¨ğŸ¾â€ğŸ¦±	cara, hombre, pelo rizado, persona, seÃ±or, tono de piel oscuro medio
ğŸ‘¨ğŸ¿â€ğŸ¦±	cara, hombre, pelo rizado, persona, seÃ±or, tono de piel oscuro
ğŸ‘¨â€ğŸ¦³	cara, hombre, pelo blanco, persona, seÃ±or
ğŸ‘¨ğŸ»â€ğŸ¦³	cara, hombre, pelo blanco, persona, seÃ±or, tono de piel claro
ğŸ‘¨ğŸ¼â€ğŸ¦³	cara, hombre, pelo blanco, persona, seÃ±or, tono de piel claro medio
ğŸ‘¨ğŸ½â€ğŸ¦³	cara, hombre, pelo blanco, persona, seÃ±or, tono de piel medio
ğŸ‘¨ğŸ¾â€ğŸ¦³	cara, hombre, pelo blanco, persona, seÃ±or, tono de piel oscuro medio
ğŸ‘¨ğŸ¿â€ğŸ¦³	cara, hombre, pelo blanco, persona, seÃ±or, tono de piel oscuro
ğŸ‘¨â€ğŸ¦²	cara, hombre, persona, seÃ±or, sin pelo
ğŸ‘¨ğŸ»â€ğŸ¦²	cara, hombre, persona, seÃ±or, sin pelo, tono de piel claro
ğŸ‘¨ğŸ¼â€ğŸ¦²	cara, hombre, persona, seÃ±or, sin pelo, tono de piel claro medio
ğŸ‘¨ğŸ½â€ğŸ¦²	cara, hombre, persona, seÃ±or, sin pelo, tono de piel medio
ğŸ‘¨ğŸ¾â€ğŸ¦²	cara, hombre, persona, seÃ±or, sin pelo, tono de piel oscuro medio
ğŸ‘¨ğŸ¿â€ğŸ¦²	cara, hombre, persona, seÃ±or, sin pelo, tono de piel oscuro
ğŸ‘©	cara, mujer, persona, seÃ±ora
ğŸ‘©ğŸ»	cara, mujer, persona, seÃ±ora, tono de piel claro
ğŸ‘©ğŸ¼	cara, mujer, persona, seÃ±ora, tono de piel claro medio
ğŸ‘©ğŸ½	cara, mujer, persona, seÃ±ora, tono de piel medio
ğŸ‘©ğŸ¾	cara, mujer, persona, seÃ±ora, tono de piel oscuro medio
ğŸ‘©ğŸ¿	cara, mujer, persona, seÃ±ora, tono de piel oscuro
ğŸ‘©â€ğŸ¦°	cara, mujer, pelo pelirrojo, persona, seÃ±ora
ğŸ‘©ğŸ»â€ğŸ¦°	cara, mujer, pelo pelirrojo, persona, seÃ±ora, tono de piel claro
ğŸ‘©ğŸ¼â€ğŸ¦°	cara, mujer, pelo pelirrojo, persona, seÃ±ora, tono de piel claro medio
ğŸ‘©ğŸ½â€ğŸ¦°	cara, mujer, pelo pelirrojo, persona, seÃ±ora, tono de piel medio
ğŸ‘©ğŸ¾â€ğŸ¦°	cara, mujer, pelo pelirrojo, persona, seÃ±ora, tono de piel oscuro medio
ğŸ‘©ğŸ¿â€ğŸ¦°	cara, mujer, pelo pelirrojo, persona, seÃ±ora, tono de piel oscuro
ğŸ‘©â€ğŸ¦±	cara, mujer, pelo rizado, persona, seÃ±ora
ğŸ‘©ğŸ»â€ğŸ¦±	cara, mujer, pelo rizado, persona, seÃ±ora, tono de piel claro
ğŸ‘©ğŸ¼â€ğŸ¦±	cara, mujer, pelo rizado, persona, seÃ±ora, tono de piel claro medio
ğŸ‘©ğŸ½â€ğŸ¦±	cara, mujer, pelo rizado, persona, seÃ±ora, tono de piel medio
ğŸ‘©ğŸ¾â€ğŸ¦±	cara, mujer, pelo rizado, persona, seÃ±ora, tono de piel oscuro medio
ğŸ‘©ğŸ¿â€ğŸ¦±	cara, mujer, pelo rizado, persona, seÃ±ora, tono de piel oscuro
ğŸ‘©â€ğŸ¦³	cara, mujer, pelo blanco, persona, seÃ±ora
ğŸ‘©ğŸ»â€ğŸ¦³	cara, mujer, pelo blanco, persona, seÃ±ora, tono de piel claro
ğŸ‘©ğŸ¼â€ğŸ¦³	cara, mujer, pelo blanco, persona, seÃ±ora, tono de piel claro medio
ğŸ‘©ğŸ½â€ğŸ¦³	cara, mujer, pelo blanco, persona, seÃ±ora, tono de piel medio
ğŸ‘©ğŸ¾â€ğŸ¦³	cara, mujer, pelo blanco, persona, seÃ±ora, tono de piel oscuro medio
ğŸ‘©ğŸ¿â€ğŸ¦³	cara, mujer, pelo blanco, persona, seÃ±ora, tono de piel oscuro
ğŸ‘©â€ğŸ¦²	cara, mujer, persona, seÃ±ora, sin pelo
ğŸ‘©ğŸ»â€ğŸ¦²	cara, mujer, persona, seÃ±ora, sin pelo, tono de piel claro
ğŸ‘©ğŸ¼â€ğŸ¦²	cara, mujer, persona, seÃ±ora, sin pelo, tono de piel claro medio
ğŸ‘©ğŸ½â€ğŸ¦²	cara, mujer, persona, seÃ±ora, sin pelo, tono de piel medio
ğŸ‘©ğŸ¾â€ğŸ¦²	cara, mujer, persona, seÃ±ora, sin pelo, tono de piel oscuro medio
ğŸ‘©ğŸ¿â€ğŸ¦²	cara, mujer, persona, seÃ±ora, sin pelo, tono de piel oscuro
ğŸ§“	adulto mayor, gÃ©nero, maduro, mayor, neutro, persona adulta madura
ğŸ§“ğŸ»	adulto mayor, adulto mayor: tono de piel claro, gÃ©nero, maduro, mayor, neutro, persona adulta madura, tono de piel claro
ğŸ§“ğŸ¼	adulto mayor, adulto mayor: tono de piel claro medio, gÃ©nero, maduro, mayor, neutro, persona adulta madura, tono de piel claro medio
ğŸ§“ğŸ½	adulto mayor, adulto mayor: tono de piel medio, gÃ©nero, maduro, mayor, neutro, persona adulta madura, tono de piel medio
ğŸ§“ğŸ¾	adulto mayor, adulto mayor: tono de piel oscuro medio, gÃ©nero, maduro, mayor, neutro, persona adulta madura, tono de piel oscuro medio
ğŸ§“ğŸ¿	adulto mayor, adulto mayor: tono de piel oscuro, gÃ©nero, maduro, mayor, neutro, persona adulta madura, tono de piel oscuro
ğŸ‘´	cara, hombre, hombre mayor, mayor, seÃ±or, viejo
ğŸ‘´ğŸ»	cara, hombre, hombre mayor: tono de piel claro, mayor, seÃ±or, tono de piel claro, viejo
ğŸ‘´ğŸ¼	cara, hombre, hombre mayor: tono de piel claro medio, mayor, seÃ±or, tono de piel claro medio, viejo
ğŸ‘´ğŸ½	cara, hombre, hombre mayor: tono de piel medio, mayor, seÃ±or, tono de piel medio, viejo
ğŸ‘´ğŸ¾	cara, hombre, hombre mayor: tono de piel oscuro medio, mayor, seÃ±or, tono de piel oscuro medio, viejo
ğŸ‘´ğŸ¿	cara, hombre, hombre mayor: tono de piel oscuro, mayor, seÃ±or, tono de piel oscuro, viejo
ğŸ‘µ	cara, mayor, mujer, mujer mayor, seÃ±ora, vieja
ğŸ‘µğŸ»	cara, mayor, mujer, mujer mayor: tono de piel claro, seÃ±ora, tono de piel claro, vieja
ğŸ‘µğŸ¼	cara, mayor, mujer, mujer mayor: tono de piel claro medio, seÃ±ora, tono de piel claro medio, vieja
ğŸ‘µğŸ½	cara, mayor, mujer, mujer mayor: tono de piel medio, seÃ±ora, tono de piel medio, vieja
ğŸ‘µğŸ¾	cara, mayor, mujer, mujer mayor: tono de piel oscuro medio, seÃ±ora, tono de piel oscuro medio, vieja
ğŸ‘µğŸ¿	cara, mayor, mujer, mujer mayor: tono de piel oscuro, seÃ±ora, tono de piel oscuro, vieja
ğŸ™	cara, ceÃ±o, enojado, mal, mujer frunciendo el ceÃ±o, persona
ğŸ™ğŸ»	cara, ceÃ±o, enojado, mal, mujer frunciendo el ceÃ±o, mujer frunciendo el ceÃ±o: tono de piel claro, persona, tono de piel claro
ğŸ™ğŸ¼	cara, ceÃ±o, enojado, mal, mujer frunciendo el ceÃ±o, mujer frunciendo el ceÃ±o: tono de piel claro medio, persona, tono de piel claro medio
ğŸ™ğŸ½	cara, ceÃ±o, enojado, mal, mujer frunciendo el ceÃ±o, mujer frunciendo el ceÃ±o: tono de piel medio, persona, tono de piel medio
ğŸ™ğŸ¾	cara, ceÃ±o, enojado, mal, mujer frunciendo el ceÃ±o, mujer frunciendo el ceÃ±o: tono de piel oscuro medio, persona, tono de piel oscuro medio
ğŸ™ğŸ¿	cara, ceÃ±o, enojado, mal, mujer frunciendo el ceÃ±o, mujer frunciendo el ceÃ±o: tono de piel oscuro, persona, tono de piel oscuro
ğŸ™â€â™€	ceÃ±o, fruncido, gesto, mujer, mujer que frunce el seÃ±o, persona, triste
ğŸ™ğŸ»â€â™€	ceÃ±o, fruncido, gesto, mujer, mujer que frunce el seÃ±o, mujer que frunce el seÃ±o: tono de piel claro, persona, tono de piel claro, triste
ğŸ™ğŸ¼â€â™€	ceÃ±o, fruncido, gesto, mujer, mujer que frunce el seÃ±o, mujer que frunce el seÃ±o: tono de piel claro medio, persona, tono de piel claro medio, triste
ğŸ™ğŸ½â€â™€	ceÃ±o, fruncido, gesto, mujer, mujer que frunce el seÃ±o, mujer que frunce el seÃ±o: tono de piel medio, persona, tono de piel medio, triste
ğŸ™ğŸ¾â€â™€	ceÃ±o, fruncido, gesto, mujer, mujer que frunce el seÃ±o, mujer que frunce el seÃ±o: tono de piel oscuro medio, persona, tono de piel oscuro medio, triste
ğŸ™ğŸ¿â€â™€	ceÃ±o, fruncido, gesto, mujer, mujer que frunce el seÃ±o, mujer que frunce el seÃ±o: tono de piel oscuro, persona, tono de piel oscuro, triste
ğŸ™	cara, enojada, mujer, mujer enojada, persona
ğŸ™ğŸ»	cara, enojada, mujer, mujer enojada: tono de piel claro, persona, tono de piel claro
ğŸ™ğŸ¼	cara, enojada, mujer, mujer enojada: tono de piel claro medio, persona, tono de piel claro medio
ğŸ™ğŸ½	cara, enojada, mujer, mujer enojada: tono de piel medio, persona, tono de piel medio
ğŸ™ğŸ¾	cara, enojada, mujer, mujer enojada: tono de piel oscuro medio, persona, tono de piel oscuro medio
ğŸ™ğŸ¿	cara, enojada, mujer, mujer enojada: tono de piel oscuro, persona, tono de piel oscuro
ğŸ™…	brazos, cruzados, gesto, gesto de estÃ¡ mal, no, prohibido
ğŸ™…ğŸ»	brazos, cruzados, gesto, gesto de estÃ¡ mal, gesto de estÃ¡ mal: tono de piel claro, no, prohibido, tono de piel claro
ğŸ™…ğŸ¼	brazos, cruzados, gesto, gesto de estÃ¡ mal, gesto de estÃ¡ mal: tono de piel claro medio, no, prohibido, tono de piel claro medio
ğŸ™…ğŸ½	brazos, cruzados, gesto, gesto de estÃ¡ mal, gesto de estÃ¡ mal: tono de piel medio, no, prohibido, tono de piel medio
ğŸ™…ğŸ¾	brazos, cruzados, gesto, gesto de estÃ¡ mal, gesto de estÃ¡ mal: tono de piel oscuro medio, no, prohibido, tono de piel oscuro medio
ğŸ™…ğŸ¿	brazos, cruzados, gesto, gesto de estÃ¡ mal, gesto de estÃ¡ mal: tono de piel oscuro, no, prohibido, tono de piel oscuro
ğŸ™†	bien, gesto, gesto de estÃ¡ bien, ok
ğŸ™†ğŸ»	bien, gesto, gesto de estÃ¡ bien, gesto de estÃ¡ bien: tono de piel claro, ok, tono de piel claro
ğŸ™†ğŸ¼	bien, gesto, gesto de estÃ¡ bien, gesto de estÃ¡ bien: tono de piel claro medio, ok, tono de piel claro medio
ğŸ™†ğŸ½	bien, gesto, gesto de estÃ¡ bien, gesto de estÃ¡ bien: tono de piel medio, ok, tono de piel medio
ğŸ™†ğŸ¾	bien, gesto, gesto de estÃ¡ bien, gesto de estÃ¡ bien: tono de piel oscuro medio, ok, tono de piel oscuro medio
ğŸ™†ğŸ¿	bien, gesto, gesto de estÃ¡ bien, gesto de estÃ¡ bien: tono de piel oscuro, ok, tono de piel oscuro
ğŸ’	entrada, informaciÃ³n, mesa, mujer, persona, persona en mesa entrada
ğŸ’ğŸ»	entrada, informaciÃ³n, mesa, mujer, persona, persona en mesa entrada, persona en mesa entrada: tono de piel claro, tono de piel claro
ğŸ’ğŸ¼	entrada, informaciÃ³n, mesa, mujer, persona, persona en mesa entrada, persona en mesa entrada: tono de piel claro medio, tono de piel claro medio
ğŸ’ğŸ½	entrada, informaciÃ³n, mesa, mujer, persona, persona en mesa entrada, persona en mesa entrada: tono de piel medio, tono de piel medio
ğŸ’ğŸ¾	entrada, informaciÃ³n, mesa, mujer, persona, persona en mesa entrada, persona en mesa entrada: tono de piel oscuro medio, tono de piel oscuro medio
ğŸ’ğŸ¿	entrada, informaciÃ³n, mesa, mujer, persona, persona en mesa entrada, persona en mesa entrada: tono de piel oscuro, tono de piel oscuro
ğŸ™‹	contenta, levantar, mano, persona, persona levantando la mano, yo
ğŸ™‹ğŸ»	contenta, levantar, mano, persona, persona levantando la mano, persona levantando la mano: tono de piel claro, tono de piel claro, yo
ğŸ™‹ğŸ¼	contenta, levantar, mano, persona, persona levantando la mano, persona levantando la mano: tono de piel claro medio, tono de piel claro medio, yo
ğŸ™‹ğŸ½	contenta, levantar, mano, persona, persona levantando la mano, persona levantando la mano: tono de piel medio, tono de piel medio, yo
ğŸ™‹ğŸ¾	contenta, levantar, mano, persona, persona levantando la mano, persona levantando la mano: tono de piel oscuro medio, tono de piel oscuro medio, yo
ğŸ™‹ğŸ¿	contenta, levantar, mano, persona, persona levantando la mano, persona levantando la mano: tono de piel oscuro, tono de piel oscuro, yo
ğŸ™‡	gesto, perdÃ³n, persona, persona haciendo una reverencia, reverencia
ğŸ™‡ğŸ»	gesto, perdÃ³n, persona, persona haciendo una reverencia, reverencia, tono de piel claro
ğŸ™‡ğŸ¼	gesto, perdÃ³n, persona, persona haciendo una reverencia, reverencia, tono de piel claro medio
ğŸ™‡ğŸ½	gesto, perdÃ³n, persona, persona haciendo una reverencia, reverencia, tono de piel medio
ğŸ™‡ğŸ¾	gesto, perdÃ³n, persona, persona haciendo una reverencia, reverencia, tono de piel oscuro medio
ğŸ™‡ğŸ¿	gesto, perdÃ³n, persona, persona haciendo una reverencia, reverencia, tono de piel oscuro
ğŸ‘®	agente de policÃ­a, cara, oficial, persona, policÃ­a
ğŸ‘®ğŸ»	agente de policÃ­a, cara, oficial, persona, policÃ­a, tono de piel claro
ğŸ‘®ğŸ¼	agente de policÃ­a, cara, oficial, persona, policÃ­a, tono de piel claro medio
ğŸ‘®ğŸ½	agente de policÃ­a, cara, oficial, persona, policÃ­a, tono de piel medio
ğŸ‘®ğŸ¾	agente de policÃ­a, cara, oficial, persona, policÃ­a, tono de piel oscuro medio
ğŸ‘®ğŸ¿	agente de policÃ­a, cara, oficial, persona, policÃ­a, tono de piel oscuro
ğŸ•µï¸	agente, bÃºsqueda, detective, espÃ­a, investigaciÃ³n, persona
ğŸ•µğŸ»	agente, bÃºsqueda, detective, espÃ­a, investigaciÃ³n, persona, tono de piel claro
ğŸ•µğŸ¼	agente, bÃºsqueda, detective, espÃ­a, investigaciÃ³n, persona, tono de piel claro medio
ğŸ•µğŸ½	agente, bÃºsqueda, detective, espÃ­a, investigaciÃ³n, persona, tono de piel medio
ğŸ•µğŸ¾	agente, bÃºsqueda, detective, espÃ­a, investigaciÃ³n, persona, tono de piel oscuro medio
ğŸ•µğŸ¿	agente, bÃºsqueda, detective, espÃ­a, investigaciÃ³n, persona, tono de piel oscuro
ğŸ’‚	cara, guardia, hombre, inglÃ©s, sombrero
ğŸ’‚ğŸ»	cara, guardia, hombre, inglÃ©s, sombrero, tono de piel claro
ğŸ’‚ğŸ¼	cara, guardia, hombre, inglÃ©s, sombrero, tono de piel claro medio
ğŸ’‚ğŸ½	cara, guardia, hombre, inglÃ©s, sombrero, tono de piel medio
ğŸ’‚ğŸ¾	cara, guardia, hombre, inglÃ©s, sombrero, tono de piel oscuro medio
ğŸ’‚ğŸ¿	cara, guardia, hombre, inglÃ©s, sombrero, tono de piel oscuro
ğŸ‘·	cara, construcciÃ³n, hombre, obrero, obrero de construcciÃ³n, persona, trabajador
ğŸ‘·ğŸ»	cara, construcciÃ³n, hombre, obrero, obrero de construcciÃ³n, obrero de construcciÃ³n: tono de piel claro, persona, tono de piel claro, trabajador
ğŸ‘·ğŸ¼	cara, construcciÃ³n, hombre, obrero, obrero de construcciÃ³n, obrero de construcciÃ³n: tono de piel claro medio, persona, tono de piel claro medio, trabajador
ğŸ‘·ğŸ½	cara, construcciÃ³n, hombre, obrero, obrero de construcciÃ³n, obrero de construcciÃ³n: tono de piel medio, persona, tono de piel medio, trabajador
ğŸ‘·ğŸ¾	cara, construcciÃ³n, hombre, obrero, obrero de construcciÃ³n, obrero de construcciÃ³n: tono de piel oscuro medio, persona, tono de piel oscuro medio, trabajador
ğŸ‘·ğŸ¿	cara, construcciÃ³n, hombre, obrero, obrero de construcciÃ³n, obrero de construcciÃ³n: tono de piel oscuro, persona, tono de piel oscuro, trabajador
ğŸ¤´	prÃ­ncipe
ğŸ¤´ğŸ»	prÃ­ncipe, tono de piel claro
ğŸ¤´ğŸ¼	prÃ­ncipe, tono de piel claro medio
ğŸ¤´ğŸ½	prÃ­ncipe, tono de piel medio
ğŸ¤´ğŸ¾	prÃ­ncipe, tono de piel oscuro medio
ğŸ¤´ğŸ¿	prÃ­ncipe, tono de piel oscuro
ğŸ‘³	cara, hombre, persona, persona con turbante, turbante
ğŸ‘³ğŸ»	cara, hombre, persona, persona con turbante, tono de piel claro, turbante
ğŸ‘³ğŸ¼	cara, hombre, persona, persona con turbante, tono de piel claro medio, turbante
ğŸ‘³ğŸ½	cara, hombre, persona, persona con turbante, tono de piel medio, turbante
ğŸ‘³ğŸ¾	cara, hombre, persona, persona con turbante, tono de piel oscuro medio, turbante
ğŸ‘³ğŸ¿	cara, hombre, persona, persona con turbante, tono de piel oscuro, turbante
ğŸ‘°	boda, persona, persona con velo, velo
ğŸ‘°ğŸ»	boda, persona, persona con velo, tono de piel claro, velo
ğŸ‘°ğŸ¼	boda, persona, persona con velo, tono de piel claro medio, velo
ğŸ‘°ğŸ½	boda, persona, persona con velo, tono de piel medio, velo
ğŸ‘°ğŸ¾	boda, persona, persona con velo, tono de piel oscuro medio, velo
ğŸ‘°ğŸ¿	boda, persona, persona con velo, tono de piel oscuro, velo
ğŸ¤°	embarazada, embarazo, mujer
ğŸ¤°ğŸ»	embarazada, embarazo, mujer, tono de piel claro
ğŸ¤°ğŸ¼	embarazada, embarazo, mujer, tono de piel claro medio
ğŸ¤°ğŸ½	embarazada, embarazo, mujer, tono de piel medio
ğŸ¤°ğŸ¾	embarazada, embarazo, mujer, tono de piel oscuro medio
ğŸ¤°ğŸ¿	embarazada, embarazo, mujer, tono de piel oscuro
ğŸ‘¼	bebÃ©, cara, cara de Ã¡ngel bebÃ©, cuento, Ã¡ngel
ğŸ‘¼ğŸ»	bebÃ©, cara, cara de Ã¡ngel bebÃ©, cara de Ã¡ngel bebÃ©: tono de piel claro, cuento, tono de piel claro, Ã¡ngel
ğŸ‘¼ğŸ¼	bebÃ©, cara, cara de Ã¡ngel bebÃ©, cara de Ã¡ngel bebÃ©: tono de piel claro medio, cuento, tono de piel claro medio, Ã¡ngel
ğŸ‘¼ğŸ½	bebÃ©, cara, cara de Ã¡ngel bebÃ©, cara de Ã¡ngel bebÃ©: tono de piel medio, cuento, tono de piel medio, Ã¡ngel
ğŸ‘¼ğŸ¾	bebÃ©, cara, cara de Ã¡ngel bebÃ©, cara de Ã¡ngel bebÃ©: tono de piel oscuro medio, cuento, tono de piel oscuro medio, Ã¡ngel
ğŸ‘¼ğŸ¿	bebÃ©, cara, cara de Ã¡ngel bebÃ©, cara de Ã¡ngel bebÃ©: tono de piel oscuro, cuento, tono de piel oscuro, Ã¡ngel
ğŸ…	Navidad, PapÃ¡ Noel, Santa Claus, fiesta, noel, papÃ¡, santa
ğŸ…ğŸ»	Navidad, PapÃ¡ Noel, Santa Claus, Santa Claus: tono de piel claro, fiesta, noel, papÃ¡, santa, tono de piel claro
ğŸ…ğŸ¼	Navidad, PapÃ¡ Noel, Santa Claus, Santa Claus: tono de piel claro medio, fiesta, noel, papÃ¡, santa, tono de piel claro medio
ğŸ…ğŸ½	Navidad, PapÃ¡ Noel, Santa Claus, Santa Claus: tono de piel medio, fiesta, noel, papÃ¡, santa, tono de piel medio
ğŸ…ğŸ¾	Navidad, PapÃ¡ Noel, Santa Claus, Santa Claus: tono de piel oscuro medio, fiesta, noel, papÃ¡, santa, tono de piel oscuro medio
ğŸ…ğŸ¿	Navidad, PapÃ¡ Noel, Santa Claus, Santa Claus: tono de piel oscuro, fiesta, noel, papÃ¡, santa, tono de piel oscuro
ğŸ§‘â€ğŸ„	Claus, Navidad, PapÃ¡ Noel, Santa, papÃ¡ noel
ğŸ§‘ğŸ»â€ğŸ„	Claus, Navidad, PapÃ¡ Noel, Santa, papÃ¡ noel, papÃ¡ noel: tono de piel claro, tono de piel claro
ğŸ§‘ğŸ¼â€ğŸ„	Claus, Navidad, PapÃ¡ Noel, Santa, papÃ¡ noel, papÃ¡ noel: tono de piel claro medio, tono de piel claro medio
ğŸ§‘ğŸ½â€ğŸ„	Claus, Navidad, PapÃ¡ Noel, Santa, papÃ¡ noel, papÃ¡ noel: tono de piel medio, tono de piel medio
ğŸ§‘ğŸ¾â€ğŸ„	Claus, Navidad, PapÃ¡ Noel, Santa, papÃ¡ noel, papÃ¡ noel: tono de piel oscuro medio, tono de piel oscuro medio
ğŸ§‘ğŸ¿â€ğŸ„	Claus, Navidad, PapÃ¡ Noel, Santa, papÃ¡ noel, papÃ¡ noel: tono de piel oscuro, tono de piel oscuro
ğŸ§œ	persona sirena, sirena, sireno
ğŸ§œğŸ»	persona sirena, sirena, sireno, tono de piel claro
ğŸ§œğŸ¼	persona sirena, sirena, sireno, tono de piel claro medio
ğŸ§œğŸ½	persona sirena, sirena, sireno, tono de piel medio
ğŸ§œğŸ¾	persona sirena, sirena, sireno, tono de piel oscuro medio
ğŸ§œğŸ¿	persona sirena, sirena, sireno, tono de piel oscuro
ğŸ§œâ€â™‚	sirena, sirena hombre, sireno, tritÃ³n
ğŸ§œğŸ»â€â™‚	sirena, sirena hombre, sireno, sireno: tono de piel claro, tono de piel claro, tritÃ³n
ğŸ§œğŸ¼â€â™‚	sirena, sirena hombre, sireno, sireno: tono de piel claro medio, tono de piel claro medio, tritÃ³n
ğŸ§œğŸ½â€â™‚	sirena, sirena hombre, sireno, sireno: tono de piel medio, tono de piel medio, tritÃ³n
ğŸ§œğŸ¾â€â™‚	sirena, sirena hombre, sireno, sireno: tono de piel oscuro medio, tono de piel oscuro medio, tritÃ³n
ğŸ§œğŸ¿â€â™‚	sirena, sirena hombre, sireno, sireno: tono de piel oscuro, tono de piel oscuro, tritÃ³n
ğŸ’†	belleza, masaje, masaje facial, relax, salÃ³n, spa
ğŸ’†ğŸ»	belleza, masaje, masaje facial, masaje facial: tono de piel claro, relax, salÃ³n, spa, tono de piel claro
ğŸ’†ğŸ¼	belleza, masaje, masaje facial, masaje facial: tono de piel claro medio, relax, salÃ³n, spa, tono de piel claro medio
ğŸ’†ğŸ½	belleza, masaje, masaje facial, masaje facial: tono de piel medio, relax, salÃ³n, spa, tono de piel medio
ğŸ’†ğŸ¾	belleza, masaje, masaje facial, masaje facial: tono de piel oscuro medio, relax, salÃ³n, spa, tono de piel oscuro medio
ğŸ’†ğŸ¿	belleza, masaje, masaje facial, masaje facial: tono de piel oscuro, relax, salÃ³n, spa, tono de piel oscuro
ğŸ’‡	belleza, corte, corte de pelo, mujer, pelo, peluquero, peluquerÃ­a, salÃ³n
ğŸ’‡ğŸ»	belleza, corte, corte de pelo, corte de pelo: tono de piel claro, mujer, pelo, peluquero, peluquerÃ­a, salÃ³n, tono de piel claro
ğŸ’‡ğŸ¼	belleza, corte, corte de pelo, corte de pelo: tono de piel claro medio, mujer, pelo, peluquero, peluquerÃ­a, salÃ³n, tono de piel claro medio
ğŸ’‡ğŸ½	belleza, corte, corte de pelo, corte de pelo: tono de piel medio, mujer, pelo, peluquero, peluquerÃ­a, salÃ³n, tono de piel medio
ğŸ’‡ğŸ¾	belleza, corte, corte de pelo, corte de pelo: tono de piel oscuro medio, mujer, pelo, peluquero, peluquerÃ­a, salÃ³n, tono de piel oscuro medio
ğŸ’‡ğŸ¿	belleza, corte, corte de pelo, corte de pelo: tono de piel oscuro, mujer, pelo, peluquero, peluquerÃ­a, salÃ³n, tono de piel oscuro
ğŸš¶	caminar, caminata, persona, persona caminando
ğŸš¶ğŸ»	caminar, caminata, persona, persona caminando, tono de piel claro
ğŸš¶ğŸ¼	caminar, caminata, persona, persona caminando, tono de piel claro medio
ğŸš¶ğŸ½	caminar, caminata, persona, persona caminando, tono de piel medio
ğŸš¶ğŸ¾	caminar, caminata, persona, persona caminando, tono de piel oscuro medio
ğŸš¶ğŸ¿	caminar, caminata, persona, persona caminando, tono de piel oscuro
ğŸƒ	correr, deporte, deportista, maratÃ³n, persona, persona corriendo
ğŸƒğŸ»	correr, deporte, deportista, maratÃ³n, persona, persona corriendo, tono de piel claro
ğŸƒğŸ¼	correr, deporte, deportista, maratÃ³n, persona, persona corriendo, tono de piel claro medio
ğŸƒğŸ½	correr, deporte, deportista, maratÃ³n, persona, persona corriendo, tono de piel medio
ğŸƒğŸ¾	correr, deporte, deportista, maratÃ³n, persona, persona corriendo, tono de piel oscuro medio
ğŸƒğŸ¿	correr, deporte, deportista, maratÃ³n, persona, persona corriendo, tono de piel oscuro
ğŸ’ƒ	bailar, bailarina, bailarÃ­n, baile, flamenco, mujer bailando, persona
ğŸ’ƒğŸ»	bailar, bailarina, bailarÃ­n, baile, flamenco, mujer bailando, persona, tono de piel claro
ğŸ’ƒğŸ¼	bailar, bailarina, bailarÃ­n, baile, flamenco, mujer bailando, persona, tono de piel claro medio
ğŸ’ƒğŸ½	bailar, bailarina, bailarÃ­n, baile, flamenco, mujer bailando, persona, tono de piel medio
ğŸ’ƒğŸ¾	bailar, bailarina, bailarÃ­n, baile, flamenco, mujer bailando, persona, tono de piel oscuro medio
ğŸ’ƒğŸ¿	bailar, bailarina, bailarÃ­n, baile, flamenco, mujer bailando, persona, tono de piel oscuro
ğŸ•º	bailar, baile, hombre, hombre bailando
ğŸ•ºğŸ»	bailar, baile, hombre, hombre bailando, tono de piel claro
ğŸ•ºğŸ¼	bailar, baile, hombre, hombre bailando, tono de piel claro medio
ğŸ•ºğŸ½	bailar, baile, hombre, hombre bailando, tono de piel medio
ğŸ•ºğŸ¾	bailar, baile, hombre, hombre bailando, tono de piel oscuro medio
ğŸ•ºğŸ¿	bailar, baile, hombre, hombre bailando, tono de piel oscuro
ğŸ•´ï¸	hombre, hombre de traje, persona, traje
ğŸ•´ğŸ»	hombre, hombre de traje, hombre de traje: tono de piel claro, persona, tono de piel claro, traje
ğŸ•´ğŸ¼	hombre, hombre de traje, hombre de traje: tono de piel claro medio, persona, tono de piel claro medio, traje
ğŸ•´ğŸ½	hombre, hombre de traje, hombre de traje: tono de piel medio, persona, tono de piel medio, traje
ğŸ•´ğŸ¾	hombre, hombre de traje, hombre de traje: tono de piel oscuro medio, persona, tono de piel oscuro medio, traje
ğŸ•´ğŸ¿	hombre, hombre de traje, hombre de traje: tono de piel oscuro, persona, tono de piel oscuro, traje
ğŸ‘¯	chicas, conejita, conejo, mujer, mujeres de fiesta, orejas, persona
ğŸ¤º	esgrimista
ğŸ‡	caballo, carrera, carrera de caballos, deporte, jinete
ğŸ‡ğŸ»	caballo, carrera, carrera de caballos, deporte, jinete, tono de piel claro
ğŸ‡ğŸ¼	caballo, carrera, carrera de caballos, deporte, jinete, tono de piel claro medio
ğŸ‡ğŸ½	caballo, carrera, carrera de caballos, deporte, jinete, tono de piel medio
ğŸ‡ğŸ¾	caballo, carrera, carrera de caballos, deporte, jinete, tono de piel oscuro medio
ğŸ‡ğŸ¿	caballo, carrera, carrera de caballos, deporte, jinete, tono de piel oscuro
â›·ï¸	deporte, esquiador, esquÃ­, nieve
ğŸ‚ï¸	deporte, nieve, snowboard, tabla
ğŸ‚ğŸ»	deporte, nieve, snowboard, snowboard: tono de piel claro, tabla, tono de piel claro
ğŸ‚ğŸ¼	deporte, nieve, snowboard, snowboard: tono de piel claro medio, tabla, tono de piel claro medio
ğŸ‚ğŸ½	deporte, nieve, snowboard, snowboard: tono de piel medio, tabla, tono de piel medio
ğŸ‚ğŸ¾	deporte, nieve, snowboard, snowboard: tono de piel oscuro medio, tabla, tono de piel oscuro medio
ğŸ‚ğŸ¿	deporte, nieve, snowboard, snowboard: tono de piel oscuro, tabla, tono de piel oscuro
ğŸŒï¸	golf, jugador, jugador de golf, pelota
ğŸŒğŸ»	golf, jugador, jugador de golf, jugador de golf: tono de piel claro, pelota, tono de piel claro
ğŸŒğŸ¼	golf, jugador, jugador de golf, jugador de golf: tono de piel claro medio, pelota, tono de piel claro medio
ğŸŒğŸ½	golf, jugador, jugador de golf, jugador de golf: tono de piel medio, pelota, tono de piel medio
ğŸŒğŸ¾	golf, jugador, jugador de golf, jugador de golf: tono de piel oscuro medio, pelota, tono de piel oscuro medio
ğŸŒğŸ¿	golf, jugador, jugador de golf, jugador de golf: tono de piel oscuro, pelota, tono de piel oscuro
ğŸ„ï¸	deporte, surf, surfista
ğŸ„ğŸ»	deporte, surf, surf: tono de piel claro, surfista, tono de piel claro
ğŸ„ğŸ¼	deporte, surf, surf: tono de piel claro medio, surfista, tono de piel claro medio
ğŸ„ğŸ½	deporte, surf, surf: tono de piel medio, surfista, tono de piel medio
ğŸ„ğŸ¾	deporte, surf, surf: tono de piel oscuro medio, surfista, tono de piel oscuro medio
ğŸ„ğŸ¿	deporte, surf, surf: tono de piel oscuro, surfista, tono de piel oscuro
ğŸš£	bote, bote a remo, remos, vehÃ­culo
ğŸš£ğŸ»	bote, bote a remo, bote a remo: tono de piel claro, remos, tono de piel claro, vehÃ­culo
ğŸš£ğŸ¼	bote, bote a remo, bote a remo: tono de piel claro medio, remos, tono de piel claro medio, vehÃ­culo
ğŸš£ğŸ½	bote, bote a remo, bote a remo: tono de piel medio, remos, tono de piel medio, vehÃ­culo
ğŸš£ğŸ¾	bote, bote a remo, bote a remo: tono de piel oscuro medio, remos, tono de piel oscuro medio, vehÃ­culo
ğŸš£ğŸ¿	bote, bote a remo, bote a remo: tono de piel oscuro, remos, tono de piel oscuro, vehÃ­culo
â›¹ï¸	bÃ¡squet, deporte, pelota, persona, persona con una pelota
â›¹ğŸ»	bÃ¡squet, deporte, pelota, persona, persona con una pelota, persona con una pelota: tono de piel claro, tono de piel claro
â›¹ğŸ¼	bÃ¡squet, deporte, pelota, persona, persona con una pelota, persona con una pelota: tono de piel claro medio, tono de piel claro medio
â›¹ğŸ½	bÃ¡squet, deporte, pelota, persona, persona con una pelota, persona con una pelota: tono de piel medio, tono de piel medio
â›¹ğŸ¾	bÃ¡squet, deporte, pelota, persona, persona con una pelota, persona con una pelota: tono de piel oscuro medio, tono de piel oscuro medio
â›¹ğŸ¿	bÃ¡squet, deporte, pelota, persona, persona con una pelota, persona con una pelota: tono de piel oscuro, tono de piel oscuro
ğŸ‹ï¸	deporte, persona levantando pesas, pesas
ğŸ‹ğŸ»	deporte, persona levantando pesas, pesas, tono de piel claro
ğŸ‹ğŸ¼	deporte, persona levantando pesas, pesas, tono de piel claro medio
ğŸ‹ğŸ½	deporte, persona levantando pesas, pesas, tono de piel medio
ğŸ‹ğŸ¾	deporte, persona levantando pesas, pesas, tono de piel oscuro medio
ğŸ‹ğŸ¿	deporte, persona levantando pesas, pesas, tono de piel oscuro
ğŸ¤¸	deporte, gimnasia, persona, persona haciendo voltereta lateral, pirueta, voletereta lateral
ğŸ¤¸ğŸ»	deporte, gimnasia, persona, persona haciendo voltereta lateral, pirueta, tono de piel claro, voletereta lateral
ğŸ¤¸ğŸ¼	deporte, gimnasia, persona, persona haciendo voltereta lateral, pirueta, tono de piel claro medio, voletereta lateral
ğŸ¤¸ğŸ½	deporte, gimnasia, persona, persona haciendo voltereta lateral, pirueta, tono de piel medio, voletereta lateral
ğŸ¤¸ğŸ¾	deporte, gimnasia, persona, persona haciendo voltereta lateral, pirueta, tono de piel oscuro medio, voletereta lateral
ğŸ¤¸ğŸ¿	deporte, gimnasia, persona, persona haciendo voltereta lateral, pirueta, tono de piel oscuro, voletereta lateral
ğŸ¤¼	deporte, luchadores, luchar, pelea, persona, personas luchando
ğŸ¤½	agua, deporte, persona, persona jugando al waterpolo, waterpolo
ğŸ¤½ğŸ»	agua, deporte, persona, persona jugando al waterpolo, tono de piel claro, waterpolo
ğŸ¤½ğŸ¼	agua, deporte, persona, persona jugando al waterpolo, tono de piel claro medio, waterpolo
ğŸ¤½ğŸ½	agua, deporte, persona, persona jugando al waterpolo, tono de piel medio, waterpolo
ğŸ¤½ğŸ¾	agua, deporte, persona, persona jugando al waterpolo, tono de piel oscuro medio, waterpolo
ğŸ¤½ğŸ¿	agua, deporte, persona, persona jugando al waterpolo, tono de piel oscuro, waterpolo
ğŸ¤¾	balonmano, handball, mano, pelota, persona
ğŸ¤¾ğŸ»	balonmano, handball, handball: tono de piel claro, mano, pelota, persona, tono de piel claro
ğŸ¤¾ğŸ¼	balonmano, handball, handball: tono de piel claro medio, mano, pelota, persona, tono de piel claro medio
ğŸ¤¾ğŸ½	balonmano, handball, handball: tono de piel medio, mano, pelota, persona, tono de piel medio
ğŸ¤¾ğŸ¾	balonmano, handball, handball: tono de piel oscuro medio, mano, pelota, persona, tono de piel oscuro medio
ğŸ¤¾ğŸ¿	balonmano, handball, handball: tono de piel oscuro, mano, pelota, persona, tono de piel oscuro
ğŸ¤¾â€â™‚	hombre jugando handball
ğŸ¤¾ğŸ»â€â™‚	hombre jugando handball, hombre jugando handball: tono de piel claro, tono de piel claro
ğŸ¤¾ğŸ¼â€â™‚	hombre jugando handball, hombre jugando handball: tono de piel claro medio, tono de piel claro medio
ğŸ¤¾ğŸ½â€â™‚	hombre jugando handball, hombre jugando handball: tono de piel medio, tono de piel medio
ğŸ¤¾ğŸ¾â€â™‚	hombre jugando handball, hombre jugando handball: tono de piel oscuro medio, tono de piel oscuro medio
ğŸ¤¾ğŸ¿â€â™‚	hombre jugando handball, hombre jugando handball: tono de piel oscuro, tono de piel oscuro
ğŸ¤¾â€â™€	mujer jugando handball
ğŸ¤¾ğŸ»â€â™€	mujer jugando handball, mujer jugando handball: tono de piel claro, tono de piel claro
ğŸ¤¾ğŸ¼â€â™€	mujer jugando handball, mujer jugando handball: tono de piel claro medio, tono de piel claro medio
ğŸ¤¾ğŸ½â€â™€	mujer jugando handball, mujer jugando handball: tono de piel medio, tono de piel medio
ğŸ¤¾ğŸ¾â€â™€	mujer jugando handball, mujer jugando handball: tono de piel oscuro medio, tono de piel oscuro medio
ğŸ¤¾ğŸ¿â€â™€	mujer jugando handball, mujer jugando handball: tono de piel oscuro, tono de piel oscuro
ğŸ›Œ	cama, dormir, hotel, persona durmiendo
ğŸ›ŒğŸ»	cama, dormir, hotel, persona durmiendo, persona durmiendo: tono de piel claro, tono de piel claro
ğŸ›ŒğŸ¼	cama, dormir, hotel, persona durmiendo, persona durmiendo: tono de piel claro medio, tono de piel claro medio
ğŸ›ŒğŸ½	cama, dormir, hotel, persona durmiendo, persona durmiendo: tono de piel medio, tono de piel medio
ğŸ›ŒğŸ¾	cama, dormir, hotel, persona durmiendo, persona durmiendo: tono de piel oscuro medio, tono de piel oscuro medio
ğŸ›ŒğŸ¿	cama, dormir, hotel, persona durmiendo, persona durmiendo: tono de piel oscuro, tono de piel oscuro
ğŸ‘¬	dos hombres de la mano, gays, hombres, hombres de la mano, novios, pareja
ğŸ‘¬ğŸ»	dos hombres de la mano, dos hombres de la mano: tono de piel claro, gays, hombres, hombres de la mano, novios, pareja, tono de piel claro
ğŸ‘¨ğŸ»â€ğŸ¤â€ğŸ‘¨ğŸ¼	dos hombres de la mano, dos hombres de la mano: tono de piel claro y tono de piel claro medio, gays, hombres, hombres de la mano, novios, pareja, tono de piel claro, tono de piel claro medio
ğŸ‘¨ğŸ»â€ğŸ¤â€ğŸ‘¨ğŸ½	dos hombres de la mano, dos hombres de la mano: tono de piel claro y tono de piel medio, gays, hombres, hombres de la mano, novios, pareja, tono de piel claro, tono de piel medio
ğŸ‘¨ğŸ»â€ğŸ¤â€ğŸ‘¨ğŸ¾	dos hombres de la mano, dos hombres de la mano: tono de piel claro y tono de piel oscuro medio, gays, hombres, hombres de la mano, novios, pareja, tono de piel claro, tono de piel oscuro medio
ğŸ‘¨ğŸ»â€ğŸ¤â€ğŸ‘¨ğŸ¿	dos hombres de la mano, dos hombres de la mano: tono de piel claro y tono de piel oscuro, gays, hombres, hombres de la mano, novios, pareja, tono de piel claro, tono de piel oscuro
ğŸ‘¨ğŸ¼â€ğŸ¤â€ğŸ‘¨ğŸ»	dos hombres de la mano, dos hombres de la mano: tono de piel claro medio y tono de piel claro, gays, hombres, hombres de la mano, novios, pareja, tono de piel claro, tono de piel claro medio
ğŸ‘¬ğŸ¼	dos hombres de la mano, dos hombres de la mano: tono de piel claro medio, gays, hombres, hombres de la mano, novios, pareja, tono de piel claro medio
ğŸ‘¨ğŸ¼â€ğŸ¤â€ğŸ‘¨ğŸ½	dos hombres de la mano, dos hombres de la mano: tono de piel claro medio y tono de piel medio, gays, hombres, hombres de la mano, novios, pareja, tono de piel claro medio, tono de piel medio
ğŸ‘¨ğŸ¼â€ğŸ¤â€ğŸ‘¨ğŸ¾	dos hombres de la mano, dos hombres de la mano: tono de piel claro medio y tono de piel oscuro medio, gays, hombres, hombres de la mano, novios, pareja, tono de piel claro medio, tono de piel oscuro medio
ğŸ‘¨ğŸ¼â€ğŸ¤â€ğŸ‘¨ğŸ¿	dos hombres de la mano, dos hombres de la mano: tono de piel claro medio y tono de piel oscuro, gays, hombres, hombres de la mano, novios, pareja, tono de piel claro medio, tono de piel oscuro
ğŸ‘¨ğŸ½â€ğŸ¤â€ğŸ‘¨ğŸ»	dos hombres de la mano, dos hombres de la mano: tono de piel medio y tono de piel claro, gays, hombres, hombres de la mano, novios, pareja, tono de piel claro, tono de piel medio
ğŸ‘¨ğŸ½â€ğŸ¤â€ğŸ‘¨ğŸ¼	dos hombres de la mano, dos hombres de la mano: tono de piel medio y tono de piel claro medio, gays, hombres, hombres de la mano, novios, pareja, tono de piel claro medio, tono de piel medio
ğŸ‘¬ğŸ½	dos hombres de la mano, dos hombres de la mano: tono de piel medio, gays, hombres, hombres de la mano, novios, pareja, tono de piel medio
ğŸ‘¨ğŸ½â€ğŸ¤â€ğŸ‘¨ğŸ¾	dos hombres de la mano, dos hombres de la mano: tono de piel medio y tono de piel oscuro medio, gays, hombres, hombres de la mano, novios, pareja, tono de piel medio, tono de piel oscuro medio
ğŸ‘¨ğŸ½â€ğŸ¤â€ğŸ‘¨ğŸ¿	dos hombres de la mano, dos hombres de la mano: tono de piel medio y tono de piel oscuro, gays, hombres, hombres de la mano, novios, pareja, tono de piel medio, tono de piel oscuro
ğŸ‘¨ğŸ¾â€ğŸ¤â€ğŸ‘¨ğŸ»	dos hombres de la mano, dos hombres de la mano: tono de piel oscuro medio y tono de piel claro, gays, hombres, hombres de la mano, novios, pareja, tono de piel claro, tono de piel oscuro medio
ğŸ‘¨ğŸ¾â€ğŸ¤â€ğŸ‘¨ğŸ¼	dos hombres de la mano, dos hombres de la mano: tono de piel oscuro medio y tono de piel claro medio, gays, hombres, hombres de la mano, novios, pareja, tono de piel claro medio, tono de piel oscuro medio
ğŸ‘¨ğŸ¾â€ğŸ¤â€ğŸ‘¨ğŸ½	dos hombres de la mano, dos hombres de la mano: tono de piel oscuro medio y tono de piel medio, gays, hombres, hombres de la mano, novios, pareja, tono de piel medio, tono de piel oscuro medio
ğŸ‘¬ğŸ¾	dos hombres de la mano, dos hombres de la mano: tono de piel oscuro medio, gays, hombres, hombres de la mano, novios, pareja, tono de piel oscuro medio
ğŸ‘¨ğŸ¾â€ğŸ¤â€ğŸ‘¨ğŸ¿	dos hombres de la mano, dos hombres de la mano: tono de piel oscuro medio y tono de piel oscuro, gays, hombres, hombres de la mano, novios, pareja, tono de piel oscuro, tono de piel oscuro medio
ğŸ‘¨ğŸ¿â€ğŸ¤â€ğŸ‘¨ğŸ»	dos hombres de la mano, dos hombres de la mano: tono de piel oscuro y tono de piel claro, gays, hombres, hombres de la mano, novios, pareja, tono de piel claro, tono de piel oscuro
ğŸ‘¨ğŸ¿â€ğŸ¤â€ğŸ‘¨ğŸ¼	dos hombres de la mano, dos hombres de la mano: tono de piel oscuro y tono de piel claro medio, gays, hombres, hombres de la mano, novios, pareja, tono de piel claro medio, tono de piel oscuro
ğŸ‘¨ğŸ¿â€ğŸ¤â€ğŸ‘¨ğŸ½	dos hombres de la mano, dos hombres de la mano: tono de piel oscuro y tono de piel medio, gays, hombres, hombres de la mano, novios, pareja, tono de piel medio, tono de piel oscuro
ğŸ‘¨ğŸ¿â€ğŸ¤â€ğŸ‘¨ğŸ¾	dos hombres de la mano, dos hombres de la mano: tono de piel oscuro y tono de piel oscuro medio, gays, hombres, hombres de la mano, novios, pareja, tono de piel oscuro, tono de piel oscuro medio
ğŸ‘¬ğŸ¿	dos hombres de la mano, dos hombres de la mano: tono de piel oscuro, gays, hombres, hombres de la mano, novios, pareja, tono de piel oscuro
ğŸ’	beso, pareja, pareja besÃ¡ndose, personas, romance, romÃ¡ntico
ğŸ‘©â€â¤â€ğŸ’‹â€ğŸ‘¨	beso, hombre, mujer, pareja, pareja besÃ¡ndose, pareja besÃ¡ndose: mujer y hombre, personas, romance, romÃ¡ntico
ğŸ‘¨â€â¤â€ğŸ’‹â€ğŸ‘¨	beso, hombre, pareja, pareja besÃ¡ndose, pareja besÃ¡ndose: hombre y hombre, personas, romance, romÃ¡ntico
ğŸ‘©â€â¤â€ğŸ’‹â€ğŸ‘©	beso, mujer, pareja, pareja besÃ¡ndose, pareja besÃ¡ndose: mujer y mujer, personas, romance, romÃ¡ntico
ğŸ’‘	amor, corazÃ³n, enamorado, pareja, pareja enamorada, personas, romance, romÃ¡ntico
ğŸ‘©â€â¤â€ğŸ‘¨	amor, corazÃ³n, enamorado, hombre, mujer, pareja, pareja enamorada, personas, romance, romÃ¡ntico
ğŸ‘¨â€â¤â€ğŸ‘¨	amor, corazÃ³n, enamorado, hombre, pareja, pareja enamorada, personas, romance, romÃ¡ntico
ğŸ‘©â€â¤â€ğŸ‘©	amor, corazÃ³n, enamorado, mujer, pareja, pareja enamorada, personas, romance, romÃ¡ntico
ğŸ‘ªï¸	familia, hija, hijo, madre, mamÃ¡, padre, papÃ¡, personas
ğŸ‘¨â€ğŸ‘©â€ğŸ‘¦	familia, hija, hijo, hombre, madre, mamÃ¡, mujer, niÃ±o, padre, papÃ¡, personas
ğŸ‘¨â€ğŸ‘©â€ğŸ‘§	familia, hija, hijo, hombre, madre, mamÃ¡, mujer, niÃ±a, padre, papÃ¡, personas
ğŸ‘¨â€ğŸ‘©â€ğŸ‘§â€ğŸ‘¦	familia, hija, hijo, hombre, madre, mamÃ¡, mujer, niÃ±a, niÃ±o, padre, papÃ¡, personas
ğŸ‘¨â€ğŸ‘©â€ğŸ‘¦â€ğŸ‘¦	familia, hija, hijo, hombre, madre, mamÃ¡, mujer, niÃ±o, padre, papÃ¡, personas
ğŸ‘¨â€ğŸ‘©â€ğŸ‘§â€ğŸ‘§	familia, hija, hijo, hombre, madre, mamÃ¡, mujer, niÃ±a, padre, papÃ¡, personas
ğŸ‘¨â€ğŸ‘¨â€ğŸ‘¦	familia, hija, hijo, hombre, madre, mamÃ¡, niÃ±o, padre, papÃ¡, personas
ğŸ‘¨â€ğŸ‘¨â€ğŸ‘§	familia, hija, hijo, hombre, madre, mamÃ¡, niÃ±a, padre, papÃ¡, personas
ğŸ‘¨â€ğŸ‘¨â€ğŸ‘§â€ğŸ‘¦	familia, hija, hijo, hombre, madre, mamÃ¡, niÃ±a, niÃ±o, padre, papÃ¡, personas
ğŸ‘¨â€ğŸ‘¨â€ğŸ‘¦â€ğŸ‘¦	familia, hija, hijo, hombre, madre, mamÃ¡, niÃ±o, padre, papÃ¡, personas
ğŸ‘¨â€ğŸ‘¨â€ğŸ‘§â€ğŸ‘§	familia, hija, hijo, hombre, madre, mamÃ¡, niÃ±a, padre, papÃ¡, personas
ğŸ‘©â€ğŸ‘©â€ğŸ‘¦	familia, hija, hijo, madre, mamÃ¡, mujer, niÃ±o, padre, papÃ¡, personas
ğŸ‘©â€ğŸ‘©â€ğŸ‘§	familia, hija, hijo, madre, mamÃ¡, mujer, niÃ±a, padre, papÃ¡, personas
ğŸ‘©â€ğŸ‘©â€ğŸ‘§â€ğŸ‘¦	familia, hija, hijo, madre, mamÃ¡, mujer, niÃ±a, niÃ±o, padre, papÃ¡, personas
ğŸ‘©â€ğŸ‘©â€ğŸ‘¦â€ğŸ‘¦	familia, hija, hijo, madre, mamÃ¡, mujer, niÃ±o, padre, papÃ¡, personas
ğŸ‘©â€ğŸ‘©â€ğŸ‘§â€ğŸ‘§	familia, hija, hijo, madre, mamÃ¡, mujer, niÃ±a, padre, papÃ¡, personas
ğŸ‘¨â€ğŸ‘¦	familia, hija, hijo, hombre, madre, mamÃ¡, niÃ±o, padre, papÃ¡, personas
ğŸ‘¨â€ğŸ‘¦â€ğŸ‘¦	familia, hija, hijo, hombre, madre, mamÃ¡, niÃ±o, padre, papÃ¡, personas
ğŸ‘¨â€ğŸ‘§	familia, hija, hijo, hombre, madre, mamÃ¡, niÃ±a, padre, papÃ¡, personas
ğŸ‘¨â€ğŸ‘§â€ğŸ‘¦	familia, hija, hijo, hombre, madre, mamÃ¡, niÃ±a, niÃ±o, padre, papÃ¡, personas
ğŸ‘¨â€ğŸ‘§â€ğŸ‘§	familia, hija, hijo, hombre, madre, mamÃ¡, niÃ±a, padre, papÃ¡, personas
ğŸ‘©â€ğŸ‘¦	familia, hija, hijo, madre, mamÃ¡, mujer, niÃ±o, padre, papÃ¡, personas
ğŸ‘©â€ğŸ‘¦â€ğŸ‘¦	familia, hija, hijo, madre, mamÃ¡, mujer, niÃ±o, padre, papÃ¡, personas
ğŸ‘©â€ğŸ‘§	familia, hija, hijo, madre, mamÃ¡, mujer, niÃ±a, padre, papÃ¡, personas
ğŸ‘©â€ğŸ‘§â€ğŸ‘¦	familia, hija, hijo, madre, mamÃ¡, mujer, niÃ±a, niÃ±o, padre, papÃ¡, personas
ğŸ‘©â€ğŸ‘§â€ğŸ‘§	familia, hija, hijo, madre, mamÃ¡, mujer, niÃ±a, padre, papÃ¡, personas
ğŸ—£ï¸	cabeza, cara, hablar, silueta, silueta hablando
ğŸ‘£	cuerpo, huellas, pie, pisada
ğŸ¦	animal, gorila
ğŸ•ï¸	cachorro, perrito, perro
ğŸ©	animal, caniche, perro
ğŸº	animal, cara, lobo
ğŸˆï¸	gatito, gato, minino
ğŸ¦	animal, cara, leÃ³n
ğŸ¦„	animal, cara, unicornio
ğŸ·	animal, cara, cara de cerdo, cerdo, chancho
ğŸ–	animal, cerdo, chancho
ğŸ½	animal, cara, cerdo, chancho, hocico, hocico de cerdo
ğŸ»â€â„	blanco, oso polar, polar, Ã¡rtico
ğŸ¼	animal, cara, cara de panda, panda
ğŸ¦¨	apestar, hedor, mal olor, mofeta, peste, tufo, zorrino
ğŸ¾	animal, huella, pata, pezuÃ±a
ğŸ£	animal, cascarÃ³n, nacer, pollito, pollito rompiendo el cascarÃ³n
ğŸ¤	animal, ave, cara de pollito, pollito, pollo, polluelo
ğŸ¦…	animal, ave, Ã¡guila
ğŸ¦†	animal, ave, pato
ğŸ¦‰	animal, ave, bÃºho, lechuza
ğŸ¦	animal, lagartija, lagarto, reptil
ğŸ³	animal, ballena, ballena soplando un chorro de agua, chorro
ğŸ¦­	foca, leÃ³n marino, lobo marino
ğŸ 	animal, pez, tropical
ğŸ¦ˆ	animal, pez, tiburÃ³n
ğŸš	animal, caracol, caracola, caracola marina, marino
ğŸ¦‹	bonita, insecto, mariposa
ğŸ›	animal, insecto, oruga
ğŸ	animal, escarabajo, insecto, mariquita
ğŸ•¸ï¸	araÃ±a, tela, telaraÃ±a
ğŸ’®	flor, flor blanca, sello
ğŸ¥€	flor, marchita, tristeza
ğŸŒ±	hojas, plantita, plÃ¡ntula
ğŸŒ²	perenne, pino, siempreverde, Ã¡rbol, Ã¡rbol de hoja perenne
ğŸŒ³	caducas, caducifolio, hojas, Ã¡rbol, Ã¡rbol caducifolio
ğŸƒ	hoja al viento, hojas, soplar, viento
ğŸŒ	banana, fruta, planta
ğŸ	ananÃ¡, fruta, piÃ±a, planta
ğŸ	fruta, manzana, roja
ğŸ	fruta, manzana, verde
ğŸ‘	durazno
ğŸ’	cereza, cerezas, fruta, planta
ğŸ“	fruta, frutilla, planta
ğŸ¥‘	comida, fruta, palta
ğŸ†	berenjena, planta, vegetal, verdura
ğŸ¥”	comida, papa, patata, vegetal
ğŸ¥•	comida, vegetal, zanahoria
ğŸŒ½	choclo, mazorca, mazorca de maÃ­z, maÃ­z, planta
ğŸŒ¶ï¸	comida, picante, pimiento, pimiento picante
ğŸ¥’	comida, pepino, vegetal
ğŸ¥œ	comida, fruto seco, manÃ­, vegetal
ğŸŒ°	castaÃ±a, castaÃ±a de Indias, castaÃ±o, fruto seco
ğŸ	comida, pan, rodaja
ğŸ¥	comida, croissant, francÃ©s, medialuna
ğŸ¥–	baguette, comida, francÃ©s, pan
ğŸ¥	comida, dulce, hotcakes, panqueques
ğŸ§€	queso
ğŸ–	carne, carne con hueso, comida, hueso, restaurante
ğŸ—	comida, pata, pata de pollo, pollo, restaurante
ğŸ¥“	carne, comida, panceta, tocino
ğŸŸ	comida, hamburguesa, papas fritas
ğŸ•	comida, pizza, porciÃ³n, restaurante
ğŸŒ­	comida, pan, pancho, perrito, salchicha
ğŸŒ®	comida, mexicana, taco
ğŸŒ¯	burrito, comida, mexicana
ğŸ«”	comida, mexicana, tamal
ğŸ¥™	comida, fajita, gyro, kebab, relleno
ğŸ³	cocina, huevo, restaurante, sartÃ©n
ğŸ¥˜	comida, paella, sartÃ©n
ğŸ²	comida, olla, olla de comida, restaurante
ğŸ¥—	comida, ensalada
ğŸ¿	cine, maÃ­z, palomitas, palomitas de maÃ­z, pochoclo
ğŸ±	caja de bento, comida, japonesa, restaurante
ğŸ™	arroz, bola de arroz, comida, japonesa, onigiri, restaurante
ğŸš	arroz, arroz cocido, china, comida, japonesa, restaurante
ğŸ›	arroz, arroz con curry, comida, curry, restaurante
ğŸœ	bol de fideos, china, comida, fideos, ramen, tazÃ³n de fideos
ğŸ	comida, espagueti, espaguetis, pastas, restaurante
ğŸ 	asada, batata, batata asada, comida, restaurante
ğŸ¢	brocheta de mariscos, brochetas, brochettes, comida, japonesa, mariscos, restaurante
ğŸ£	comida, japonesa, sushi
ğŸ¤	camarones, camarones fritos, comida, japonesa, restaurante, tempura
ğŸ¥	comida, croqueta, pastel de pescado, pescado, restaurante
ğŸ¡	brocheta, brocheta dulce japonesa, comida, dango, dulce, japonesa, restaurante
ğŸ¦	camarÃ³n, comida, langostino, marisco
ğŸ¦	comida, dulce, frÃ­o, helado, helado en cucurucho, restaurante
ğŸ§	comida, dulce, frÃ­o, helado, hielo, hielo molido, restaurante
ğŸ¨	crema, dulce, helada, helado, postre
ğŸ©	comida, dona, dulce, postre, rosquilla
ğŸª	cafÃ©, comida, dulce, galleta, postre
ğŸ‚	celebraciÃ³n, cumpleaÃ±os, dulce, fiesta, torta, torta de cumpleaÃ±os, velas
ğŸ°	celebraciÃ³n, cumpleaÃ±os, dulce, fiesta, porciÃ³n de torta, torta, velas
ğŸ¬	caramelo, dulce, postre
ğŸ­	chupetÃ­n, dulce, golosina, paleta, paleta dulce
ğŸ¯	dulce, miel, pote, tarro, tarro de miel
ğŸ¼	bebÃ©, biberÃ³n, botella, leche, mamadera
ğŸµ	bebida, taza, taza de tÃ©, tazÃ³n de tÃ©, tÃ©
ğŸ¶	bar, bebida, botella, japonÃ©s, sake, tazÃ³n
ğŸ¾	bebida, botella, botella descorchada, celebrar, champaÃ±a, champÃ¡n, festejar
ğŸ·	bar, bebida, copa, copa de vino, restaurante, vino
ğŸ¹	bar, bebida, cÃ³ctel, restaurante, trago, tropical
ğŸº	bar, bebida, jarra, jarro, restaurante, tarro de cerveza
ğŸ»	bar, bebida, brindis, brindis con cerveza, celebrar, cerveza, festejar, jarra, jarro, restaurante
ğŸ¥‚	bebida, brindis, celebraciÃ³n, copas, copas brindando
ğŸ¥ƒ	licor, vaso, vaso de whisky, vaso pequeÃ±o, whisky
ğŸ§‹	burbuja, leche, perla, tÃ©, tÃ© de burbujas
ğŸ½ï¸	cubiertos, cuchillo, plato, plato y cubiertos, restaurante, tenedor
ğŸ´	cubiertos, cuchillo, cuchillo y tenedor, restaurante, tenedor
ğŸ¥„	cubiertos, cuchara, cucharita
ğŸ”ª	arma, cocina, cuchillo, cuchillo de cocina
ğŸº	jarra, vasija
ğŸŒ	Europa, globo, globo terrÃ¡queo Europa/Ãfrica, mapa, terrÃ¡queo, Ãfrica
ğŸŒï¸	AmÃ©rica, globo, globo terrÃ¡queo AmÃ©rica, mapa, terrÃ¡queo
ğŸŒ	Asia, Australia, OceanÃ­a, globo, globo terrÃ¡queo Asia/OceanÃ­a, mapa, terrÃ¡queo
ğŸŒ	Tierra, globo, globo terrÃ¡queo con meridianos, meridianos, mundo, paralelos, terrÃ¡queo
ğŸ—ºï¸	mapa, mapamundi, mundo
ğŸ”ï¸	frÃ­o, montaÃ±a, montaÃ±as nevadas, nieve
â›°ï¸	montaÃ±a, montaÃ±as
ğŸŒ‹	erupciÃ³n, fuego, volcÃ¡n
ğŸ—»	montaÃ±a, monte, monte Fuji
ğŸ•ï¸	acampar, campamento, carpa, vacaciones
ğŸ–ï¸	mar, playa, playa y sombrilla, sombrilla, vacaciones
ğŸï¸	atracciÃ³n, parque, parque nacional, vacaciones
ğŸ›ï¸	clÃ¡sico, edificio, monumento
ğŸ—ï¸	construcciÃ³n, edificio, edificio en construcciÃ³n
ğŸ˜ï¸	casas, viviendas
ğŸšï¸	abandonada, casa, deshabitada, edificio abandonado, inhabitada, vacÃ­a
ğŸ ï¸	casa, hogar, vivienda
ğŸ¡	casa, casa con jardÃ­n, hogar, jardÃ­n, vivienda
ğŸ£	correo, edificio, oficina, oficina de correo japonesa
ğŸ¤	correo, edificio, oficina, oficina de correo europea
ğŸ©	alojamiento, amor, edificio, hotel, motel
ğŸ«	edificio, escuela
ğŸ¬	centro, centro comercial, comercial, edificio, shopping, tienda
ğŸ¯	castillo, edificio, japonÃ©s
ğŸ°	Europa, castillo, castillo europeo, edificio
ğŸ’’	capilla, casamiento, casamiento en capilla, romance
ğŸ—½	Estados Unidos, Estatua de la Libertad, Nueva York, estatua, estatua de la libertad
ğŸ•Œ	edificio, islam, mezquita, musulmÃ¡n, religiÃ³n
ğŸ•	edificio, judaÃ­smo, religiÃ³n, sinagoga, templo
â›©ï¸	JapÃ³n, edificio, jinja, religiÃ³n, santuario, santuario sintoÃ­sta
ğŸ•‹	Kaaba, edificio, islam, musulmÃ¡n, religiÃ³n
â›ºï¸	acampar, campamento, camping, carpa
ğŸŒ	bruma, neblina, niebla
ğŸ™ï¸	ciudad, edificios, paisaje urbano
ğŸŒ„	amanecer, amanecer en las montaÃ±as, atardecer, montaÃ±a, sol
ğŸŒ…	amanecer, atardecer, puesta, sol
ğŸŒ‡	amanecer, atardecer, edificios, puesta, puesta de sol sobre edificios, sol
â™¨ï¸	aguas, caliente, fuentes termales, termales, termas, vapor
ğŸ 	caballo, caballo de carrusel, calesita, carrusel
ğŸ¡	diversiones, mundo, noria, parque, vuelta
ğŸ¢	diversiones, montaÃ±a, parque, rusa
ğŸ’ˆ	barbero, barberÃ­a, peluquerÃ­a
ğŸª	carpa, circo
ğŸš‚	ferrocarril, locomotora, transporte, tren, tren a vapor, viajar, viaje
ğŸšƒ	elÃ©ctrico, ferrocarril, tranvÃ­a, tren, tren elÃ©ctrico, vagÃ³n
ğŸš„	bala, ferrocarril, rÃ¡pido, transporte, tren, tren de alta velocidad, velocidad, viajar, viaje
ğŸš…	bala, ferrocarril, rÃ¡pido, transporte, tren, velocidad, viajar, viaje
ğŸš†	ferrocarril, transporte, tren, viajar, viaje
ğŸš‡ï¸	metro, subte, subterrÃ¡neo, transporte
ğŸš‰	estaciÃ³n de tren, ferrocarril, transporte, tranvÃ­a, tren
ğŸšŠ	transporte, tranvÃ­a
ğŸš	monocarril, monorriel, transporte, tren
ğŸš	ferrocarril, ferrocarril de montaÃ±a, montaÃ±a, transporte, tren, viajar, viaje
ğŸš‹	transporte, tranvÃ­a, vagÃ³n, vagÃ³n de tranvÃ­a
ğŸšŒ	autobÃºs, bus, colectivo, transporte
ğŸšï¸	autobÃºs, autobÃºs que llega, autobÃºs se aproxima, bus, colectivo, micro
ğŸš	combi, minibÃºs, transporte, van
ğŸš’	bomberos, camiÃ³n, camiÃ³n de bomberos, carro, transporte
ğŸš“	auto, auto de policÃ­a, patrullero, policÃ­a, transporte
ğŸš”ï¸	auto, patrullero, patrullero se aproxima, policÃ­a, transporte
ğŸš–	taxi, taxi se aproxima, transporte
ğŸš—	auto, automÃ³vil, carro, transporte
ğŸš˜ï¸	auto, auto se aproxima, automÃ³vil, carro, transporte
ğŸš™	auto, automÃ³vil, carro, transporte, vehÃ­culo deportivo utilitario, vehÃ­culo recreativo
ğŸ›»	camioneta, pickup
ğŸšš	camiÃ³n, camiÃ³n de reparto, reparto, transporte
ğŸš›	acoplado, camiÃ³n, camiÃ³n articulado, transporte
ğŸï¸	auto, auto de carrera, carrera
ğŸï¸	motocicleta
ğŸ›µ	moto
ğŸš²ï¸	bici, bicicleta, transporte
ğŸ›´	monopatÃ­n
ğŸ›¹	patineta, skateboard, tabla
ğŸ›¼	patines, patines quad, patÃ­n sobre ruedas, rollers
ğŸš	autobÃºs, bus, colectivo, parada, parada de autobÃºs
ğŸ›¤ï¸	ferrocarril, tren, vÃ­as
ğŸ›¢ï¸	barril, petrÃ³leo, tambor, tambor de petrÃ³leo
â›½ï¸	dispensador, estaciÃ³n, estaciÃ³n de gasolina, gasolina, nafta, servicio, surtidor
ğŸš¨	auto, luz, luz de patrullero, patrullero, policÃ­a, sirena, transporte
ğŸš¥	luces, semÃ¡foro, semÃ¡foro horizontal, trÃ¡fico, trÃ¡nsito
ğŸš¦	luces, semÃ¡foro, semÃ¡foro vertical, trÃ¡fico, trÃ¡nsito
ğŸ›‘	pare, seÃ±al, seÃ±al de pare, stop
ğŸš§	cartel, construcciÃ³n, peligro, seÃ±al de construcciÃ³n
âš“ï¸	ancla, barco, bote
â›µï¸	bote, mar, velero
ğŸ›¶	bote, canoa, remo
ğŸš¤	bote, lancha, vehÃ­culo
â›´ï¸	bote, ferry, transbordador, trasbordador, vehÃ­culo
ğŸ›¥ï¸	barco a motor, bote, motor, vehÃ­culo
ğŸš¢	barco, crucero, vehÃ­culo
âœˆï¸	aire, aviÃ³n, vehÃ­culo, viajar, viaje, volar
ğŸ›©ï¸	aire, avioneta, aviÃ³n, vehÃ­culo, viajar, viaje
ğŸ›«	aviÃ³n, aviÃ³n despegando, check, despegar, despegue, in, partida, salida
ğŸ›¬	arribo, aterrizaje, aterrizar, aviÃ³n, aviÃ³n aterrizando
ğŸ’º	asiento, asiento de transporte, silla
ğŸšŸ	suspensiÃ³n, tren, tren colgante, vehÃ­culo
ğŸš 	montaÃ±a, telefÃ©rico, tren, vehÃ­culo
ğŸš¡	aÃ©reo, colgante, montaÃ±a, tranvÃ­a, tranvÃ­a aÃ©reo, tren
ğŸ›°ï¸	espacio, satÃ©lite
ğŸš€	cohete, espacio
ğŸ›¸	ovni, platillo volador, platillo volante
ğŸ›ï¸	campana, campanilla de hotel, hotel
âŒ›ï¸	arena, reloj, reloj de arena sin tiempo
â³ï¸	arena, reloj, reloj de arena con tiempo, reloj de arena funcionando, temporizador
â°	alarma, despertador, reloj, reloj de alarma
â±ï¸	cronÃ³metro, reloj, segundos, tiempo
â²ï¸	reloj, segundos, temporizador, tiempo
ğŸ•°ï¸	decoraciÃ³n, reloj, reloj de repisa, repisa
ğŸ•›ï¸	12, 12 en punto, doce, punto, reloj
ğŸ•§	12, doce, doce y media, media, reloj
ğŸ•ï¸	1, 1 en punto, reloj, una
ğŸ•œ	1, media, reloj, una, una y media
ğŸ•‘ï¸	2, 2 en punto, dos, reloj
ğŸ•	2, dos, dos y media, media, reloj
ğŸ•’ï¸	3, 3 en punto, reloj, tres
ğŸ•	3, media, reloj, tres, tres y media
ğŸ•“ï¸	4, 4 en punto, cuatro, reloj
ğŸ•Ÿ	4, cuatro, cuatro y media, media, reloj
ğŸ•”ï¸	5, 5 en punto, cinco, reloj
ğŸ• 	5, cinco, cinco y media, media, reloj
ğŸ••ï¸	6, 6 en punto, reloj, seis
ğŸ•¡	6, media, reloj, seis, seis y media
ğŸ•–ï¸	7, 7 en punto, reloj, siete
ğŸ•¢	7, media, reloj, siete, siete y media
ğŸ•—ï¸	8, 8 en punto, ocho, reloj
ğŸ•£	8, media, ocho, ocho y media, reloj
ğŸ•˜ï¸	9, 9 en punto, nueve, reloj
ğŸ•¤	9, media, nueve, nueve y media, reloj
ğŸ•™ï¸	10, 10 en punto, diez, reloj
ğŸ•¥	10, diez, diez y media, media, reloj
ğŸ•šï¸	11, 11 en punto, once, reloj
ğŸ•¦	11, media, once, once y media, reloj
ğŸŒ‘	clima, espacio, luna, negra, nueva
ğŸŒ’	clima, creciente, espacio, luna, luna nueva visible, nueva, visible
ğŸŒ“	clima, creciente, cuarto, espacio, luna, luna en cuarto creciente
ğŸŒ”	clima, creciente, espacio, gibosa, luna
ğŸŒ•ï¸	clima, espacio, llena, luna
ğŸŒ–	clima, espacio, gibosa, luna, menguante
ğŸŒ—	clima, cuarto, espacio, luna, luna en cuarto menguante, menguante
ğŸŒ˜	clima, creciente, luna, luna creciente menguante, menguante
ğŸŒ™	clima, creciente, cuarto, espacio, luna, media luna
ğŸŒš	cara, luna, luna nueva con cara, nueva
ğŸŒ›	cara, creciente, cuarto, luna, luna de cuarto creciente con cara
ğŸŒœï¸	cara, cuarto, luna, luna de cuarto menguante con cara, menguante
ğŸŒ¡ï¸	clima, temperatura, termÃ³metro
â˜€ï¸	calor, estrella, rayos, sol
â­ï¸	blanca, estrella, estrella blanca
ğŸŒŸ	brillante, estrella
ğŸŒ 	espacio, estrella, fugaz
ğŸŒŒ	VÃ­a LÃ¡ctea, cielo, estrellas, galaxia, lÃ¡ctea, vÃ­a
â˜ï¸	nube, nublado, tiempo
â›…ï¸	nubes, nublado, parcialmente nublado, sol, soleado, tiempo
â›ˆï¸	lluvia, nube, tiempo, tormenta, trueno
ğŸŒ¤ï¸	clima, nube, sol, soleado con nubes
ğŸŒ¥ï¸	clima, nube, nublado
ğŸŒ¦ï¸	clima, lluvia, nube, sol, soleado con lluvia
ğŸŒ§ï¸	clima, lluvia, nube
ğŸŒ¨ï¸	clima, nieve, nube
ğŸŒ©ï¸	clima, nubes, nubes y relÃ¡mpagos, relÃ¡mpagos
ğŸŒªï¸	clima, nube, tornado, viento
ğŸŒ«ï¸	clima, neblina, nieve
ğŸŒ¬ï¸	cara, cara de viento, clima, soplar, viento
ğŸŒ€	ciclÃ³n, clima, huracÃ¡n, tifÃ³n, tornado
ğŸŒˆ	arcoÃ­ris, clima
ğŸŒ‚	clima, lluvia, lluvioso, paraguas
â˜‚ï¸	accesorio, clima, lluvia, paraguas, paraguas abierto
â˜”ï¸	accesorio, gotas, lluvia, paraguas, paraguas con gotas
â›±ï¸	arena, playa, sol, sombrilla, sombrilla en la arena
âš¡ï¸	alto voltaje, electricidad, peligro, tensiÃ³n, voltaje
â„ï¸	clima, copo de nieve, frÃ­o, nieve
â˜ƒï¸	clima, frÃ­o, invierno, muÃ±eco, muÃ±eco de nieve nevado, nieve
â›„ï¸	clima, frÃ­o, invierno, muÃ±eco, muÃ±eco de nieve, nieve
â˜„ï¸	espacio, estrella, meteorito
ğŸ’§	clima, cÃ³mic, frÃ­o, gota, sudar
ğŸŒŠ	mar, ocÃ©ano, ola
ğŸƒ	Halloween, calabaza, linterna
ğŸ„	celebraciÃ³n, navidad, Ã¡rbol, Ã¡rbol de Navidad
ğŸ†	artificiales, celebraciÃ³n, festejo, fiesta, fuegos
ğŸ‡	artificiales, bengala, celebraciÃ³n, festejo, fiesta, fuegos
âœ¨	brillo, chispas, estrella, estrellas
ğŸˆ	celebraciÃ³n, fiesta, globo
ğŸ‰	celebraciÃ³n, fiesta, lanzador de serpentina, serpentina
ğŸŠ	celebraciÃ³n, confeti, festejo, piÃ±ata
ğŸ‹	estrellas, festividad, fiesta, japonesa, papel, Ã¡rbol de tanabata
ğŸ	adorno para pinos, aÃ±o, japonÃ©s, nuevo, pino
ğŸ	JapÃ³n, festival, festividad, muÃ±eca, muÃ±ecas japonesas
ğŸ	bandera, banderÃ­n, banderÃ­n con forma de carpa, celebraciÃ³n, festejo, japonÃ©s
ğŸ	campanilla, campanilla de viento, viento
ğŸ‘	Otsukimi, celebraciÃ³n, ceremonia, ceremonia japonesa, luna
ğŸ€	celebraciÃ³n, cinta, festejo, moÃ±o, regalo
ğŸ	celebraciÃ³n, moÃ±o, presente, regalo
ğŸ—ï¸	cinta, cinta conmemorativa, conmemoraciÃ³n
ğŸŸï¸	entradas, evento
ğŸ«	boleto, entrada, entretenimiento
ğŸ†ï¸	copa, premio, trofeo
ğŸ…	deportes, medalla deportiva, triunfo
ğŸ¥‡	medalla, medalla de primer lugar, oro, primero
ğŸ¥ˆ	medalla, medalla de segundo lugar, plata, segundo
ğŸ¥‰	bronce, medalla, medalla de tercer lugar, tercero
âš½ï¸	fÃºtbol, pelota, pelota de fÃºtbol
âš¾ï¸	bÃ©isbol, pelota, pelota de bÃ©isbol
ğŸ€	bÃ¡squet, bÃ¡squetbol, cesto, deporte, pelota, pelota de bÃ¡squet
ğŸ	deporte, pelota, vÃ³leibol
ğŸˆ	americano, deporte, fÃºtbol, pelota, pelota de fÃºtbol americano
ğŸ‰	deporte, pelota, pelota de rugby, rugby
ğŸ¾	deporte, pelota, pelota de tenis, raqueta, tenis
ğŸ³	bola, boliche, bolos, bowling, juego
ğŸ	cricket, criquet, deporte, pelota
ğŸ‘	cÃ©sped, deporte, hockey, hockey sobre hierba, palo, pelota
ğŸ’	deporte, hielo, hockey, hockey sobre hielo, palo
ğŸ“	deporte, mesa, paleta, pelota, ping, pong, tenis de mesa
ğŸ¸	bÃ¡dminton, deporte, raqueta
ğŸ¥‹	artes marciales, deporte, judo, karate, taekwondo, uniforme, uniforme de artes marciales
ğŸ¥…	arco, deporte, porterÃ­a, red
â›¸ï¸	deporte, hielo, patinaje, patinaje sobre hielo
ğŸ£	caÃ±a, caÃ±a de pescar, libre, pesca, pescado, pescar, tiempo
ğŸ½	camiseta, camiseta para correr, correr, deporte, mangas, musculosa, sin
ğŸ¿	deporte, esquiar, esquÃ­s, nieve
ğŸ¯	centro, dardo, dardo en el centro, diana, juego, objetivo
ğŸ±	8, billar, bola, bola ocho, ocho, pool
ğŸ”®	adivinar, bola, bola de cristal, cristal, fantasÃ­a, futuro
ğŸ®ï¸	control, joystick, juego, mando, video, video juegos, videojuego
ğŸ•¹ï¸	control, joystick, juego, mando, video, videojuego
ğŸ°	apostar, apuestas, casino, juego, mÃ¡quina, tragamonedas
ğŸ§©	conectar, pieza, pieza de rompecabezas, pista, puzle, rompecabezas
ğŸª†	babushka, mamushka, matrioshka, matrioska, muÃ±eca rusa, rusia
â™ ï¸	cartas, juegos, naipes, palos, picas
â™¥ï¸	cartas, corazones, juegos, naipes, palos
â™¦ï¸	cartas, diamantes, juegos, naipes, palos
â™£ï¸	cartas, juegos, naipes, palos, trÃ©boles
ğŸƒ	carta, carta comodÃ­n, comodÃ­n, naipes
ğŸ€„ï¸	dragÃ³n, dragÃ³n rojo de mahjong, mahjong, mosaico, rojo
ğŸ´	Hanafuda, carta, flor, japonÃ©s, juego
ğŸ­ï¸	actuaciÃ³n, artes, mÃ¡scaras, mÃ¡scaras de teatro, teatro
ğŸ–¼ï¸	arte, cuadro enmarcado, marco, museo, pintura
ğŸ¨	arte, artista, paleta, paleta de pinturas, pintor, pintura
ğŸ‘“ï¸	gafas, lentes, ropa, vestimenta
ğŸ•¶ï¸	anteojos, anteojos de sol, gafas, oscuros, ropa, sol, vestimenta
ğŸ‘”	camisa, corbata, ropa, vestimenta
ğŸ‘•	camiseta, remera, ropa, vestimenta
ğŸ‘–	jeans, pantalones, ropa, vaquero, vestimenta
ğŸ‘—	ropa, vestido, vestimenta
ğŸ‘˜	japonÃ©s, kimono, ropa, vestido, vestimenta
ğŸ‘™	baÃ±o, bikini, nadar, pileta, piscina, ropa, traje, vestimenta
ğŸ‘š	blusa, mujer, ropa, ropa de mujer, vestimenta
ğŸ‘›	cartera, dinero, monedas, monedero, ropa, vestimenta
ğŸ‘œ	bolsa, bolso, cartera, cartera de mano, mujer, ropa, vestimenta
ğŸ‘	bolso, bolso de mano, cartera, ropa, sobre, vestimenta
ğŸ›ï¸	bolsa, bolsas de compras, compras
ğŸ’	escuela, estudiar, maletÃ­n, mochila
ğŸ©´	chancla, chancleta, chinela, sandalia
ğŸ‘	hombre, ropa, vestimenta, zapato, zapato de hombre
ğŸ‘Ÿ	deporte, ropa deportiva, vestimenta, zapato deportivo
ğŸ‘ 	mujer, tacÃ³n, zapato, zapato de taco alto, zapato de tacÃ³n
ğŸ‘¡	mujer, ropa, sandalia, sandalia de mujer, vestimenta
ğŸ‘¢	bota, bota de mujer, mujer, ropa, vestimenta
ğŸ‘‘	corona, reina, rey, ropa, vestimenta
ğŸ‘’	mujer, ropa, sombrero, sombrero de mujer, vestimenta
ğŸ©	caballero, copa, galera, hombre, sombrero
ğŸ“ï¸	birrete, celebraciÃ³n, gorro de graduaciÃ³n, graduaciÃ³n, graduado
â›‘ï¸	ayuda, casco, casco con cruz blanca, casco de rescatista
ğŸ“¿	collar, cuentas, oraciÃ³n, rosario
ğŸ’„	cosmÃ©ticos, labial, lÃ¡piz labial, maquillaje
ğŸ’	anillo, compromiso, romance
ğŸ’	diamante, joya, piedra preciosa
ğŸ“¢	altavoces, altavoz, altavoz de mano, estadio, parlante
ğŸ“£	altavoz, megÃ¡fono, parlante
ğŸ“¯	clarÃ­n, corneta, corneta de correo, correo, instrumento
ğŸ¼	clave, clave de sol, mÃºsica, partitura, pentagrama, sol
ğŸµ	corchea, mÃºsica, nota, nota musical
ğŸ¶	corchea, mÃºsica, nota, notas musicales
ğŸ™ï¸	estudio, grabaciÃ³n, micrÃ³fono, micrÃ³fono de grabaciÃ³n, voz
ğŸšï¸	control deslizante, deslizar, mÃºsica, nivel
ğŸ›ï¸	control, diales, mÃºsica, perillas, potenciÃ³metros, ruedas, ruedas de control
ğŸ¤	entretenimiento, karaoke, micrÃ³fono, mÃºsica
ğŸ§ï¸	auriculares, entretenimiento, mÃºsica
ğŸª—	acordeÃ³n, bandoneÃ³n, concertina, instrumento musical, mÃºsica
ğŸ¥	mÃºsica, palitos, tambor
ğŸ“²	celular, flecha, hacer llamada, mÃ³vil, telÃ©fono, telÃ©fono mÃ³vil con una flecha
â˜ï¸	cables, lÃ­nea, telÃ©fono, telÃ©fono de lÃ­nea
ğŸ“	comunicaciÃ³n, telÃ©fono, tubo
ğŸ“Ÿï¸	buscapersonas, comunicaciÃ³n
ğŸ”Œ	electricidad, enchufe, enchufe elÃ©ctrico
ğŸ’»ï¸	computadora, laptop, netbook, notebook, personal
ğŸ–¥ï¸	computadora, computadora de escritorio, escritorio
ğŸ–¨ï¸	accesorio, computadora, impresora
âŒ¨ï¸	accesorio, computadora, teclado
ğŸ–±ï¸	accesorio, computadora, mouse
ğŸ–²ï¸	accesorio, computadora, rueda de desplazamiento
ğŸ’½	computadora, disco, minidisc, minidisco
ğŸ’¾	disco, diskette, disquete, floppy
ğŸ’¿ï¸	Blu-ray, CD, DVD, disco, Ã³ptico
ğŸ“€	DVD, disco
ğŸ¥	cine, cÃ¡mara, entretenimiento, filmadora, pelÃ­cula
ğŸï¸	cine, cuadros de pelÃ­cula, pelÃ­cula
ğŸ“½ï¸	cine, pelÃ­culas, proyector, proyector de cine, video
ğŸ“ºï¸	TV, televisiÃ³n, televisor, video
ğŸ“·ï¸	cÃ¡mara, cÃ¡mara fotogrÃ¡fica, fotos
ğŸ“¹ï¸	cÃ¡mara, video, videocÃ¡mara
ğŸ“¼	cinta, cinta de video, video
ğŸ”	aumento, buscar, instrumento, lupa, lupa hacia la izquierda
ğŸ”	aumento, buscar, instrumento, lupa, lupa hacia la derecha
ğŸ•¯ï¸	cera, fuego, luz, vela
ğŸ’¡	cÃ³mic, idea, lamparita, lÃ¡mpara
ğŸ®	farol, farol de papel japonÃ©s, izakaya, linterna, papel, restaurante, roja
ğŸ“”	cuaderno, cuaderno con tapa decorativa, decorado, tapa
ğŸ“™	libro, libro anaranjado, naranja
ğŸ“šï¸	libro, libros, pila
ğŸ““	cuaderno, negro
ğŸ“’	contabilidad, libro, libro de contabilidad
ğŸ“ƒ	doblada, documento doblado, pÃ¡gina
ğŸ“„	documento, frente, hoja, pÃ¡gina
ğŸ“°	diario, noticias, periÃ³dico
ğŸ—	diario, noticias, periÃ³dico, periÃ³dico enrollado
ğŸ“‘	marcador, pestaÃ±as, pestaÃ±as de marcador
ğŸ’°ï¸	bolsa, bolsa de dinero, dinero, dÃ³lares
ğŸ’´	billete, billete de yen, dinero, yen
ğŸ’µ	billete, billete de dÃ³lar, dinero, dÃ³lar
ğŸ’¶	billete, billete de euro, dinero, euro
ğŸ’·	billete, billete de libra, dinero, libra
ğŸ’¸	alas, billete con alas, billetes, dinero, dÃ³lares
ğŸ’¹	dinero, grÃ¡fico, mercado, mercado en alza, tendencia, yen
ğŸ“§	comunicaciÃ³n, correo, electrÃ³nico, sobre
ğŸ“¨	carta, comunicaciÃ³n, correo, electrÃ³nico, mensaje, mensaje entrante, recibido, sobre
ğŸ“©	carta, comunicaciÃ³n, correo electrÃ³nico, enviado, mensaje, mensaje saliente, sobre
ğŸ“¤ï¸	bandeja, bandeja de salida, comunicaciÃ³n, correo, enviados, salida, saliente
ğŸ“¥ï¸	bandeja, bandeja de entrada, comunicaciÃ³n, correo, entrada, entrante, recibidos
ğŸ“«ï¸	bandera, buzÃ³n, buzÃ³n cerrado bandera levantada, correo
ğŸ“ªï¸	bandera, buzÃ³n, buzÃ³n cerrado bandera baja, correo
ğŸ“¬ï¸	bandera, buzÃ³n, buzÃ³n abierto bandera levantada, correo
ğŸ“­ï¸	bandera, buzÃ³n, buzÃ³n abierto bandera baja, correo
ğŸ—³ï¸	elecciones, urna, urna con papeleta, votaciÃ³n
âœï¸	escolar, escribir, lÃ¡piz, Ãºtil
âœ’ï¸	lapicera, lapicera de pluma, pluma, tinta
ğŸ–‹ï¸	lapicera, pluma, pluma fuente, tinta
ğŸ–Šï¸	bolÃ­grafo, escribir, lapicera
ğŸ–ï¸	crayÃ³n, dibujar, pintar
ğŸ“	comunicaciÃ³n, memo, nota, recordatorio
ğŸ—‚ï¸	archivos, separadores para tarjetas, Ã­ndice
ğŸ“…	calendario, cita, fecha, reuniÃ³n
ğŸ“†	calendario, calendario con hojas, hojas
ğŸ—’ï¸	anotador, bloc de notas con espiral, escribir, notas
ğŸ—“ï¸	calendario, calendario con espiral, fechas
ğŸ“‡	Rolodex, organizador de fichas, Ã­ndice
ğŸ“ˆ	alza, ascendente, aumentar, grÃ¡fico, mejor, mejorar, tabla, tendencia ascendente
ğŸ“‰	alza, descendente, disminuir, empeorar, grÃ¡fico, peor, reducir, tabla, tendencia descendente
ğŸ“‹ï¸	carpeta, portapapeles, sujetapapeles
ğŸ“Œ	chinche, chincheta, tachuela
ğŸ“	chinche, chincheta, chincheta redonda, tachuela
ğŸ“	clip, clip para hojas, hojas, papel
ğŸ–‡ï¸	clips, unidos
ğŸ“	regla, regla recta
ğŸ“	escuadra, regla, triangular
ğŸ—ƒï¸	archivos, caja, organizador de tarjetas
ğŸ—‘ï¸	basura, cesto, papeles
ğŸ”’ï¸	candado, cerrado
ğŸ”“ï¸	abierto, candado
ğŸ”	candado, candado y lapicera, lapicera, pluma
ğŸ”	candado, candado cerrado y llave, cerrado, llave
â›ï¸	herramienta, minerÃ­a, pico
âš’ï¸	herramientas, martillo, martillo y pico, pico
ğŸ› ï¸	herramienta, inglesa, llave, martillo, martillo y llave inglesa
ğŸ—¡ï¸	armas, cuchillo, daga
âš”ï¸	armas, espadas, espadas cruzadas
ğŸ›¡ï¸	escudo, protecciÃ³n
ğŸ”©	herramienta, perno, perno con tuerca, tuerca
ğŸ”—	cadena, enlace, eslabones, eslabones de cadena, vÃ­nculo
âš—ï¸	alambique, destilar, herramienta, quÃ­mica
ğŸ“¡	antena, antena de satÃ©lite, antena satelital, comunicaciÃ³n, satÃ©lite
ğŸ’‰	aguja, inyecciÃ³n, jeringa, medicina, mÃ©dico
ğŸ’Š	medicamento, medicina, mÃ©dico, pastilla, pÃ­ldora
ğŸ›’	carriito, carrito de compras, carro, compras, supermercado, tienda
ğŸš¬	cigarrillo, fumar, permitido
âš±ï¸	funeral, muerte, urna, urna funeraria
ğŸ—¿	MoÃ¡i, Pascua, estatua, estatua de la isla de Pascua, isla
ğŸ§	atm, banco, cajero, cajero automÃ¡tico, seÃ±al de cajero automÃ¡tico
ğŸš®	basura, cartel cesto de basura, papelera, seÃ±al, seÃ±al de usar papelera, tirar la basura en la papelera
â™¿ï¸	acceso, acceso para silla de ruedas, seÃ±al, silla de ruedas
ğŸš¹ï¸	aseo de caballeros, aseo para hombres, baÃ±o, servicio, seÃ±al, seÃ±al con un hombre, sÃ­mbolo de hombre
ğŸšºï¸	aseo de seÃ±oras, baÃ±o, servicio, seÃ±al, seÃ±al con una mujer, seÃ±al de aseo para mujeres, sÃ­mbolo de mujer
ğŸš»	baÃ±o, pÃºblico, servicios, seÃ±al, seÃ±al de baÃ±o
ğŸš¼ï¸	bebÃ©, bordo, cambiador, seÃ±al, seÃ±al de bebÃ©
ğŸš¾	baÃ±o, servicios, seÃ±al
ğŸ›‚	control, control de pasaportes, inspecciÃ³n de pasaportes, pasaportes
ğŸ›„	equipaje, reclamo, reclamo de equipaje, seÃ±al
ğŸ›…	depÃ³sito, depÃ³sito de equipaje, equipaje, locker, seÃ±al
ğŸš¸	cruce de niÃ±os, niÃ±os, seÃ±al
â›”ï¸	entrar, no, pasar, prohibido, prohibido entrar, seÃ±al
ğŸš«	entrar, no, pasar, prohibido, seÃ±al, seÃ±al de prohibiciÃ³n
ğŸš³	bicicletas, no se permiten bicicletas, prohibido, seÃ±al, vehÃ­culo
ğŸ“µ	mÃ³vil, no hacer llamadas, no se permiten celulares, prohibido, prohibido el uso de mÃ³viles, telÃ©fono
ğŸ”	prohibido, prohibido para menores de 18, prohibido para menores de 18 aÃ±os, prohibido para menos de 18 aÃ±os
â˜£ï¸	biolÃ³gico, peligro, peligro biolÃ³gico, seÃ±al
ğŸ”„	flechas, flechas horizontales en sentido horario, flechas horizontales sentido horario, horario, seÃ±al de recarga
ğŸ›	lugar, lugar de culto, lugar de oraciÃ³n, oraciÃ³n, religiÃ³n
âš›ï¸	ateo, sÃ­mbolo atÃ³mico, sÃ­mbolo de Ã¡tomo, Ã¡tomo
â˜¸ï¸	dharma
â˜¦ï¸	cristianismo, cruz, ortodoxa, religiÃ³n
â˜ªï¸	estrella, estrella y creciente, islam, luna, media luna y estrella, religiÃ³n
ğŸ•	candelabro, judaÃ­smo, judÃ­o, menorÃ¡, religiÃ³n
â™ˆï¸	Aries, aries, carnero, zodÃ­aco
â™‰ï¸	Tauro, buey, tauro, toro, zodÃ­aco
â™Šï¸	GÃ©minis, gÃ©minis, mellizos, zodÃ­aco
â™‹ï¸	CÃ¡ncer, cangrejo, cÃ¡ncer, zodÃ­aco
â™Œï¸	Leo, leo, leÃ³n, zodÃ­aco
â™ï¸	Virgo, virgen, virgo, zodÃ­aco
â™ï¸	Libra, balanza, justicia, libra, zodÃ­aco
â™ï¸	Escorpio, escorpio, escorpiÃ³n, zodÃ­aco
â™ï¸	Sagitario, arquero, sagitario, zodÃ­aco
â™‘ï¸	Capricornio, cabra, capricornio, zodÃ­aco
â™’ï¸	Acuario, acuario, agua, zodÃ­aco
â™“ï¸	Piscis, pez, piscis, zodÃ­aco
â›	Ofiuco, ofiuco, serpiente, zodÃ­aco
ğŸ”	flechas, mÃºsica, repetir, todo
ğŸ”‚	flechas, mÃºsica, repetir, repetir una vez, uno
â©	adelantar, avance, botÃ³n, mÃºsica, rÃ¡pido
â­	adelantar, avanzar, avanzar a la pista siguiente, botÃ³n, mÃºsica, siguiente
â¯	botÃ³n, mÃºsica, pausa, pausar o reproducir, triÃ¡ngulo
â—€	botÃ³n, mÃºsica, retroceder
âª	botÃ³n, mÃºsica, retroceso, retroceso rÃ¡pido, rÃ¡pido
â®	anterior, botÃ³n, mÃºsica, Ãºltima pista
ğŸ”½	abajo, bajar, botÃ³n, botÃ³n hacia abajo, flecha
â¬	abajo, bajar, botÃ³n, doble, flecha, triÃ¡ngulo doble hacia abajo
â¸ï¸	barras, botÃ³n, mÃºsica, pausa, verticales
â¹ï¸	botÃ³n, cuadrado, detener, mÃºsica
âºï¸	botÃ³n, cÃ­rculo, grabar, mÃºsica
âï¸	botÃ³n, expulsar, mÃºsica
ğŸ¦	botÃ³n, cine, cÃ¡mara, filmar
ğŸ“¶	antena, barras de cobertura, celular, cobertura, telÃ©fono
ğŸ“³	celular, modo vibraciÃ³n, mÃ³vil, telÃ©fono, vibraciÃ³n
ğŸ“´	apagado, celular, celular apagado, mÃ³vil, telÃ©fono
â•	suma
â–	resta
â”	?, interrogaciÃ³n, interrogaciÃ³n blanca, pregunta, puntuaciÃ³n, signo de interrogaciÃ³n gris
â•	!, exclamaciÃ³n, exclamaciÃ³n blanca, puntuaciÃ³n, signo de exclamaciÃ³n gris
ã€°ï¸	guion, lÃ­nea ondulada, marca de sonido largo, ondulado
ğŸ’±	cambio, cambio de divisa, cambio de divisas, dinero, divisa
ğŸ“›	identificaciÃ³n, identificaciÃ³n con nombre, nombre, prendedor
ğŸ”°	amarillo, japonÃ©s, principiante, sÃ­mbolo japonÃ©s de principiante, sÃ­mbolo japonÃ©s para principiante, verde
â˜‘ï¸	casilla, casilla con marca de verificaciÃ³n, casilla seleccionada, marca, selecciÃ³n, verificaciÃ³n, âœ“
âœ”ï¸	marca, marca de verificaciÃ³n, marca de verificaciÃ³n grande, selecciÃ³n, verificaciÃ³n, âœ“
âŒ	cruz
â	botÃ³n con marca de cruz, casilla, cruz, cruz con recuadro, marca, x, Ã—
ã€½ï¸	alternancia
Â©ï¸	autor, copyright, derechos, signo de derechos autor
Â®ï¸	marca, registrada, signo de marca registrada
â„¢ï¸	marca, registrada, sÃ­mbolo, sÃ­mbolo de marca comercial, sÃ­mbolo de marca registrada
#âƒ£	tecla mayus, tecla mayus: #
*âƒ£	tecla mayus, tecla mayus: *
0âƒ£	tecla mayus, tecla mayus: 0
1âƒ£	tecla mayus, tecla mayus: 1
2âƒ£	tecla mayus, tecla mayus: 2
3âƒ£	tecla mayus, tecla mayus: 3
4âƒ£	tecla mayus, tecla mayus: 4
5âƒ£	tecla mayus, tecla mayus: 5
6âƒ£	tecla mayus, tecla mayus: 6
7âƒ£	tecla mayus, tecla mayus: 7
8âƒ£	tecla mayus, tecla mayus: 8
9âƒ£	tecla mayus, tecla mayus: 9
ğŸ”Ÿ	tecla mayus, tecla mayus: 10
ğŸ†‘	CL, borrar, borrar recuadrado, botÃ³n CL, cuadrado
ğŸ†’	botÃ³n COOL, cool, cuadrado, genial
ğŸ†“	cuadrado, free, gratis, libre
â“‚ï¸	M, letra, letra m en un cÃ­rculo, metro
ğŸ…¿ï¸	P, estacionamiento, letra
ğŸ†˜	auxilio, ayuda, socorro, sos, sÃ­mbolo, sÃ­mbolo de socorro
ğŸ”´	cÃ­rculo rojo
ğŸ”µ	cÃ­rculo azul
âšªï¸	blanco, cÃ­rculo, grande
â¬›ï¸	cuadrado, grande, negro
â¬œï¸	blanco, cuadrado, grande
â—¼ï¸	cuadrado, mediano, negro
â—»ï¸	blanco, cuadrado, mediano
â—¾ï¸	cuadrado, cuadrado negro mediano-pequeÃ±o, mediano, negro, pequeÃ±o
â—½ï¸	blanco, cuadrado, cuadrado blanco mediano-pequeÃ±o, mediano, pequeÃ±o
â–ªï¸	cuadrado, negro, pequeÃ±o
â–«ï¸	blanco, cuadrado, pequeÃ±o
ğŸ”¶	anaranjado, diamante, diamante naranja grande, naranja
ğŸ”·	azul, diamante, diamante azul grande
ğŸ”¸	anaranjado, diamante, diamante naranja pequeÃ±o, naranja
ğŸ”¹	azul, diamante, diamante azul pequeÃ±o, rombo azul pequeÃ±o
ğŸ’ 	cÃ³mic, diamante, flor, pÃ©talo de flor, rombo con pÃ©talo
ğŸ”˜	botÃ³n, botÃ³n de opciÃ³n, botÃ³n de radio, radio
ğŸ”³	blanco, borde, botÃ³n, cuadrado, cuadrado negro con borde blanco, marco, negro
ğŸ”²	blanco, borde, botÃ³n, cuadrado, cuadrado blanco con borde negro, marco, negro
ğŸš©	bandera, bandera de ubicaciÃ³n, banderÃ­n, triangular, ubicaciÃ³n
ğŸ³ï¸	bandera, blanca, paz
ğŸ³â€ğŸŒˆ	arcoÃ­ris, bandera, bandera del arcoÃ­ris, orgullo
ğŸ³â€âš§	LGTB, bandera, blanco, celeste, rosa, transgÃ©nero
ğŸ‡¦ğŸ‡¨	bandera, bandera: Isla AscensiÃ³n
ğŸ‡¦ğŸ‡©	bandera, bandera: Andorra
ğŸ‡¦ğŸ‡ª	bandera, bandera: Emiratos Ãrabes Unidos
ğŸ‡¦ğŸ‡«	bandera, bandera: AfganistÃ¡n
ğŸ‡¦ğŸ‡¬	bandera, bandera: Antigua y Barbuda
ğŸ‡¦ğŸ‡®	bandera, bandera: Anguila
ğŸ‡¦ğŸ‡±	bandera, bandera: Albania
ğŸ‡¦ğŸ‡²	bandera, bandera: Armenia
ğŸ‡¦ğŸ‡´	bandera, bandera: Angola
ğŸ‡¦ğŸ‡¶	bandera, bandera: AntÃ¡rtida
ğŸ‡¦ğŸ‡·	bandera, bandera: Argentina
ğŸ‡¦ğŸ‡¸	bandera, bandera: Samoa Americana
ğŸ‡¦ğŸ‡¹	bandera, bandera: Austria
ğŸ‡¦ğŸ‡º	bandera, bandera: Australia
ğŸ‡¦ğŸ‡¼	bandera, bandera: Aruba
ğŸ‡¦ğŸ‡½	bandera, bandera: Islas Ã…land
ğŸ‡¦ğŸ‡¿	bandera, bandera: AzerbaiyÃ¡n
ğŸ‡§ğŸ‡¦	bandera, bandera: Bosnia-Herzegovina
ğŸ‡§ğŸ‡§	bandera, bandera: Barbados
ğŸ‡§ğŸ‡©	bandera, bandera: BangladÃ©s
ğŸ‡§ğŸ‡ª	bandera, bandera: BÃ©lgica
ğŸ‡§ğŸ‡«	bandera, bandera: Burkina Faso
ğŸ‡§ğŸ‡¬	bandera, bandera: Bulgaria
ğŸ‡§ğŸ‡­	bandera, bandera: BarÃ©in
ğŸ‡§ğŸ‡®	bandera, bandera: Burundi
ğŸ‡§ğŸ‡¯	bandera, bandera: BenÃ­n
ğŸ‡§ğŸ‡±	bandera, bandera: San BartolomÃ©
ğŸ‡§ğŸ‡²	bandera, bandera: Bermudas
ğŸ‡§ğŸ‡³	bandera, bandera: BrunÃ©i
ğŸ‡§ğŸ‡´	bandera, bandera: Bolivia
ğŸ‡§ğŸ‡¶	bandera, bandera: Caribe neerlandÃ©s
ğŸ‡§ğŸ‡·	bandera, bandera: Brasil
ğŸ‡§ğŸ‡¸	bandera, bandera: Bahamas
ğŸ‡§ğŸ‡¹	bandera, bandera: ButÃ¡n
ğŸ‡§ğŸ‡»	bandera, bandera: Isla Bouvet
ğŸ‡§ğŸ‡¼	bandera, bandera: Botsuana
ğŸ‡§ğŸ‡¾	bandera, bandera: Bielorrusia
ğŸ‡§ğŸ‡¿	bandera, bandera: Belice
ğŸ‡¨ğŸ‡¦	bandera, bandera: CanadÃ¡
ğŸ‡¨ğŸ‡¨	bandera, bandera: Islas Cocos
ğŸ‡¨ğŸ‡©	bandera, bandera: RepÃºblica DemocrÃ¡tica del Congo
ğŸ‡¨ğŸ‡«	bandera, bandera: RepÃºblica Centroafricana
ğŸ‡¨ğŸ‡¬	bandera, bandera: RepÃºblica del Congo
ğŸ‡¨ğŸ‡­	bandera, bandera: Suiza
ğŸ‡¨ğŸ‡®	bandera, bandera: Costa de Marfil
ğŸ‡¨ğŸ‡°	bandera, bandera: Islas Cook
ğŸ‡¨ğŸ‡±	bandera, bandera: Chile
ğŸ‡¨ğŸ‡²	bandera, bandera: CamerÃºn
ğŸ‡¨ğŸ‡³	bandera, bandera: China
ğŸ‡¨ğŸ‡´	bandera, bandera: Colombia
ğŸ‡¨ğŸ‡µ	bandera, bandera: Isla Clipperton
ğŸ‡¨ğŸ‡·	bandera, bandera: Costa Rica
ğŸ‡¨ğŸ‡º	bandera, bandera: Cuba
ğŸ‡¨ğŸ‡»	bandera, bandera: Cabo Verde
ğŸ‡¨ğŸ‡¼	bandera, bandera: Curazao
ğŸ‡¨ğŸ‡½	bandera, bandera: Isla de Navidad
ğŸ‡¨ğŸ‡¾	bandera, bandera: Chipre
ğŸ‡¨ğŸ‡¿	bandera, bandera: Chequia
ğŸ‡©ğŸ‡ª	bandera, bandera: Alemania
ğŸ‡©ğŸ‡¬	bandera, bandera: Diego GarcÃ­a
ğŸ‡©ğŸ‡¯	bandera, bandera: Yibuti
ğŸ‡©ğŸ‡°	bandera, bandera: Dinamarca
ğŸ‡©ğŸ‡²	bandera, bandera: Dominica
ğŸ‡©ğŸ‡´	bandera, bandera: RepÃºblica Dominicana
ğŸ‡©ğŸ‡¿	bandera, bandera: Argelia
ğŸ‡ªğŸ‡¦	bandera, bandera: Ceuta y Melilla
ğŸ‡ªğŸ‡¨	bandera, bandera: Ecuador
ğŸ‡ªğŸ‡ª	bandera, bandera: Estonia
ğŸ‡ªğŸ‡¬	bandera, bandera: Egipto
ğŸ‡ªğŸ‡­	bandera, bandera: SÃ¡hara Occidental
ğŸ‡ªğŸ‡·	bandera, bandera: Eritrea
ğŸ‡ªğŸ‡¸	bandera, bandera: EspaÃ±a
ğŸ‡ªğŸ‡¹	bandera, bandera: EtiopÃ­a
ğŸ‡ªğŸ‡º	bandera, bandera: UniÃ³n Europea
ğŸ‡«ğŸ‡®	bandera, bandera: Finlandia
ğŸ‡«ğŸ‡¯	bandera, bandera: Fiyi
ğŸ‡«ğŸ‡°	bandera, bandera: Islas Malvinas
ğŸ‡«ğŸ‡²	bandera, bandera: Micronesia
ğŸ‡«ğŸ‡´	bandera, bandera: Islas Feroe
ğŸ‡«ğŸ‡·	bandera, bandera: Francia
ğŸ‡¬ğŸ‡¦	bandera, bandera: GabÃ³n
ğŸ‡¬ğŸ‡§	bandera, bandera: Reino Unido
ğŸ‡¬ğŸ‡©	bandera, bandera: Granada
ğŸ‡¬ğŸ‡ª	bandera, bandera: Georgia
ğŸ‡¬ğŸ‡«	bandera, bandera: Guayana Francesa
ğŸ‡¬ğŸ‡¬	bandera, bandera: Guernesey
ğŸ‡¬ğŸ‡­	bandera, bandera: Ghana
ğŸ‡¬ğŸ‡®	bandera, bandera: Gibraltar
ğŸ‡¬ğŸ‡±	bandera, bandera: Groenlandia
ğŸ‡¬ğŸ‡²	bandera, bandera: Gambia
ğŸ‡¬ğŸ‡³	bandera, bandera: Guinea
ğŸ‡¬ğŸ‡µ	bandera, bandera: Guadalupe
ğŸ‡¬ğŸ‡¶	bandera, bandera: Guinea Ecuatorial
ğŸ‡¬ğŸ‡·	bandera, bandera: Grecia
ğŸ‡¬ğŸ‡¸	bandera, bandera: Islas Georgia del Sur y Sandwich del Sur
ğŸ‡¬ğŸ‡¹	bandera, bandera: Guatemala
ğŸ‡¬ğŸ‡º	bandera, bandera: Guam
ğŸ‡¬ğŸ‡¼	bandera, bandera: Guinea-BisÃ¡u
ğŸ‡¬ğŸ‡¾	bandera, bandera: Guyana
ğŸ‡­ğŸ‡°	bandera, bandera: RAE de Hong Kong (China)
ğŸ‡­ğŸ‡²	bandera, bandera: Islas Heard y McDonald
ğŸ‡­ğŸ‡³	bandera, bandera: Honduras
ğŸ‡­ğŸ‡·	bandera, bandera: Croacia
ğŸ‡­ğŸ‡¹	bandera, bandera: HaitÃ­
ğŸ‡­ğŸ‡º	bandera, bandera: HungrÃ­a
ğŸ‡®ğŸ‡¨	bandera, bandera: Islas Canarias
ğŸ‡®ğŸ‡©	bandera, bandera: Indonesia
ğŸ‡®ğŸ‡ª	bandera, bandera: Irlanda
ğŸ‡®ğŸ‡±	bandera, bandera: Israel
ğŸ‡®ğŸ‡²	bandera, bandera: Isla de Man
ğŸ‡®ğŸ‡³	bandera, bandera: India
ğŸ‡®ğŸ‡´	bandera, bandera: Territorio BritÃ¡nico del OcÃ©ano Ãndico
ğŸ‡®ğŸ‡¶	bandera, bandera: Irak
ğŸ‡®ğŸ‡·	bandera, bandera: IrÃ¡n
ğŸ‡®ğŸ‡¸	bandera, bandera: Islandia
ğŸ‡®ğŸ‡¹	bandera, bandera: Italia
ğŸ‡¯ğŸ‡ª	bandera, bandera: Jersey
ğŸ‡¯ğŸ‡²	bandera, bandera: Jamaica
ğŸ‡¯ğŸ‡´	bandera, bandera: Jordania
ğŸ‡¯ğŸ‡µ	bandera, bandera: JapÃ³n
ğŸ‡°ğŸ‡ª	bandera, bandera: Kenia
ğŸ‡°ğŸ‡¬	bandera, bandera: KirguistÃ¡n
ğŸ‡°ğŸ‡­	bandera, bandera: Camboya
ğŸ‡°ğŸ‡®	bandera, bandera: Kiribati
ğŸ‡°ğŸ‡²	bandera, bandera: Comoras
ğŸ‡°ğŸ‡³	bandera, bandera: San CristÃ³bal y Nieves
ğŸ‡°ğŸ‡µ	bandera, bandera: Corea del Norte
ğŸ‡°ğŸ‡·	bandera, bandera: Corea del Sur
ğŸ‡°ğŸ‡¼	bandera, bandera: Kuwait
ğŸ‡°ğŸ‡¾	bandera, bandera: Islas CaimÃ¡n
ğŸ‡°ğŸ‡¿	bandera, bandera: KazajistÃ¡n
ğŸ‡±ğŸ‡¦	bandera, bandera: Laos
ğŸ‡±ğŸ‡§	bandera, bandera: LÃ­bano
ğŸ‡±ğŸ‡¨	bandera, bandera: Santa LucÃ­a
ğŸ‡±ğŸ‡®	bandera, bandera: Liechtenstein
ğŸ‡±ğŸ‡°	bandera, bandera: Sri Lanka
ğŸ‡±ğŸ‡·	bandera, bandera: Liberia
ğŸ‡±ğŸ‡¸	bandera, bandera: Lesoto
ğŸ‡±ğŸ‡¹	bandera, bandera: Lituania
ğŸ‡±ğŸ‡º	bandera, bandera: Luxemburgo
ğŸ‡±ğŸ‡»	bandera, bandera: Letonia
ğŸ‡±ğŸ‡¾	bandera, bandera: Libia
ğŸ‡²ğŸ‡¦	bandera, bandera: Marruecos
ğŸ‡²ğŸ‡¨	bandera, bandera: MÃ³naco
ğŸ‡²ğŸ‡©	bandera, bandera: Moldavia
ğŸ‡²ğŸ‡ª	bandera, bandera: Montenegro
ğŸ‡²ğŸ‡«	bandera, bandera: San MartÃ­n
ğŸ‡²ğŸ‡¬	bandera, bandera: Madagascar
ğŸ‡²ğŸ‡­	bandera, bandera: Islas Marshall
ğŸ‡²ğŸ‡°	bandera, bandera: Macedonia del Norte
ğŸ‡²ğŸ‡±	bandera, bandera: Mali
ğŸ‡²ğŸ‡²	bandera, bandera: Myanmar (Birmania)
ğŸ‡²ğŸ‡³	bandera, bandera: Mongolia
ğŸ‡²ğŸ‡´	bandera, bandera: RAE de Macao (China)
ğŸ‡²ğŸ‡µ	bandera, bandera: Islas Marianas del Norte
ğŸ‡²ğŸ‡¶	bandera, bandera: Martinica
ğŸ‡²ğŸ‡·	bandera, bandera: Mauritania
ğŸ‡²ğŸ‡¸	bandera, bandera: Montserrat
ğŸ‡²ğŸ‡¹	bandera, bandera: Malta
ğŸ‡²ğŸ‡º	bandera, bandera: Mauricio
ğŸ‡²ğŸ‡»	bandera, bandera: Maldivas
ğŸ‡²ğŸ‡¼	bandera, bandera: Malaui
ğŸ‡²ğŸ‡½	bandera, bandera: MÃ©xico
ğŸ‡²ğŸ‡¾	bandera, bandera: Malasia
ğŸ‡²ğŸ‡¿	bandera, bandera: Mozambique
ğŸ‡³ğŸ‡¦	bandera, bandera: Namibia
ğŸ‡³ğŸ‡¨	bandera, bandera: Nueva Caledonia
ğŸ‡³ğŸ‡ª	bandera, bandera: NÃ­ger
ğŸ‡³ğŸ‡«	bandera, bandera: Isla Norfolk
ğŸ‡³ğŸ‡¬	bandera, bandera: Nigeria
ğŸ‡³ğŸ‡®	bandera, bandera: Nicaragua
ğŸ‡³ğŸ‡±	bandera, bandera: PaÃ­ses Bajos
ğŸ‡³ğŸ‡´	bandera, bandera: Noruega
ğŸ‡³ğŸ‡µ	bandera, bandera: Nepal
ğŸ‡³ğŸ‡·	bandera, bandera: Nauru
ğŸ‡³ğŸ‡º	bandera, bandera: Niue
ğŸ‡³ğŸ‡¿	bandera, bandera: Nueva Zelanda
ğŸ‡´ğŸ‡²	bandera, bandera: OmÃ¡n
ğŸ‡µğŸ‡¦	bandera, bandera: PanamÃ¡
ğŸ‡µğŸ‡ª	bandera, bandera: PerÃº
ğŸ‡µğŸ‡«	bandera, bandera: Polinesia Francesa
ğŸ‡µğŸ‡¬	bandera, bandera: PapÃºa Nueva Guinea
ğŸ‡µğŸ‡­	bandera, bandera: Filipinas
ğŸ‡µğŸ‡°	bandera, bandera: PakistÃ¡n
ğŸ‡µğŸ‡±	bandera, bandera: Polonia
ğŸ‡µğŸ‡²	bandera, bandera: San Pedro y MiquelÃ³n
ğŸ‡µğŸ‡³	bandera, bandera: Islas Pitcairn
ğŸ‡µğŸ‡·	bandera, bandera: Puerto Rico
ğŸ‡µğŸ‡¸	bandera, bandera: Territorios Palestinos
ğŸ‡µğŸ‡¹	bandera, bandera: Portugal
ğŸ‡µğŸ‡¼	bandera, bandera: Palaos
ğŸ‡µğŸ‡¾	bandera, bandera: Paraguay
ğŸ‡¶ğŸ‡¦	bandera, bandera: Catar
ğŸ‡·ğŸ‡ª	bandera, bandera: ReuniÃ³n
ğŸ‡·ğŸ‡´	bandera, bandera: RumanÃ­a
ğŸ‡·ğŸ‡¸	bandera, bandera: Serbia
ğŸ‡·ğŸ‡º	bandera, bandera: Rusia
ğŸ‡·ğŸ‡¼	bandera, bandera: Ruanda
ğŸ‡¸ğŸ‡¦	bandera, bandera: Arabia SaudÃ­
ğŸ‡¸ğŸ‡§	bandera, bandera: Islas SalomÃ³n
ğŸ‡¸ğŸ‡¨	bandera, bandera: Seychelles
ğŸ‡¸ğŸ‡©	bandera, bandera: SudÃ¡n
ğŸ‡¸ğŸ‡ª	bandera, bandera: Suecia
ğŸ‡¸ğŸ‡¬	bandera, bandera: Singapur
ğŸ‡¸ğŸ‡­	bandera, bandera: Santa Elena
ğŸ‡¸ğŸ‡®	bandera, bandera: Eslovenia
ğŸ‡¸ğŸ‡¯	bandera, bandera: Svalbard y Jan Mayen
ğŸ‡¸ğŸ‡°	bandera, bandera: Eslovaquia
ğŸ‡¸ğŸ‡±	bandera, bandera: Sierra Leona
ğŸ‡¸ğŸ‡²	bandera, bandera: San Marino
ğŸ‡¸ğŸ‡³	bandera, bandera: Senegal
ğŸ‡¸ğŸ‡´	bandera, bandera: Somalia
ğŸ‡¸ğŸ‡·	bandera, bandera: Surinam
ğŸ‡¸ğŸ‡¸	bandera, bandera: SudÃ¡n del Sur
ğŸ‡¸ğŸ‡¹	bandera, bandera: Santo TomÃ© y PrÃ­ncipe
ğŸ‡¸ğŸ‡»	bandera, bandera: El Salvador
ğŸ‡¸ğŸ‡½	bandera, bandera: Sint Maarten
ğŸ‡¸ğŸ‡¾	bandera, bandera: Siria
ğŸ‡¸ğŸ‡¿	bandera, bandera: Esuatini
ğŸ‡¹ğŸ‡¦	bandera, bandera: TristÃ¡n da Cunha
ğŸ‡¹ğŸ‡¨	bandera, bandera: Islas Turcas y Caicos
ğŸ‡¹ğŸ‡©	bandera, bandera: Chad
ğŸ‡¹ğŸ‡«	bandera, bandera: Territorios Australes Franceses
ğŸ‡¹ğŸ‡¬	bandera, bandera: Togo
ğŸ‡¹ğŸ‡­	bandera, bandera: Tailandia
ğŸ‡¹ğŸ‡¯	bandera, bandera: TayikistÃ¡n
ğŸ‡¹ğŸ‡°	bandera, bandera: Tokelau
ğŸ‡¹ğŸ‡±	bandera, bandera: Timor-Leste
ğŸ‡¹ğŸ‡²	bandera, bandera: TurkmenistÃ¡n
ğŸ‡¹ğŸ‡³	bandera, bandera: TÃºnez
ğŸ‡¹ğŸ‡´	bandera, bandera: Tonga
ğŸ‡¹ğŸ‡·	bandera, bandera: TurquÃ­a
ğŸ‡¹ğŸ‡¹	bandera, bandera: Trinidad y Tobago
ğŸ‡¹ğŸ‡»	bandera, bandera: Tuvalu
ğŸ‡¹ğŸ‡¼	bandera, bandera: TaiwÃ¡n
ğŸ‡¹ğŸ‡¿	bandera, bandera: Tanzania
ğŸ‡ºğŸ‡¦	bandera, bandera: Ucrania
ğŸ‡ºğŸ‡¬	bandera, bandera: Uganda
ğŸ‡ºğŸ‡²	bandera, bandera: Islas Ultramarinas de EE.UU.
ğŸ‡ºğŸ‡³	bandera, bandera: Naciones Unidas
ğŸ‡ºğŸ‡¸	bandera, bandera: Estados Unidos
ğŸ‡ºğŸ‡¾	bandera, bandera: Uruguay
ğŸ‡ºğŸ‡¿	bandera, bandera: UzbekistÃ¡n
ğŸ‡»ğŸ‡¦	bandera, bandera: Ciudad del Vaticano
ğŸ‡»ğŸ‡¨	bandera, bandera: San Vicente y las Granadinas
ğŸ‡»ğŸ‡ª	bandera, bandera: Venezuela
ğŸ‡»ğŸ‡¬	bandera, bandera: Islas VÃ­rgenes BritÃ¡nicas
ğŸ‡»ğŸ‡®	bandera, bandera: Islas VÃ­rgenes de EE. UU.
ğŸ‡»ğŸ‡³	bandera, bandera: Vietnam
ğŸ‡»ğŸ‡º	bandera, bandera: Vanuatu
ğŸ‡¼ğŸ‡«	bandera, bandera: Wallis y Futuna
ğŸ‡¼ğŸ‡¸	bandera, bandera: Samoa
ğŸ‡½ğŸ‡°	bandera, bandera: Kosovo
ğŸ‡¾ğŸ‡ª	bandera, bandera: Yemen
ğŸ‡¾ğŸ‡¹	bandera, bandera: Mayotte
ğŸ‡¿ğŸ‡¦	bandera, bandera: SudÃ¡frica
ğŸ‡¿ğŸ‡²	bandera, bandera: Zambia
ğŸ‡¿ğŸ‡¼	bandera, bandera: Zimbabue
ğŸ´ó §ó ¢ó ¥ó ®ó §ó ¿	bandera, bandera: Inglaterra
ğŸ´ó §ó ¢ó ³ó £ó ´ó ¿	bandera, bandera: Escocia
ğŸ´ó §ó ¢ó ·ó ¬ó ³ó ¿	bandera, bandera: Gales
