ğŸ˜€	cara, cara sonriendo, contento, divertido, sonrisa
ğŸ˜ƒ	boca abierta, cara sonriendo con ojos grandes, divertido, risa, sonrisa
ğŸ˜„	boca abierta, cara sonriendo con ojos sonrientes, divertido, risa, sonrisa
ğŸ˜	cara, cara radiante con ojos sonrientes, divertido, risa, sonrisa
ğŸ˜†	boca abierta, cara, cara sonriendo con los ojos cerrados
ğŸ˜…	boca abierta, cara sonriendo con sudor frÃ­o, sonrisa, sonrisa boca abierta, sudor frÃ­o
ğŸ˜‚	cara, cara llorando de felicidad, felicidad, feliz, lÃ¡grimas
ğŸ™‚	cara, cara sonriendo ligeramente, sonrisa
ğŸ˜‰	cara, cara guiÃ±ando el ojo, guiÃ±o
ğŸ˜Š	cara, cara feliz con ojos sonrientes, ojos sonrientes, sonrisa
ğŸ˜‡	cara sonriendo con aureola
ğŸ¥°	adoraciÃ³n, cara sonriente con 3 corazones, cara sonriente con 4 corazones, enamoramiento, flechazo
ğŸ˜	amor, cara sonriendo con ojos de corazÃ³n, corazones, sonriente, tierno
ğŸ˜˜	besos, cara, cara lanzando un beso, corazÃ³n
ğŸ˜—	cara, cara dando un beso
ğŸ˜š	beso, cara, cara besando con los ojos cerrados, cerrados, ojos
ğŸ˜™	beso, cara, cara besando con ojos sonrientes, ojos, sonriente
ğŸ˜‹	broma, cara saboreando comida, delicioso, rico, sonriente
ğŸ˜›	cara sacando la lengua
ğŸ˜œ	cara sacando la lengua y guiÃ±ando un ojo
ğŸ¤ª	cara de loco, ojo grande, ojo pequeÃ±o
ğŸ˜	cara con los ojos bien cerrados y sacando la lengua, cara con ojos cerrados y sacando la lengua
ğŸ¤‘	cara con lengua de dinero
ğŸ¤­	chanfle, risita, uy, vaya
ğŸ¤	boca, cara, cara con la boca cerrada con cierre, zipper
ğŸ˜‘	cara sin expresiÃ³n
ğŸ˜	cara sonriendo con superioridad
ğŸ™„	cara con ojos en blanco
ğŸ˜¬	cara, cara haciendo mueca, mueca
ğŸ˜”	cara desanimada
ğŸ˜·	barbijo, cara, cara con mascarilla mÃ©dica, cubrebocas, enfermo
ğŸ¤•	cara, cara con la cabeza vendada, dolor, herido, vendas
ğŸ¤§	cara, cara estornudando, estornudar, estornudo, resfrÃ­o
ğŸ¥µ	calor, cara colorada, cara de calor, fiebre, golpe de calor, sudor
ğŸ¥¶	cara azul, cara de frÃ­o, congelamiento, frÃ­o, helado, tempano
ğŸ¥´	boca ondulada, borrachera, cara de mareo, intoxicaciÃ³n, mareo, ojos desparejos
ğŸ˜µ	cara, cara mareada, mareado
ğŸ¥³	cara de fiesta, celebraciÃ³n, fiesta, gorro, matasuegras
ğŸ˜	cara, cara sonriendo con lentes de sol, lentes de sol, onda, sol
ğŸ˜Ÿ	cara, cara preocupada, preocupado
ğŸ˜®	cara con boca abierta, empatÃ­a, sorpresa
ğŸ˜³	avergonzado, sonrojado, sorprendido, sorpresa, vergÃ¼enza
ğŸ¥º	cara de sÃºplica, ganas de llorar, ojos llorosos, suplicar
ğŸ˜¦	abierta, boca, cara, cara con el ceÃ±o fruncido y la boca abierta
ğŸ˜§	cara angustiada
ğŸ˜¨	cara asustada
ğŸ˜°	cara con ansiedad y sudor
ğŸ˜¥	cara triste pero aliviada
ğŸ˜¢	cara llorando, llanto, llorar, triste, tristeza
ğŸ˜±	cara gritando de miedo, grito, horror, miedo, terror
ğŸ˜£	cara perseverante
ğŸ˜	cara, cara decepcionada, decepcionado, decepciÃ³n
ğŸ˜©	cara agotada
ğŸ˜«	cara cansada
ğŸ˜¤	cara resoplando
ğŸ˜¡	cara de enojo
ğŸ˜ 	cara, cara enfadada, enfadado, enojo
ğŸ¤¬	cara con boca censurada, cara con sÃ­mbolos en la boca, maldecir, palabrota
ğŸ˜ˆ	cara malvada sonriendo con cuernos, cara sonriendo con cuernos, cuernos, diablo, pÃ­caro, sonrisa
ğŸ‘¿	cara, cara enfadada con cuernos, cara malvada enfadada con cuernos, diablo, fantasÃ­a
ğŸ’€	calavera, cara, miedo, monstruo, muerte
â˜ ï¸	calavera y huesos cruzados, cara, huesos
ğŸ’©	caca con ojos, cara, estiÃ©rcol, gracioso
ğŸ‘¹	demonio japonÃ©s oni, fantasÃ­a, japonÃ©s, ogro, oni
ğŸ‘º	cara, cuento, demonio, demonio japonÃ©s tengu, japonÃ©s, tengu
ğŸ‘½ï¸	alien, alienÃ­gena, cara, extraterrestre, ovni
ğŸ‘¾	cara, extraterrestre, monstruo alienÃ­gena, ovni
ğŸ¤–	cara, cara de robot, monstruo
ğŸ˜º	abierta, boca, cara, cara de gato sonriendo, gato
ğŸ˜¸	cara, cara de gato sonriendo con ojos sonrientes, gato, sonriente, sonrisa
ğŸ˜¹	alegrÃ­a, cara, cara de gato llorando de risa, gato, llorando, lÃ¡grimas
ğŸ˜»	amor, cara, cara de gato sonriendo con ojos de corazÃ³n, corazones, gato, gato con ojos de corazÃ³n
ğŸ˜¼	cara de gato con sonrisa irÃ³nica, gato, irÃ³nico, sarcÃ¡stico, sonrisa
ğŸ˜½	beso, cara de gato besando, cerrados, gato, ojos
ğŸ™€	cara de gato asustado
ğŸ˜¿	cara de gato llorando, gato, llanto, llorar, lÃ¡grima, triste
ğŸ˜¾	cara, cara de gato enfadado, enfadado, enojado, gato
ğŸ™ˆ	cara, mono, mono con los ojos tapados, no ver
ğŸ™‰	cara, mono, mono con los oÃ­dos tapados, no oÃ­r
ğŸ™Š	cara, mono, mono con la boca tapada, no hablar
ğŸ’	amor, corazÃ³n, corazÃ³n con lazo, emociÃ³n, moÃ±o
ğŸ’—	amor, corazÃ³n, corazÃ³n creciente, emociÃ³n, entusiasmado
ğŸ’“	corazÃ³n, corazÃ³n latiendo, emociÃ³n, latidos, palpitar
ğŸ’	amor, corazones giratorios, corazÃ³n, emociÃ³n, girar
ğŸ’Ÿ	adorno de corazÃ³n, corazÃ³n
ğŸ’”	corazÃ³n, mal, roto, sufrir, triste
â¤ï¸	amor, corazÃ³n, emociÃ³n, rojo
ğŸ’œ	corazÃ³n, emociÃ³n, morado
ğŸ¤	corazÃ³n cafÃ©
ğŸ’¯	100, perfecto, puntaje, puntos, puntuaciÃ³n
ğŸ’¢	cÃ³mics, emociÃ³n, seÃ±al de enojo, sÃ­mbolo de enfado
ğŸ’¥	choque, cÃ³mics, emociÃ³n, explosiÃ³n
ğŸ’«	cÃ³mics, emociÃ³n, estrellas, mareo, sÃ­mbolo de mareo
ğŸ’¨	correr, corriendo, emociÃ³n, escapar, huir
ğŸ•³ï¸	cÃ³mics, pozo
ğŸ’£ï¸	cÃ³mics, explosiÃ³n, explota
ğŸ’¬	burbuja, cÃ³mics, diÃ¡logo, globo, globo de diÃ¡logo
ğŸ‘â€ğŸ—¨	ojo en un globo de texto
ğŸ—¨ï¸	burbuja, cÃ³mics, diÃ¡logo, globo, globo de diÃ¡logo izquierdo
ğŸ—¯ï¸	burbuja, cÃ³mics, derecho, enojado, globo
ğŸ’­	burbuja, cÃ³mics, globo, globo de pensamiento, pensamiento
ğŸ’¤	cÃ³mics, emociÃ³n, estar durmiendo, roncar, sÃ­mbolo de sueÃ±o
ğŸ‘‹ğŸ»	agitar, mano, mano saludando, mano saludando: tono de piel claro, saludar, saludo, tono de piel claro
ğŸ‘‹ğŸ¼	agitar, mano, mano saludando, mano saludando: tono de piel claro medio, saludar, saludo, tono de piel claro medio
ğŸ‘‹ğŸ½	agitar, mano, mano saludando, mano saludando: tono de piel medio, saludar, saludo, tono de piel medio
ğŸ‘‹ğŸ¾	agitar, mano, mano saludando, mano saludando: tono de piel oscuro medio, saludar, saludo, tono de piel oscuro medio
ğŸ‘‹ğŸ¿	agitar, mano, mano saludando, mano saludando: tono de piel oscuro, saludar, saludo, tono de piel oscuro
ğŸ¤š	dorso de la mano
ğŸ¤šğŸ»	dorso de la mano, dorso de la mano: tono de piel claro, tono de piel claro
ğŸ¤šğŸ¼	dorso de la mano, dorso de la mano: tono de piel claro medio, tono de piel claro medio
ğŸ¤šğŸ½	dorso de la mano, dorso de la mano: tono de piel medio, tono de piel medio
ğŸ¤šğŸ¾	dorso de la mano, dorso de la mano: tono de piel oscuro medio, tono de piel oscuro medio
ğŸ¤šğŸ¿	dorso de la mano, dorso de la mano: tono de piel oscuro, tono de piel oscuro
ğŸ–ï¸	dedos, mano, mano abierta, palma de la mano
ğŸ–ğŸ»	dedos, mano, mano abierta, mano abierta: tono de piel claro, palma de la mano, tono de piel claro
ğŸ–ğŸ¼	dedos, mano, mano abierta, mano abierta: tono de piel claro medio, palma de la mano, tono de piel claro medio
ğŸ–ğŸ½	dedos, mano, mano abierta, mano abierta: tono de piel medio, palma de la mano, tono de piel medio
ğŸ–ğŸ¾	dedos, mano, mano abierta, mano abierta: tono de piel oscuro medio, palma de la mano, tono de piel oscuro medio
ğŸ–ğŸ¿	dedos, mano, mano abierta, mano abierta: tono de piel oscuro, palma de la mano, tono de piel oscuro
âœ‹	mano, mano abierta, palma de la mano
âœ‹ğŸ»	mano, mano abierta, mano levantada: tono de piel claro, palma de la mano, tono de piel claro
âœ‹ğŸ¼	mano, mano abierta, mano levantada: tono de piel claro medio, palma de la mano, tono de piel claro medio
âœ‹ğŸ½	mano, mano abierta, mano levantada: tono de piel medio, palma de la mano, tono de piel medio
âœ‹ğŸ¾	mano, mano abierta, mano levantada: tono de piel oscuro medio, palma de la mano, tono de piel oscuro medio
âœ‹ğŸ¿	mano, mano abierta, mano levantada: tono de piel oscuro, palma de la mano, tono de piel oscuro
ğŸ––	saludo, spock, star, trek, vulcano
ğŸ––ğŸ»	saludo, saludo vulcano: tono de piel claro, spock, star, tono de piel claro, trek, vulcano
ğŸ––ğŸ¼	saludo, saludo vulcano: tono de piel claro medio, spock, star, tono de piel claro medio, trek, vulcano
ğŸ––ğŸ½	saludo, saludo vulcano: tono de piel medio, spock, star, tono de piel medio, trek, vulcano
ğŸ––ğŸ¾	saludo, saludo vulcano: tono de piel oscuro medio, spock, star, tono de piel oscuro medio, trek, vulcano
ğŸ––ğŸ¿	saludo, saludo vulcano: tono de piel oscuro, spock, star, tono de piel oscuro, trek, vulcano
ğŸ‘Œ	seÃ±al de aprobaciÃ³n con la mano
ğŸ‘ŒğŸ»	seÃ±al de aprobaciÃ³n con la mano, seÃ±al de aprobaciÃ³n con la mano: tono de piel claro, tono de piel claro
ğŸ‘ŒğŸ¼	seÃ±al de aprobaciÃ³n con la mano, seÃ±al de aprobaciÃ³n con la mano: tono de piel claro medio, tono de piel claro medio
ğŸ‘ŒğŸ½	seÃ±al de aprobaciÃ³n con la mano, seÃ±al de aprobaciÃ³n con la mano: tono de piel medio, tono de piel medio
ğŸ‘ŒğŸ¾	seÃ±al de aprobaciÃ³n con la mano, seÃ±al de aprobaciÃ³n con la mano: tono de piel oscuro medio, tono de piel oscuro medio
ğŸ‘ŒğŸ¿	seÃ±al de aprobaciÃ³n con la mano, seÃ±al de aprobaciÃ³n con la mano: tono de piel oscuro, tono de piel oscuro
ğŸ¤ğŸ»	mano pellizcando, mano pellizcando: tono de piel claro, pellizco, poco, poquito, tono de piel claro
ğŸ¤ğŸ¼	mano pellizcando, mano pellizcando: tono de piel claro medio, pellizco, poco, poquito, tono de piel claro medio
ğŸ¤ğŸ½	mano pellizcando, mano pellizcando: tono de piel medio, pellizco, poco, poquito, tono de piel medio
ğŸ¤ğŸ¾	mano pellizcando, mano pellizcando: tono de piel oscuro medio, pellizco, poco, poquito, tono de piel oscuro medio
ğŸ¤ğŸ¿	mano pellizcando, mano pellizcando: tono de piel oscuro, pellizco, poco, poquito, tono de piel oscuro
âœŒï¸	amor y paz, mano con seÃ±al de victoria, tijera, victoria
âœŒğŸ»	amor y paz, mano con seÃ±al de victoria, mano con seÃ±al de victoria: tono de piel claro, tijera, tono de piel claro, victoria
âœŒğŸ¼	amor y paz, mano con seÃ±al de victoria, mano con seÃ±al de victoria: tono de piel claro medio, tijera, tono de piel claro medio, victoria
âœŒğŸ½	amor y paz, mano con seÃ±al de victoria, mano con seÃ±al de victoria: tono de piel medio, tijera, tono de piel medio, victoria
âœŒğŸ¾	amor y paz, mano con seÃ±al de victoria, mano con seÃ±al de victoria: tono de piel oscuro medio, tijera, tono de piel oscuro medio, victoria
âœŒğŸ¿	amor y paz, mano con seÃ±al de victoria, mano con seÃ±al de victoria: tono de piel oscuro, tijera, tono de piel oscuro, victoria
ğŸ¤	dedos cruzados, mano, suerte
ğŸ¤ğŸ»	dedos cruzados, dedos cruzados: tono de piel claro, mano, suerte, tono de piel claro
ğŸ¤ğŸ¼	dedos cruzados, dedos cruzados: tono de piel claro medio, mano, suerte, tono de piel claro medio
ğŸ¤ğŸ½	dedos cruzados, dedos cruzados: tono de piel medio, mano, suerte, tono de piel medio
ğŸ¤ğŸ¾	dedos cruzados, dedos cruzados: tono de piel oscuro medio, mano, suerte, tono de piel oscuro medio
ğŸ¤ğŸ¿	dedos cruzados, dedos cruzados: tono de piel oscuro, mano, suerte, tono de piel oscuro
ğŸ¤ŸğŸ»	gesto de te quiero, gesto de te quiero: tono de piel claro, mano, quiero, tono de piel claro
ğŸ¤ŸğŸ¼	gesto de te quiero, gesto de te quiero: tono de piel claro medio, mano, quiero, tono de piel claro medio
ğŸ¤ŸğŸ½	gesto de te quiero, gesto de te quiero: tono de piel medio, mano, quiero, tono de piel medio
ğŸ¤ŸğŸ¾	gesto de te quiero, gesto de te quiero: tono de piel oscuro medio, mano, quiero, tono de piel oscuro medio
ğŸ¤ŸğŸ¿	gesto de te quiero, gesto de te quiero: tono de piel oscuro, mano, quiero, tono de piel oscuro
ğŸ¤˜	cuernos, dedos, mano haciendo los cuernos, rock, roll
ğŸ¤˜ğŸ»	cuernos, dedos, mano haciendo los cuernos, mano haciendo los cuernos: tono de piel claro, rock, roll, tono de piel claro
ğŸ¤˜ğŸ¼	cuernos, dedos, mano haciendo los cuernos, mano haciendo los cuernos: tono de piel claro medio, rock, roll, tono de piel claro medio
ğŸ¤˜ğŸ½	cuernos, dedos, mano haciendo los cuernos, mano haciendo los cuernos: tono de piel medio, rock, roll, tono de piel medio
ğŸ¤˜ğŸ¾	cuernos, dedos, mano haciendo los cuernos, mano haciendo los cuernos: tono de piel oscuro medio, rock, roll, tono de piel oscuro medio
ğŸ¤˜ğŸ¿	cuernos, dedos, mano haciendo los cuernos, mano haciendo los cuernos: tono de piel oscuro, rock, roll, tono de piel oscuro
ğŸ¤™	gesto, llamada, mano, mano haciendo el gesto de llamar
ğŸ¤™ğŸ»	gesto, llamada, mano, mano haciendo el gesto de llamar, mano haciendo el gesto de llamar: tono de piel claro, tono de piel claro
ğŸ¤™ğŸ¼	gesto, llamada, mano, mano haciendo el gesto de llamar, mano haciendo el gesto de llamar: tono de piel claro medio, tono de piel claro medio
ğŸ¤™ğŸ½	gesto, llamada, mano, mano haciendo el gesto de llamar, mano haciendo el gesto de llamar: tono de piel medio, tono de piel medio
ğŸ¤™ğŸ¾	gesto, llamada, mano, mano haciendo el gesto de llamar, mano haciendo el gesto de llamar: tono de piel oscuro medio, tono de piel oscuro medio
ğŸ¤™ğŸ¿	gesto, llamada, mano, mano haciendo el gesto de llamar, mano haciendo el gesto de llamar: tono de piel oscuro, tono de piel oscuro
ğŸ‘ˆï¸	apuntar, dedo, dorso, mano con dedo Ã­ndice hacia la izquierda, Ã­ndice, Ã­ndice hacia la izquierda
ğŸ‘ˆğŸ»	apuntar, dedo, dorso, mano con dedo Ã­ndice hacia la izquierda, mano con dedo Ã­ndice hacia la izquierda: tono de piel claro, tono de piel claro, Ã­ndice, Ã­ndice hacia la izquierda
ğŸ‘ˆğŸ¼	apuntar, dedo, dorso, mano con dedo Ã­ndice hacia la izquierda, mano con dedo Ã­ndice hacia la izquierda: tono de piel claro medio, tono de piel claro medio, Ã­ndice, Ã­ndice hacia la izquierda
ğŸ‘ˆğŸ½	apuntar, dedo, dorso, mano con dedo Ã­ndice hacia la izquierda, mano con dedo Ã­ndice hacia la izquierda: tono de piel medio, tono de piel medio, Ã­ndice, Ã­ndice hacia la izquierda
ğŸ‘ˆğŸ¾	apuntar, dedo, dorso, mano con dedo Ã­ndice hacia la izquierda, mano con dedo Ã­ndice hacia la izquierda: tono de piel oscuro medio, tono de piel oscuro medio, Ã­ndice, Ã­ndice hacia la izquierda
ğŸ‘ˆğŸ¿	apuntar, dedo, dorso, mano con dedo Ã­ndice hacia la izquierda, mano con dedo Ã­ndice hacia la izquierda: tono de piel oscuro, tono de piel oscuro, Ã­ndice, Ã­ndice hacia la izquierda
ğŸ‘‰ï¸	apuntar, dedo, dorso, mano con dedo Ã­ndice hacia la derecha, Ã­ndice, Ã­ndice hacia la derecha
ğŸ‘‰ğŸ»	apuntar, dedo, dorso, mano con dedo Ã­ndice hacia la derecha, mano con dedo Ã­ndice hacia la derecha: tono de piel claro, tono de piel claro, Ã­ndice, Ã­ndice hacia la derecha
ğŸ‘‰ğŸ¼	apuntar, dedo, dorso, mano con dedo Ã­ndice hacia la derecha, mano con dedo Ã­ndice hacia la derecha: tono de piel claro medio, tono de piel claro medio, Ã­ndice, Ã­ndice hacia la derecha
ğŸ‘‰ğŸ½	apuntar, dedo, dorso, mano con dedo Ã­ndice hacia la derecha, mano con dedo Ã­ndice hacia la derecha: tono de piel medio, tono de piel medio, Ã­ndice, Ã­ndice hacia la derecha
ğŸ‘‰ğŸ¾	apuntar, dedo, dorso, mano con dedo Ã­ndice hacia la derecha, mano con dedo Ã­ndice hacia la derecha: tono de piel oscuro medio, tono de piel oscuro medio, Ã­ndice, Ã­ndice hacia la derecha
ğŸ‘‰ğŸ¿	apuntar, dedo, dorso, mano con dedo Ã­ndice hacia la derecha, mano con dedo Ã­ndice hacia la derecha: tono de piel oscuro, tono de piel oscuro, Ã­ndice, Ã­ndice hacia la derecha
ğŸ‘†ï¸	apuntar, dedo, mano, seÃ±alar, Ã­ndice
ğŸ‘†ğŸ»	apuntar, dedo, dorso de mano con Ã­ndice hacia arriba: tono de piel claro, mano, seÃ±alar, tono de piel claro, Ã­ndice
ğŸ‘†ğŸ¼	apuntar, dedo, dorso de mano con Ã­ndice hacia arriba: tono de piel claro medio, mano, seÃ±alar, tono de piel claro medio, Ã­ndice
ğŸ‘†ğŸ½	apuntar, dedo, dorso de mano con Ã­ndice hacia arriba: tono de piel medio, mano, seÃ±alar, tono de piel medio, Ã­ndice
ğŸ‘†ğŸ¾	apuntar, dedo, dorso de mano con Ã­ndice hacia arriba: tono de piel oscuro medio, mano, seÃ±alar, tono de piel oscuro medio, Ã­ndice
ğŸ‘†ğŸ¿	apuntar, dedo, dorso de mano con Ã­ndice hacia arriba: tono de piel oscuro, mano, seÃ±alar, tono de piel oscuro, Ã­ndice
ğŸ–•	dedo, insulto, mano, mano con el dedo medio levantado, medio
ğŸ–•ğŸ»	dedo, insulto, mano, mano con el dedo medio levantado, mano con el dedo medio levantado: tono de piel claro, medio, tono de piel claro
ğŸ–•ğŸ¼	dedo, insulto, mano, mano con el dedo medio levantado, mano con el dedo medio levantado: tono de piel claro medio, medio, tono de piel claro medio
ğŸ–•ğŸ½	dedo, insulto, mano, mano con el dedo medio levantado, mano con el dedo medio levantado: tono de piel medio, medio, tono de piel medio
ğŸ–•ğŸ¾	dedo, insulto, mano, mano con el dedo medio levantado, mano con el dedo medio levantado: tono de piel oscuro medio, medio, tono de piel oscuro medio
ğŸ–•ğŸ¿	dedo, insulto, mano, mano con el dedo medio levantado, mano con el dedo medio levantado: tono de piel oscuro, medio, tono de piel oscuro
ğŸ‘‡ï¸	abajo, apuntar, mano, seÃ±alar, Ã­ndice
ğŸ‘‡ğŸ»	abajo, apuntar, dorso de mano con Ã­ndice hacia abajo: tono de piel claro, mano, seÃ±alar, tono de piel claro, Ã­ndice
ğŸ‘‡ğŸ¼	abajo, apuntar, dorso de mano con Ã­ndice hacia abajo: tono de piel claro medio, mano, seÃ±alar, tono de piel claro medio, Ã­ndice
ğŸ‘‡ğŸ½	abajo, apuntar, dorso de mano con Ã­ndice hacia abajo: tono de piel medio, mano, seÃ±alar, tono de piel medio, Ã­ndice
ğŸ‘‡ğŸ¾	abajo, apuntar, dorso de mano con Ã­ndice hacia abajo: tono de piel oscuro medio, mano, seÃ±alar, tono de piel oscuro medio, Ã­ndice
ğŸ‘‡ğŸ¿	abajo, apuntar, dorso de mano con Ã­ndice hacia abajo: tono de piel oscuro, mano, seÃ±alar, tono de piel oscuro, Ã­ndice
â˜ï¸	apuntar, arriba, dedo Ã­ndice hacia arriba, seÃ±alar, Ã­ndice
â˜ğŸ»	apuntar, arriba, dedo Ã­ndice hacia arriba, dedo Ã­ndice hacia arriba: tono de piel claro, seÃ±alar, tono de piel claro, Ã­ndice
â˜ğŸ¼	apuntar, arriba, dedo Ã­ndice hacia arriba, dedo Ã­ndice hacia arriba: tono de piel claro medio, seÃ±alar, tono de piel claro medio, Ã­ndice
â˜ğŸ½	apuntar, arriba, dedo Ã­ndice hacia arriba, dedo Ã­ndice hacia arriba: tono de piel medio, seÃ±alar, tono de piel medio, Ã­ndice
â˜ğŸ¾	apuntar, arriba, dedo Ã­ndice hacia arriba, dedo Ã­ndice hacia arriba: tono de piel oscuro medio, seÃ±alar, tono de piel oscuro medio, Ã­ndice
â˜ğŸ¿	apuntar, arriba, dedo Ã­ndice hacia arriba, dedo Ã­ndice hacia arriba: tono de piel oscuro, seÃ±alar, tono de piel oscuro, Ã­ndice
ğŸ‘ï¸	+1, OK, de acuerdo, pulgar, seÃ±al de OK
ğŸ‘ğŸ»	+1, OK, de acuerdo, pulgar, pulgar hacia arriba: tono de piel claro, seÃ±al de OK, tono de piel claro
ğŸ‘ğŸ¼	+1, OK, de acuerdo, pulgar, pulgar hacia arriba: tono de piel claro medio, seÃ±al de OK, tono de piel claro medio
ğŸ‘ğŸ½	+1, OK, de acuerdo, pulgar, pulgar hacia arriba: tono de piel medio, seÃ±al de OK, tono de piel medio
ğŸ‘ğŸ¾	+1, OK, de acuerdo, pulgar, pulgar hacia arriba: tono de piel oscuro medio, seÃ±al de OK, tono de piel oscuro medio
ğŸ‘ğŸ¿	+1, OK, de acuerdo, pulgar, pulgar hacia arriba: tono de piel oscuro, seÃ±al de OK, tono de piel oscuro
ğŸ‘ï¸	-1, abajo, desacuerdo, mano, pulgar
ğŸ‘ğŸ»	-1, abajo, desacuerdo, mano, pulgar, pulgar hacia abajo: tono de piel claro, tono de piel claro
ğŸ‘ğŸ¼	-1, abajo, desacuerdo, mano, pulgar, pulgar hacia abajo: tono de piel claro medio, tono de piel claro medio
ğŸ‘ğŸ½	-1, abajo, desacuerdo, mano, pulgar, pulgar hacia abajo: tono de piel medio, tono de piel medio
ğŸ‘ğŸ¾	-1, abajo, desacuerdo, mano, pulgar, pulgar hacia abajo: tono de piel oscuro medio, tono de piel oscuro medio
ğŸ‘ğŸ¿	-1, abajo, desacuerdo, mano, pulgar, pulgar hacia abajo: tono de piel oscuro, tono de piel oscuro
âœŠ	puÃ±o en alto
âœŠğŸ»	puÃ±o en alto, puÃ±o en alto: tono de piel claro, tono de piel claro
âœŠğŸ¼	puÃ±o en alto, puÃ±o en alto: tono de piel claro medio, tono de piel claro medio
âœŠğŸ½	puÃ±o en alto, puÃ±o en alto: tono de piel medio, tono de piel medio
âœŠğŸ¾	puÃ±o en alto, puÃ±o en alto: tono de piel oscuro medio, tono de piel oscuro medio
âœŠğŸ¿	puÃ±o en alto, puÃ±o en alto: tono de piel oscuro, tono de piel oscuro
ğŸ‘ŠğŸ»	puÃ±etazo, puÃ±o, puÃ±o cerrado, puÃ±o cerrado: tono de piel claro, tono de piel claro
ğŸ‘ŠğŸ¼	puÃ±etazo, puÃ±o, puÃ±o cerrado, puÃ±o cerrado: tono de piel claro medio, tono de piel claro medio
ğŸ‘ŠğŸ½	puÃ±etazo, puÃ±o, puÃ±o cerrado, puÃ±o cerrado: tono de piel medio, tono de piel medio
ğŸ‘ŠğŸ¾	puÃ±etazo, puÃ±o, puÃ±o cerrado, puÃ±o cerrado: tono de piel oscuro medio, tono de piel oscuro medio
ğŸ‘ŠğŸ¿	puÃ±etazo, puÃ±o, puÃ±o cerrado, puÃ±o cerrado: tono de piel oscuro, tono de piel oscuro
ğŸ¤›	izquierda, puÃ±o, puÃ±o hacia la izquierda
ğŸ¤›ğŸ»	izquierda, puÃ±o, puÃ±o hacia la izquierda, puÃ±o hacia la izquierda: tono de piel claro, tono de piel claro
ğŸ¤›ğŸ¼	izquierda, puÃ±o, puÃ±o hacia la izquierda, puÃ±o hacia la izquierda: tono de piel claro medio, tono de piel claro medio
ğŸ¤›ğŸ½	izquierda, puÃ±o, puÃ±o hacia la izquierda, puÃ±o hacia la izquierda: tono de piel medio, tono de piel medio
ğŸ¤›ğŸ¾	izquierda, puÃ±o, puÃ±o hacia la izquierda, puÃ±o hacia la izquierda: tono de piel oscuro medio, tono de piel oscuro medio
ğŸ¤›ğŸ¿	izquierda, puÃ±o, puÃ±o hacia la izquierda, puÃ±o hacia la izquierda: tono de piel oscuro, tono de piel oscuro
ğŸ¤œ	derecha, puÃ±o, puÃ±o hacia la derecha
ğŸ¤œğŸ»	derecha, puÃ±o, puÃ±o hacia la derecha, puÃ±o hacia la derecha: tono de piel claro, tono de piel claro
ğŸ¤œğŸ¼	derecha, puÃ±o, puÃ±o hacia la derecha, puÃ±o hacia la derecha: tono de piel claro medio, tono de piel claro medio
ğŸ¤œğŸ½	derecha, puÃ±o, puÃ±o hacia la derecha, puÃ±o hacia la derecha: tono de piel medio, tono de piel medio
ğŸ¤œğŸ¾	derecha, puÃ±o, puÃ±o hacia la derecha, puÃ±o hacia la derecha: tono de piel oscuro medio, tono de piel oscuro medio
ğŸ¤œğŸ¿	derecha, puÃ±o, puÃ±o hacia la derecha, puÃ±o hacia la derecha: tono de piel oscuro, tono de piel oscuro
ğŸ‘ğŸ»	aplaudir, manos, manos aplaudiendo, manos aplaudiendo: tono de piel claro, palmas, seÃ±al, tono de piel claro
ğŸ‘ğŸ¼	aplaudir, manos, manos aplaudiendo, manos aplaudiendo: tono de piel claro medio, palmas, seÃ±al, tono de piel claro medio
ğŸ‘ğŸ½	aplaudir, manos, manos aplaudiendo, manos aplaudiendo: tono de piel medio, palmas, seÃ±al, tono de piel medio
ğŸ‘ğŸ¾	aplaudir, manos, manos aplaudiendo, manos aplaudiendo: tono de piel oscuro medio, palmas, seÃ±al, tono de piel oscuro medio
ğŸ‘ğŸ¿	aplaudir, manos, manos aplaudiendo, manos aplaudiendo: tono de piel oscuro, palmas, seÃ±al, tono de piel oscuro
ğŸ™Œ	chocar, cinco, festejo, manos, manos levantadas celebrando
ğŸ™ŒğŸ»	chocar, cinco, festejo, manos, manos levantadas celebrando, manos levantadas celebrando: tono de piel claro, tono de piel claro
ğŸ™ŒğŸ¼	chocar, cinco, festejo, manos, manos levantadas celebrando, manos levantadas celebrando: tono de piel claro medio, tono de piel claro medio
ğŸ™ŒğŸ½	chocar, cinco, festejo, manos, manos levantadas celebrando, manos levantadas celebrando: tono de piel medio, tono de piel medio
ğŸ™ŒğŸ¾	chocar, cinco, festejo, manos, manos levantadas celebrando, manos levantadas celebrando: tono de piel oscuro medio, tono de piel oscuro medio
ğŸ™ŒğŸ¿	chocar, cinco, festejo, manos, manos levantadas celebrando, manos levantadas celebrando: tono de piel oscuro, tono de piel oscuro
ğŸ‘ğŸ»	abiertas, manos, manos abiertas: tono de piel claro, tono de piel claro
ğŸ‘ğŸ¼	abiertas, manos, manos abiertas: tono de piel claro medio, tono de piel claro medio
ğŸ‘ğŸ½	abiertas, manos, manos abiertas: tono de piel medio, tono de piel medio
ğŸ‘ğŸ¾	abiertas, manos, manos abiertas: tono de piel oscuro medio, tono de piel oscuro medio
ğŸ‘ğŸ¿	abiertas, manos, manos abiertas: tono de piel oscuro, tono de piel oscuro
ğŸ¤²ğŸ»	oraciÃ³n, palmas hacia arriba juntas, palmas hacia arriba juntas: tono de piel claro, tono de piel claro
ğŸ¤²ğŸ¼	oraciÃ³n, palmas hacia arriba juntas, palmas hacia arriba juntas: tono de piel claro medio, tono de piel claro medio
ğŸ¤²ğŸ½	oraciÃ³n, palmas hacia arriba juntas, palmas hacia arriba juntas: tono de piel medio, tono de piel medio
ğŸ¤²ğŸ¾	oraciÃ³n, palmas hacia arriba juntas, palmas hacia arriba juntas: tono de piel oscuro medio, tono de piel oscuro medio
ğŸ¤²ğŸ¿	oraciÃ³n, palmas hacia arriba juntas, palmas hacia arriba juntas: tono de piel oscuro, tono de piel oscuro
ğŸ™	favor, gracias, oraciÃ³n, orar, rezar
ğŸ™ğŸ»	favor, gracias, manos en oraciÃ³n: tono de piel claro, oraciÃ³n, orar, rezar, tono de piel claro
ğŸ™ğŸ¼	favor, gracias, manos en oraciÃ³n: tono de piel claro medio, oraciÃ³n, orar, rezar, tono de piel claro medio
ğŸ™ğŸ½	favor, gracias, manos en oraciÃ³n: tono de piel medio, oraciÃ³n, orar, rezar, tono de piel medio
ğŸ™ğŸ¾	favor, gracias, manos en oraciÃ³n: tono de piel oscuro medio, oraciÃ³n, orar, rezar, tono de piel oscuro medio
ğŸ™ğŸ¿	favor, gracias, manos en oraciÃ³n: tono de piel oscuro, oraciÃ³n, orar, rezar, tono de piel oscuro
âœğŸ»	cuerpo, escribir, lÃ¡piz, mano, mano escribiendo, mano escribiendo: tono de piel claro, tono de piel claro
âœğŸ¼	cuerpo, escribir, lÃ¡piz, mano, mano escribiendo, mano escribiendo: tono de piel claro medio, tono de piel claro medio
âœğŸ½	cuerpo, escribir, lÃ¡piz, mano, mano escribiendo, mano escribiendo: tono de piel medio, tono de piel medio
âœğŸ¾	cuerpo, escribir, lÃ¡piz, mano, mano escribiendo, mano escribiendo: tono de piel oscuro medio, tono de piel oscuro medio
âœğŸ¿	cuerpo, escribir, lÃ¡piz, mano, mano escribiendo, mano escribiendo: tono de piel oscuro, tono de piel oscuro
ğŸ’…	esmalte, pintarse las uÃ±as, uÃ±as
ğŸ’…ğŸ»	esmalte, pintarse las uÃ±as, pintarse las uÃ±as: tono de piel claro, tono de piel claro, uÃ±as
ğŸ’…ğŸ¼	esmalte, pintarse las uÃ±as, pintarse las uÃ±as: tono de piel claro medio, tono de piel claro medio, uÃ±as
ğŸ’…ğŸ½	esmalte, pintarse las uÃ±as, pintarse las uÃ±as: tono de piel medio, tono de piel medio, uÃ±as
ğŸ’…ğŸ¾	esmalte, pintarse las uÃ±as, pintarse las uÃ±as: tono de piel oscuro medio, tono de piel oscuro medio, uÃ±as
ğŸ’…ğŸ¿	esmalte, pintarse las uÃ±as, pintarse las uÃ±as: tono de piel oscuro, tono de piel oscuro, uÃ±as
ğŸ¤³	selfi
ğŸ¤³ğŸ»	selfi, selfi: tono de piel claro, tono de piel claro
ğŸ¤³ğŸ¼	selfi, selfi: tono de piel claro medio, tono de piel claro medio
ğŸ¤³ğŸ½	selfi, selfi: tono de piel medio, tono de piel medio
ğŸ¤³ğŸ¾	selfi, selfi: tono de piel oscuro medio, tono de piel oscuro medio
ğŸ¤³ğŸ¿	selfi, selfi: tono de piel oscuro, tono de piel oscuro
ğŸ’ªğŸ»	bÃ­ceps, bÃ­ceps flexionado: tono de piel claro, cÃ³mic, flexionado, fuerte, mÃºsculo, tono de piel claro
ğŸ’ªğŸ¼	bÃ­ceps, bÃ­ceps flexionado: tono de piel claro medio, cÃ³mic, flexionado, fuerte, mÃºsculo, tono de piel claro medio
ğŸ’ªğŸ½	bÃ­ceps, bÃ­ceps flexionado: tono de piel medio, cÃ³mic, flexionado, fuerte, mÃºsculo, tono de piel medio
ğŸ’ªğŸ¾	bÃ­ceps, bÃ­ceps flexionado: tono de piel oscuro medio, cÃ³mic, flexionado, fuerte, mÃºsculo, tono de piel oscuro medio
ğŸ’ªğŸ¿	bÃ­ceps, bÃ­ceps flexionado: tono de piel oscuro, cÃ³mic, flexionado, fuerte, mÃºsculo, tono de piel oscuro
ğŸ¦µğŸ»	extremidad, patada, pierna, pierna: tono de piel claro, tono de piel claro
ğŸ¦µğŸ¼	extremidad, patada, pierna, pierna: tono de piel claro medio, tono de piel claro medio
ğŸ¦µğŸ½	extremidad, patada, pierna, pierna: tono de piel medio, tono de piel medio
ğŸ¦µğŸ¾	extremidad, patada, pierna, pierna: tono de piel oscuro medio, tono de piel oscuro medio
ğŸ¦µğŸ¿	extremidad, patada, pierna, pierna: tono de piel oscuro, tono de piel oscuro
ğŸ¦¶ğŸ»	patada, pie, pie: tono de piel claro, pisotÃ³n, tono de piel claro
ğŸ¦¶ğŸ¼	patada, pie, pie: tono de piel claro medio, pisotÃ³n, tono de piel claro medio
ğŸ¦¶ğŸ½	patada, pie, pie: tono de piel medio, pisotÃ³n, tono de piel medio
ğŸ¦¶ğŸ¾	patada, pie, pie: tono de piel oscuro medio, pisotÃ³n, tono de piel oscuro medio
ğŸ¦¶ğŸ¿	patada, pie, pie: tono de piel oscuro, pisotÃ³n, tono de piel oscuro
ğŸ‘‚ğŸ»	cuerpo, oreja, oreja: tono de piel claro, tono de piel claro
ğŸ‘‚ğŸ¼	cuerpo, oreja, oreja: tono de piel claro medio, tono de piel claro medio
ğŸ‘‚ğŸ½	cuerpo, oreja, oreja: tono de piel medio, tono de piel medio
ğŸ‘‚ğŸ¾	cuerpo, oreja, oreja: tono de piel oscuro medio, tono de piel oscuro medio
ğŸ‘‚ğŸ¿	cuerpo, oreja, oreja: tono de piel oscuro, tono de piel oscuro
ğŸ¦»ğŸ»	accesibilidad, audÃ­fono, oreja con audÃ­fono, oreja con audÃ­fono: tono de piel claro, prÃ³tesis auditiva, sordo, tono de piel claro
ğŸ¦»ğŸ¼	accesibilidad, audÃ­fono, oreja con audÃ­fono, oreja con audÃ­fono: tono de piel claro medio, prÃ³tesis auditiva, sordo, tono de piel claro medio
ğŸ¦»ğŸ½	accesibilidad, audÃ­fono, oreja con audÃ­fono, oreja con audÃ­fono: tono de piel medio, prÃ³tesis auditiva, sordo, tono de piel medio
ğŸ¦»ğŸ¾	accesibilidad, audÃ­fono, oreja con audÃ­fono, oreja con audÃ­fono: tono de piel oscuro medio, prÃ³tesis auditiva, sordo, tono de piel oscuro medio
ğŸ¦»ğŸ¿	accesibilidad, audÃ­fono, oreja con audÃ­fono, oreja con audÃ­fono: tono de piel oscuro, prÃ³tesis auditiva, sordo, tono de piel oscuro
ğŸ‘ƒğŸ»	cuerpo, nariz, nariz: tono de piel claro, tono de piel claro
ğŸ‘ƒğŸ¼	cuerpo, nariz, nariz: tono de piel claro medio, tono de piel claro medio
ğŸ‘ƒğŸ½	cuerpo, nariz, nariz: tono de piel medio, tono de piel medio
ğŸ‘ƒğŸ¾	cuerpo, nariz, nariz: tono de piel oscuro medio, tono de piel oscuro medio
ğŸ‘ƒğŸ¿	cuerpo, nariz, nariz: tono de piel oscuro, tono de piel oscuro
ğŸ‘¶	bebÃ©, cara, infante, nene
ğŸ‘¶ğŸ»	bebÃ©, bebÃ©: tono de piel claro, cara, infante, nene, tono de piel claro
ğŸ‘¶ğŸ¼	bebÃ©, bebÃ©: tono de piel claro medio, cara, infante, nene, tono de piel claro medio
ğŸ‘¶ğŸ½	bebÃ©, bebÃ©: tono de piel medio, cara, infante, nene, tono de piel medio
ğŸ‘¶ğŸ¾	bebÃ©, bebÃ©: tono de piel oscuro medio, cara, infante, nene, tono de piel oscuro medio
ğŸ‘¶ğŸ¿	bebÃ©, bebÃ©: tono de piel oscuro, cara, infante, nene, tono de piel oscuro
ğŸ§’	joven
ğŸ§’ğŸ»	joven, joven: tono de piel claro, tono de piel claro
ğŸ§’ğŸ¼	joven, joven: tono de piel claro medio, tono de piel claro medio
ğŸ§’ğŸ½	joven, joven: tono de piel medio, tono de piel medio
ğŸ§’ğŸ¾	joven, joven: tono de piel oscuro medio, tono de piel oscuro medio
ğŸ§’ğŸ¿	joven, joven: tono de piel oscuro, tono de piel oscuro
ğŸ‘¦ğŸ»	joven, niÃ±o, niÃ±o: tono de piel claro, tono de piel claro
ğŸ‘¦ğŸ¼	joven, niÃ±o, niÃ±o: tono de piel claro medio, tono de piel claro medio
ğŸ‘¦ğŸ½	joven, niÃ±o, niÃ±o: tono de piel medio, tono de piel medio
ğŸ‘¦ğŸ¾	joven, niÃ±o, niÃ±o: tono de piel oscuro medio, tono de piel oscuro medio
ğŸ‘¦ğŸ¿	joven, niÃ±o, niÃ±o: tono de piel oscuro, tono de piel oscuro
ğŸ‘§ğŸ»	chica, joven, niÃ±a, niÃ±a: tono de piel claro, tono de piel claro
ğŸ‘§ğŸ¼	chica, joven, niÃ±a, niÃ±a: tono de piel claro medio, tono de piel claro medio
ğŸ‘§ğŸ½	chica, joven, niÃ±a, niÃ±a: tono de piel medio, tono de piel medio
ğŸ‘§ğŸ¾	chica, joven, niÃ±a, niÃ±a: tono de piel oscuro medio, tono de piel oscuro medio
ğŸ‘§ğŸ¿	chica, joven, niÃ±a, niÃ±a: tono de piel oscuro, tono de piel oscuro
ğŸ§‘	persona
ğŸ§‘ğŸ»	persona, persona: tono de piel claro, tono de piel claro
ğŸ§‘ğŸ¼	persona, persona: tono de piel claro medio, tono de piel claro medio
ğŸ§‘ğŸ½	persona, persona: tono de piel medio, tono de piel medio
ğŸ§‘ğŸ¾	persona, persona: tono de piel oscuro medio, tono de piel oscuro medio
ğŸ§‘ğŸ¿	persona, persona: tono de piel oscuro, tono de piel oscuro
ğŸ‘±	cara, persona rubia
ğŸ‘±ğŸ»	cara, persona adulta rubia: tono de piel claro, persona rubia, tono de piel claro
ğŸ‘±ğŸ¼	cara, persona adulta rubia: tono de piel claro medio, persona rubia, tono de piel claro medio
ğŸ‘±ğŸ½	cara, persona adulta rubia: tono de piel medio, persona rubia, tono de piel medio
ğŸ‘±ğŸ¾	cara, persona adulta rubia: tono de piel oscuro medio, persona rubia, tono de piel oscuro medio
ğŸ‘±ğŸ¿	cara, persona adulta rubia: tono de piel oscuro, persona rubia, tono de piel oscuro
ğŸ‘¨	adulto, cara, persona, seÃ±or
ğŸ‘¨ğŸ»	adulto, cara, hombre: tono de piel claro, persona, seÃ±or, tono de piel claro
ğŸ‘¨ğŸ¼	adulto, cara, hombre: tono de piel claro medio, persona, seÃ±or, tono de piel claro medio
ğŸ‘¨ğŸ½	adulto, cara, hombre: tono de piel medio, persona, seÃ±or, tono de piel medio
ğŸ‘¨ğŸ¾	adulto, cara, hombre: tono de piel oscuro medio, persona, seÃ±or, tono de piel oscuro medio
ğŸ‘¨ğŸ¿	adulto, cara, hombre: tono de piel oscuro, persona, seÃ±or, tono de piel oscuro
ğŸ§”	barba, barbÃ³n, cara, persona con barba
ğŸ§”ğŸ»	barba, barbÃ³n, cara, hombre con barba: tono de piel claro, persona con barba, tono de piel claro
ğŸ§”ğŸ¼	barba, barbÃ³n, cara, hombre con barba: tono de piel claro medio, persona con barba, tono de piel claro medio
ğŸ§”ğŸ½	barba, barbÃ³n, cara, hombre con barba: tono de piel medio, persona con barba, tono de piel medio
ğŸ§”ğŸ¾	barba, barbÃ³n, cara, hombre con barba: tono de piel oscuro medio, persona con barba, tono de piel oscuro medio
ğŸ§”ğŸ¿	barba, barbÃ³n, cara, hombre con barba: tono de piel oscuro, persona con barba, tono de piel oscuro
ğŸ‘±â€â™‚	cara, gÃ¼ero, hombre rubio, rubio
ğŸ‘±ğŸ»â€â™‚	cara, gÃ¼ero, hombre rubio, hombre rubio: tono de piel claro, rubio, tono de piel claro
ğŸ‘±ğŸ¼â€â™‚	cara, gÃ¼ero, hombre rubio, hombre rubio: tono de piel claro medio, rubio, tono de piel claro medio
ğŸ‘±ğŸ½â€â™‚	cara, gÃ¼ero, hombre rubio, hombre rubio: tono de piel medio, rubio, tono de piel medio
ğŸ‘±ğŸ¾â€â™‚	cara, gÃ¼ero, hombre rubio, hombre rubio: tono de piel oscuro medio, rubio, tono de piel oscuro medio
ğŸ‘±ğŸ¿â€â™‚	cara, gÃ¼ero, hombre rubio, hombre rubio: tono de piel oscuro, rubio, tono de piel oscuro
ğŸ‘¨â€ğŸ¦°	adulto, cara, hombre: pelirrojo, pelirrojo, persona, seÃ±or
ğŸ‘¨ğŸ»â€ğŸ¦°	adulto, cara, hombre: tono de piel claro y pelirrojo, pelirrojo, persona, seÃ±or, tono de piel claro
ğŸ‘¨ğŸ¼â€ğŸ¦°	adulto, cara, hombre: tono de piel claro medio y pelirrojo, pelirrojo, persona, seÃ±or, tono de piel claro medio
ğŸ‘¨ğŸ½â€ğŸ¦°	adulto, cara, hombre: tono de piel medio y pelirrojo, pelirrojo, persona, seÃ±or, tono de piel medio
ğŸ‘¨ğŸ¾â€ğŸ¦°	adulto, cara, hombre: tono de piel oscuro medio y pelirrojo, pelirrojo, persona, seÃ±or, tono de piel oscuro medio
ğŸ‘¨ğŸ¿â€ğŸ¦°	adulto, cara, hombre: tono de piel oscuro y pelirrojo, pelirrojo, persona, seÃ±or, tono de piel oscuro
ğŸ‘¨â€ğŸ¦±	adulto, cara, hombre: pelo enrulado, pelo enrulado, persona, seÃ±or
ğŸ‘¨ğŸ»â€ğŸ¦±	adulto, cara, hombre: tono de piel claro y pelo enrulado, pelo enrulado, persona, seÃ±or, tono de piel claro
ğŸ‘¨ğŸ¼â€ğŸ¦±	adulto, cara, hombre: tono de piel claro medio y pelo enrulado, pelo enrulado, persona, seÃ±or, tono de piel claro medio
ğŸ‘¨ğŸ½â€ğŸ¦±	adulto, cara, hombre: tono de piel medio y pelo enrulado, pelo enrulado, persona, seÃ±or, tono de piel medio
ğŸ‘¨ğŸ¾â€ğŸ¦±	adulto, cara, hombre: tono de piel oscuro medio y pelo enrulado, pelo enrulado, persona, seÃ±or, tono de piel oscuro medio
ğŸ‘¨ğŸ¿â€ğŸ¦±	adulto, cara, hombre: tono de piel oscuro y pelo enrulado, pelo enrulado, persona, seÃ±or, tono de piel oscuro
ğŸ‘¨â€ğŸ¦³	adulto, cara, hombre: pelo canoso, pelo canoso, persona, seÃ±or
ğŸ‘¨ğŸ»â€ğŸ¦³	adulto, cara, hombre: tono de piel claro y pelo canoso, pelo canoso, persona, seÃ±or, tono de piel claro
ğŸ‘¨ğŸ¼â€ğŸ¦³	adulto, cara, hombre: tono de piel claro medio y pelo canoso, pelo canoso, persona, seÃ±or, tono de piel claro medio
ğŸ‘¨ğŸ½â€ğŸ¦³	adulto, cara, hombre: tono de piel medio y pelo canoso, pelo canoso, persona, seÃ±or, tono de piel medio
ğŸ‘¨ğŸ¾â€ğŸ¦³	adulto, cara, hombre: tono de piel oscuro medio y pelo canoso, pelo canoso, persona, seÃ±or, tono de piel oscuro medio
ğŸ‘¨ğŸ¿â€ğŸ¦³	adulto, cara, hombre: tono de piel oscuro y pelo canoso, pelo canoso, persona, seÃ±or, tono de piel oscuro
ğŸ‘¨â€ğŸ¦²	adulto, calvo, cara, hombre: calvo, persona, seÃ±or
ğŸ‘¨ğŸ»â€ğŸ¦²	adulto, calvo, cara, hombre: tono de piel claro y calvo, persona, seÃ±or, tono de piel claro
ğŸ‘¨ğŸ¼â€ğŸ¦²	adulto, calvo, cara, hombre: tono de piel claro medio y calvo, persona, seÃ±or, tono de piel claro medio
ğŸ‘¨ğŸ½â€ğŸ¦²	adulto, calvo, cara, hombre: tono de piel medio y calvo, persona, seÃ±or, tono de piel medio
ğŸ‘¨ğŸ¾â€ğŸ¦²	adulto, calvo, cara, hombre: tono de piel oscuro medio y calvo, persona, seÃ±or, tono de piel oscuro medio
ğŸ‘¨ğŸ¿â€ğŸ¦²	adulto, calvo, cara, hombre: tono de piel oscuro y calvo, persona, seÃ±or, tono de piel oscuro
ğŸ‘©ğŸ»	adulta, mujer, mujer: tono de piel claro, tono de piel claro
ğŸ‘©ğŸ¼	adulta, mujer, mujer: tono de piel claro medio, tono de piel claro medio
ğŸ‘©ğŸ½	adulta, mujer, mujer: tono de piel medio, tono de piel medio
ğŸ‘©ğŸ¾	adulta, mujer, mujer: tono de piel oscuro medio, tono de piel oscuro medio
ğŸ‘©ğŸ¿	adulta, mujer, mujer: tono de piel oscuro, tono de piel oscuro
ğŸ‘±â€â™€	cara, gÃ¼era, mujer, mujer rubia
ğŸ‘±ğŸ»â€â™€	cara, gÃ¼era, mujer, mujer rubia, mujer rubia: tono de piel claro, tono de piel claro
ğŸ‘±ğŸ¼â€â™€	cara, gÃ¼era, mujer, mujer rubia, mujer rubia: tono de piel claro medio, tono de piel claro medio
ğŸ‘±ğŸ½â€â™€	cara, gÃ¼era, mujer, mujer rubia, mujer rubia: tono de piel medio, tono de piel medio
ğŸ‘±ğŸ¾â€â™€	cara, gÃ¼era, mujer, mujer rubia, mujer rubia: tono de piel oscuro medio, tono de piel oscuro medio
ğŸ‘±ğŸ¿â€â™€	cara, gÃ¼era, mujer, mujer rubia, mujer rubia: tono de piel oscuro, tono de piel oscuro
ğŸ‘©â€ğŸ¦°	adulta, mujer, mujer: pelirrojo, pelirrojo
ğŸ‘©ğŸ»â€ğŸ¦°	adulta, mujer, mujer: tono de piel claro y pelirrojo, pelirrojo, tono de piel claro
ğŸ‘©ğŸ¼â€ğŸ¦°	adulta, mujer, mujer: tono de piel claro medio y pelirrojo, pelirrojo, tono de piel claro medio
ğŸ‘©ğŸ½â€ğŸ¦°	adulta, mujer, mujer: tono de piel medio y pelirrojo, pelirrojo, tono de piel medio
ğŸ‘©ğŸ¾â€ğŸ¦°	adulta, mujer, mujer: tono de piel oscuro medio y pelirrojo, pelirrojo, tono de piel oscuro medio
ğŸ‘©ğŸ¿â€ğŸ¦°	adulta, mujer, mujer: tono de piel oscuro y pelirrojo, pelirrojo, tono de piel oscuro
ğŸ‘©â€ğŸ¦±	adulta, mujer, mujer: pelo enrulado, pelo enrulado
ğŸ‘©ğŸ»â€ğŸ¦±	adulta, mujer, mujer: tono de piel claro y pelo enrulado, pelo enrulado, tono de piel claro
ğŸ‘©ğŸ¼â€ğŸ¦±	adulta, mujer, mujer: tono de piel claro medio y pelo enrulado, pelo enrulado, tono de piel claro medio
ğŸ‘©ğŸ½â€ğŸ¦±	adulta, mujer, mujer: tono de piel medio y pelo enrulado, pelo enrulado, tono de piel medio
ğŸ‘©ğŸ¾â€ğŸ¦±	adulta, mujer, mujer: tono de piel oscuro medio y pelo enrulado, pelo enrulado, tono de piel oscuro medio
ğŸ‘©ğŸ¿â€ğŸ¦±	adulta, mujer, mujer: tono de piel oscuro y pelo enrulado, pelo enrulado, tono de piel oscuro
ğŸ‘©â€ğŸ¦³	adulta, mujer, mujer: pelo canoso, pelo canoso
ğŸ‘©ğŸ»â€ğŸ¦³	adulta, mujer, mujer: tono de piel claro y pelo canoso, pelo canoso, tono de piel claro
ğŸ‘©ğŸ¼â€ğŸ¦³	adulta, mujer, mujer: tono de piel claro medio y pelo canoso, pelo canoso, tono de piel claro medio
ğŸ‘©ğŸ½â€ğŸ¦³	adulta, mujer, mujer: tono de piel medio y pelo canoso, pelo canoso, tono de piel medio
ğŸ‘©ğŸ¾â€ğŸ¦³	adulta, mujer, mujer: tono de piel oscuro medio y pelo canoso, pelo canoso, tono de piel oscuro medio
ğŸ‘©ğŸ¿â€ğŸ¦³	adulta, mujer, mujer: tono de piel oscuro y pelo canoso, pelo canoso, tono de piel oscuro
ğŸ‘©â€ğŸ¦²	adulta, calvo, mujer, mujer: calvo
ğŸ‘©ğŸ»â€ğŸ¦²	adulta, calvo, mujer, mujer: tono de piel claro y calvo, tono de piel claro
ğŸ‘©ğŸ¼â€ğŸ¦²	adulta, calvo, mujer, mujer: tono de piel claro medio y calvo, tono de piel claro medio
ğŸ‘©ğŸ½â€ğŸ¦²	adulta, calvo, mujer, mujer: tono de piel medio y calvo, tono de piel medio
ğŸ‘©ğŸ¾â€ğŸ¦²	adulta, calvo, mujer, mujer: tono de piel oscuro medio y calvo, tono de piel oscuro medio
ğŸ‘©ğŸ¿â€ğŸ¦²	adulta, calvo, mujer, mujer: tono de piel oscuro y calvo, tono de piel oscuro
ğŸ§“	persona mayor
ğŸ§“ğŸ»	persona mayor, persona mayor: tono de piel claro, tono de piel claro
ğŸ§“ğŸ¼	persona mayor, persona mayor: tono de piel claro medio, tono de piel claro medio
ğŸ§“ğŸ½	persona mayor, persona mayor: tono de piel medio, tono de piel medio
ğŸ§“ğŸ¾	persona mayor, persona mayor: tono de piel oscuro medio, tono de piel oscuro medio
ğŸ§“ğŸ¿	persona mayor, persona mayor: tono de piel oscuro, tono de piel oscuro
ğŸ‘´ğŸ»	anciano, anciano: tono de piel claro, hombre, mayor, tono de piel claro
ğŸ‘´ğŸ¼	anciano, anciano: tono de piel claro medio, hombre, mayor, tono de piel claro medio
ğŸ‘´ğŸ½	anciano, anciano: tono de piel medio, hombre, mayor, tono de piel medio
ğŸ‘´ğŸ¾	anciano, anciano: tono de piel oscuro medio, hombre, mayor, tono de piel oscuro medio
ğŸ‘´ğŸ¿	anciano, anciano: tono de piel oscuro, hombre, mayor, tono de piel oscuro
ğŸ‘µğŸ»	anciana, anciana: tono de piel claro, mayor, mujer, tono de piel claro
ğŸ‘µğŸ¼	anciana, anciana: tono de piel claro medio, mayor, mujer, tono de piel claro medio
ğŸ‘µğŸ½	anciana, anciana: tono de piel medio, mayor, mujer, tono de piel medio
ğŸ‘µğŸ¾	anciana, anciana: tono de piel oscuro medio, mayor, mujer, tono de piel oscuro medio
ğŸ‘µğŸ¿	anciana, anciana: tono de piel oscuro, mayor, mujer, tono de piel oscuro
ğŸ™	persona frunciendo el ceÃ±o
ğŸ™ğŸ»	persona frunciendo el ceÃ±o, persona frunciendo el ceÃ±o: tono de piel claro, tono de piel claro
ğŸ™ğŸ¼	persona frunciendo el ceÃ±o, persona frunciendo el ceÃ±o: tono de piel claro medio, tono de piel claro medio
ğŸ™ğŸ½	persona frunciendo el ceÃ±o, persona frunciendo el ceÃ±o: tono de piel medio, tono de piel medio
ğŸ™ğŸ¾	persona frunciendo el ceÃ±o, persona frunciendo el ceÃ±o: tono de piel oscuro medio, tono de piel oscuro medio
ğŸ™ğŸ¿	persona frunciendo el ceÃ±o, persona frunciendo el ceÃ±o: tono de piel oscuro, tono de piel oscuro
ğŸ™ğŸ»â€â™‚	ceÃ±o, fruncido, gesto, hombre, hombre frunciendo el ceÃ±o, hombre frunciendo el ceÃ±o: tono de piel claro, tono de piel claro
ğŸ™ğŸ¼â€â™‚	ceÃ±o, fruncido, gesto, hombre, hombre frunciendo el ceÃ±o, hombre frunciendo el ceÃ±o: tono de piel claro medio, tono de piel claro medio
ğŸ™ğŸ½â€â™‚	ceÃ±o, fruncido, gesto, hombre, hombre frunciendo el ceÃ±o, hombre frunciendo el ceÃ±o: tono de piel medio, tono de piel medio
ğŸ™ğŸ¾â€â™‚	ceÃ±o, fruncido, gesto, hombre, hombre frunciendo el ceÃ±o, hombre frunciendo el ceÃ±o: tono de piel oscuro medio, tono de piel oscuro medio
ğŸ™ğŸ¿â€â™‚	ceÃ±o, fruncido, gesto, hombre, hombre frunciendo el ceÃ±o, hombre frunciendo el ceÃ±o: tono de piel oscuro, tono de piel oscuro
ğŸ™â€â™€	mujer frunciendo el ceÃ±o
ğŸ™ğŸ»â€â™€	mujer frunciendo el ceÃ±o, mujer frunciendo el ceÃ±o: tono de piel claro, tono de piel claro
ğŸ™ğŸ¼â€â™€	mujer frunciendo el ceÃ±o, mujer frunciendo el ceÃ±o: tono de piel claro medio, tono de piel claro medio
ğŸ™ğŸ½â€â™€	mujer frunciendo el ceÃ±o, mujer frunciendo el ceÃ±o: tono de piel medio, tono de piel medio
ğŸ™ğŸ¾â€â™€	mujer frunciendo el ceÃ±o, mujer frunciendo el ceÃ±o: tono de piel oscuro medio, tono de piel oscuro medio
ğŸ™ğŸ¿â€â™€	mujer frunciendo el ceÃ±o, mujer frunciendo el ceÃ±o: tono de piel oscuro, tono de piel oscuro
ğŸ™	persona haciendo pucheros
ğŸ™ğŸ»	persona haciendo pucheros, persona haciendo pucheros: tono de piel claro, tono de piel claro
ğŸ™ğŸ¼	persona haciendo pucheros, persona haciendo pucheros: tono de piel claro medio, tono de piel claro medio
ğŸ™ğŸ½	persona haciendo pucheros, persona haciendo pucheros: tono de piel medio, tono de piel medio
ğŸ™ğŸ¾	persona haciendo pucheros, persona haciendo pucheros: tono de piel oscuro medio, tono de piel oscuro medio
ğŸ™ğŸ¿	persona haciendo pucheros, persona haciendo pucheros: tono de piel oscuro, tono de piel oscuro
ğŸ™ğŸ»â€â™‚	gesto, hombre, hombre haciendo pucheros, hombre haciendo pucheros: tono de piel claro, pucheros, tono de piel claro
ğŸ™ğŸ¼â€â™‚	gesto, hombre, hombre haciendo pucheros, hombre haciendo pucheros: tono de piel claro medio, pucheros, tono de piel claro medio
ğŸ™ğŸ½â€â™‚	gesto, hombre, hombre haciendo pucheros, hombre haciendo pucheros: tono de piel medio, pucheros, tono de piel medio
ğŸ™ğŸ¾â€â™‚	gesto, hombre, hombre haciendo pucheros, hombre haciendo pucheros: tono de piel oscuro medio, pucheros, tono de piel oscuro medio
ğŸ™ğŸ¿â€â™‚	gesto, hombre, hombre haciendo pucheros, hombre haciendo pucheros: tono de piel oscuro, pucheros, tono de piel oscuro
ğŸ™ğŸ»â€â™€	gesto, mujer, mujer haciendo pucheros, mujer haciendo pucheros: tono de piel claro, pucheros, tono de piel claro
ğŸ™ğŸ¼â€â™€	gesto, mujer, mujer haciendo pucheros, mujer haciendo pucheros: tono de piel claro medio, pucheros, tono de piel claro medio
ğŸ™ğŸ½â€â™€	gesto, mujer, mujer haciendo pucheros, mujer haciendo pucheros: tono de piel medio, pucheros, tono de piel medio
ğŸ™ğŸ¾â€â™€	gesto, mujer, mujer haciendo pucheros, mujer haciendo pucheros: tono de piel oscuro medio, pucheros, tono de piel oscuro medio
ğŸ™ğŸ¿â€â™€	gesto, mujer, mujer haciendo pucheros, mujer haciendo pucheros: tono de piel oscuro, pucheros, tono de piel oscuro
ğŸ™…	persona haciendo el gesto de "no"
ğŸ™…ğŸ»	persona haciendo el gesto de "no", persona haciendo el gesto de "no": tono de piel claro, tono de piel claro
ğŸ™…ğŸ¼	persona haciendo el gesto de "no", persona haciendo el gesto de "no": tono de piel claro medio, tono de piel claro medio
ğŸ™…ğŸ½	persona haciendo el gesto de "no", persona haciendo el gesto de "no": tono de piel medio, tono de piel medio
ğŸ™…ğŸ¾	persona haciendo el gesto de "no", persona haciendo el gesto de "no": tono de piel oscuro medio, tono de piel oscuro medio
ğŸ™…ğŸ¿	persona haciendo el gesto de "no", persona haciendo el gesto de "no": tono de piel oscuro, tono de piel oscuro
ğŸ™…ğŸ»â€â™‚	gesto, hombre, hombre haciendo el gesto de "no", hombre haciendo el gesto de "no": tono de piel claro, mano, prohibido, tono de piel claro
ğŸ™…ğŸ¼â€â™‚	gesto, hombre, hombre haciendo el gesto de "no", hombre haciendo el gesto de "no": tono de piel claro medio, mano, prohibido, tono de piel claro medio
ğŸ™…ğŸ½â€â™‚	gesto, hombre, hombre haciendo el gesto de "no", hombre haciendo el gesto de "no": tono de piel medio, mano, prohibido, tono de piel medio
ğŸ™…ğŸ¾â€â™‚	gesto, hombre, hombre haciendo el gesto de "no", hombre haciendo el gesto de "no": tono de piel oscuro medio, mano, prohibido, tono de piel oscuro medio
ğŸ™…ğŸ¿â€â™‚	gesto, hombre, hombre haciendo el gesto de "no", hombre haciendo el gesto de "no": tono de piel oscuro, mano, prohibido, tono de piel oscuro
ğŸ™…ğŸ»â€â™€	gesto, mano, mujer, mujer haciendo el gesto de "no", mujer haciendo el gesto de "no": tono de piel claro, prohibido, tono de piel claro
ğŸ™…ğŸ¼â€â™€	gesto, mano, mujer, mujer haciendo el gesto de "no", mujer haciendo el gesto de "no": tono de piel claro medio, prohibido, tono de piel claro medio
ğŸ™…ğŸ½â€â™€	gesto, mano, mujer, mujer haciendo el gesto de "no", mujer haciendo el gesto de "no": tono de piel medio, prohibido, tono de piel medio
ğŸ™…ğŸ¾â€â™€	gesto, mano, mujer, mujer haciendo el gesto de "no", mujer haciendo el gesto de "no": tono de piel oscuro medio, prohibido, tono de piel oscuro medio
ğŸ™…ğŸ¿â€â™€	gesto, mano, mujer, mujer haciendo el gesto de "no", mujer haciendo el gesto de "no": tono de piel oscuro, prohibido, tono de piel oscuro
ğŸ™†	persona haciendo el gesto de "de acuerdo"
ğŸ™†ğŸ»	persona haciendo el gesto de "de acuerdo", persona haciendo el gesto de "de acuerdo": tono de piel claro, tono de piel claro
ğŸ™†ğŸ¼	persona haciendo el gesto de "de acuerdo", persona haciendo el gesto de "de acuerdo": tono de piel claro medio, tono de piel claro medio
ğŸ™†ğŸ½	persona haciendo el gesto de "de acuerdo", persona haciendo el gesto de "de acuerdo": tono de piel medio, tono de piel medio
ğŸ™†ğŸ¾	persona haciendo el gesto de "de acuerdo", persona haciendo el gesto de "de acuerdo": tono de piel oscuro medio, tono de piel oscuro medio
ğŸ™†ğŸ¿	persona haciendo el gesto de "de acuerdo", persona haciendo el gesto de "de acuerdo": tono de piel oscuro, tono de piel oscuro
ğŸ™†ğŸ»â€â™‚	OK, gesto, hombre haciendo el gesto de "de acuerdo", hombre haciendo el gesto de "de acuerdo": tono de piel claro, mano, tono de piel claro, vale
ğŸ™†ğŸ¼â€â™‚	OK, gesto, hombre haciendo el gesto de "de acuerdo", hombre haciendo el gesto de "de acuerdo": tono de piel claro medio, mano, tono de piel claro medio, vale
ğŸ™†ğŸ½â€â™‚	OK, gesto, hombre haciendo el gesto de "de acuerdo", hombre haciendo el gesto de "de acuerdo": tono de piel medio, mano, tono de piel medio, vale
ğŸ™†ğŸ¾â€â™‚	OK, gesto, hombre haciendo el gesto de "de acuerdo", hombre haciendo el gesto de "de acuerdo": tono de piel oscuro medio, mano, tono de piel oscuro medio, vale
ğŸ™†ğŸ¿â€â™‚	OK, gesto, hombre haciendo el gesto de "de acuerdo", hombre haciendo el gesto de "de acuerdo": tono de piel oscuro, mano, tono de piel oscuro, vale
ğŸ™†ğŸ»â€â™€	OK, gesto, mano, mujer haciendo el gesto de "de acuerdo", mujer haciendo el gesto de "de acuerdo": tono de piel claro, tono de piel claro, vale
ğŸ™†ğŸ¼â€â™€	OK, gesto, mano, mujer haciendo el gesto de "de acuerdo", mujer haciendo el gesto de "de acuerdo": tono de piel claro medio, tono de piel claro medio, vale
ğŸ™†ğŸ½â€â™€	OK, gesto, mano, mujer haciendo el gesto de "de acuerdo", mujer haciendo el gesto de "de acuerdo": tono de piel medio, tono de piel medio, vale
ğŸ™†ğŸ¾â€â™€	OK, gesto, mano, mujer haciendo el gesto de "de acuerdo", mujer haciendo el gesto de "de acuerdo": tono de piel oscuro medio, tono de piel oscuro medio, vale
ğŸ™†ğŸ¿â€â™€	OK, gesto, mano, mujer haciendo el gesto de "de acuerdo", mujer haciendo el gesto de "de acuerdo": tono de piel oscuro, tono de piel oscuro, vale
ğŸ’	informaciÃ³n, mesa, persona, persona de mostrador de informaciÃ³n, persona en mostrador de informaciÃ³n
ğŸ’ğŸ»	informaciÃ³n, mesa, persona, persona de mostrador de informaciÃ³n, persona de mostrador de informaciÃ³n: tono de piel claro, persona en mostrador de informaciÃ³n, tono de piel claro
ğŸ’ğŸ¼	informaciÃ³n, mesa, persona, persona de mostrador de informaciÃ³n, persona de mostrador de informaciÃ³n: tono de piel claro medio, persona en mostrador de informaciÃ³n, tono de piel claro medio
ğŸ’ğŸ½	informaciÃ³n, mesa, persona, persona de mostrador de informaciÃ³n, persona de mostrador de informaciÃ³n: tono de piel medio, persona en mostrador de informaciÃ³n, tono de piel medio
ğŸ’ğŸ¾	informaciÃ³n, mesa, persona, persona de mostrador de informaciÃ³n, persona de mostrador de informaciÃ³n: tono de piel oscuro medio, persona en mostrador de informaciÃ³n, tono de piel oscuro medio
ğŸ’ğŸ¿	informaciÃ³n, mesa, persona, persona de mostrador de informaciÃ³n, persona de mostrador de informaciÃ³n: tono de piel oscuro, persona en mostrador de informaciÃ³n, tono de piel oscuro
ğŸ’â€â™‚	empleado, hombre, hombre en mostrador de informaciÃ³n, informaciÃ³n, mesa
ğŸ’ğŸ»â€â™‚	empleado, empleado de mostrador de informaciÃ³n: tono de piel claro, hombre, hombre en mostrador de informaciÃ³n, informaciÃ³n, mesa, tono de piel claro
ğŸ’ğŸ¼â€â™‚	empleado, empleado de mostrador de informaciÃ³n: tono de piel claro medio, hombre, hombre en mostrador de informaciÃ³n, informaciÃ³n, mesa, tono de piel claro medio
ğŸ’ğŸ½â€â™‚	empleado, empleado de mostrador de informaciÃ³n: tono de piel medio, hombre, hombre en mostrador de informaciÃ³n, informaciÃ³n, mesa, tono de piel medio
ğŸ’ğŸ¾â€â™‚	empleado, empleado de mostrador de informaciÃ³n: tono de piel oscuro medio, hombre, hombre en mostrador de informaciÃ³n, informaciÃ³n, mesa, tono de piel oscuro medio
ğŸ’ğŸ¿â€â™‚	empleado, empleado de mostrador de informaciÃ³n: tono de piel oscuro, hombre, hombre en mostrador de informaciÃ³n, informaciÃ³n, mesa, tono de piel oscuro
ğŸ’â€â™€	empleada, informaciÃ³n, mesa, mujer, mujer en mostrador de informaciÃ³n
ğŸ’ğŸ»â€â™€	empleada, empleada de mostrador de informaciÃ³n: tono de piel claro, informaciÃ³n, mesa, mujer, mujer en mostrador de informaciÃ³n, tono de piel claro
ğŸ’ğŸ¼â€â™€	empleada, empleada de mostrador de informaciÃ³n: tono de piel claro medio, informaciÃ³n, mesa, mujer, mujer en mostrador de informaciÃ³n, tono de piel claro medio
ğŸ’ğŸ½â€â™€	empleada, empleada de mostrador de informaciÃ³n: tono de piel medio, informaciÃ³n, mesa, mujer, mujer en mostrador de informaciÃ³n, tono de piel medio
ğŸ’ğŸ¾â€â™€	empleada, empleada de mostrador de informaciÃ³n: tono de piel oscuro medio, informaciÃ³n, mesa, mujer, mujer en mostrador de informaciÃ³n, tono de piel oscuro medio
ğŸ’ğŸ¿â€â™€	empleada, empleada de mostrador de informaciÃ³n: tono de piel oscuro, informaciÃ³n, mesa, mujer, mujer en mostrador de informaciÃ³n, tono de piel oscuro
ğŸ™‹	levantar, mano, persona, persona levantando la mano, yo
ğŸ™‹ğŸ»	levantar, mano, persona, persona con la mano levantada: tono de piel claro, persona levantando la mano, tono de piel claro, yo
ğŸ™‹ğŸ¼	levantar, mano, persona, persona con la mano levantada: tono de piel claro medio, persona levantando la mano, tono de piel claro medio, yo
ğŸ™‹ğŸ½	levantar, mano, persona, persona con la mano levantada: tono de piel medio, persona levantando la mano, tono de piel medio, yo
ğŸ™‹ğŸ¾	levantar, mano, persona, persona con la mano levantada: tono de piel oscuro medio, persona levantando la mano, tono de piel oscuro medio, yo
ğŸ™‹ğŸ¿	levantar, mano, persona, persona con la mano levantada: tono de piel oscuro, persona levantando la mano, tono de piel oscuro, yo
ğŸ™‹ğŸ»â€â™‚	gesto, hombre, hombre con la mano levantada, hombre con la mano levantada: tono de piel claro, levantar, mano, tono de piel claro
ğŸ™‹ğŸ¼â€â™‚	gesto, hombre, hombre con la mano levantada, hombre con la mano levantada: tono de piel claro medio, levantar, mano, tono de piel claro medio
ğŸ™‹ğŸ½â€â™‚	gesto, hombre, hombre con la mano levantada, hombre con la mano levantada: tono de piel medio, levantar, mano, tono de piel medio
ğŸ™‹ğŸ¾â€â™‚	gesto, hombre, hombre con la mano levantada, hombre con la mano levantada: tono de piel oscuro medio, levantar, mano, tono de piel oscuro medio
ğŸ™‹ğŸ¿â€â™‚	gesto, hombre, hombre con la mano levantada, hombre con la mano levantada: tono de piel oscuro, levantar, mano, tono de piel oscuro
ğŸ™‹ğŸ»â€â™€	gesto, levantar, mano, mujer, mujer con la mano levantada, mujer con la mano levantada: tono de piel claro, tono de piel claro
ğŸ™‹ğŸ¼â€â™€	gesto, levantar, mano, mujer, mujer con la mano levantada, mujer con la mano levantada: tono de piel claro medio, tono de piel claro medio
ğŸ™‹ğŸ½â€â™€	gesto, levantar, mano, mujer, mujer con la mano levantada, mujer con la mano levantada: tono de piel medio, tono de piel medio
ğŸ™‹ğŸ¾â€â™€	gesto, levantar, mano, mujer, mujer con la mano levantada, mujer con la mano levantada: tono de piel oscuro medio, tono de piel oscuro medio
ğŸ™‹ğŸ¿â€â™€	gesto, levantar, mano, mujer, mujer con la mano levantada, mujer con la mano levantada: tono de piel oscuro, tono de piel oscuro
ğŸ§ğŸ»	accesibilidad, escuchar, oÃ­do, oÃ­r, persona sorda, persona sorda: tono de piel claro, sordera, tono de piel claro
ğŸ§ğŸ¼	accesibilidad, escuchar, oÃ­do, oÃ­r, persona sorda, persona sorda: tono de piel claro medio, sordera, tono de piel claro medio
ğŸ§ğŸ½	accesibilidad, escuchar, oÃ­do, oÃ­r, persona sorda, persona sorda: tono de piel medio, sordera, tono de piel medio
ğŸ§ğŸ¾	accesibilidad, escuchar, oÃ­do, oÃ­r, persona sorda, persona sorda: tono de piel oscuro medio, sordera, tono de piel oscuro medio
ğŸ§ğŸ¿	accesibilidad, escuchar, oÃ­do, oÃ­r, persona sorda, persona sorda: tono de piel oscuro, sordera, tono de piel oscuro
ğŸ§ğŸ»â€â™‚	hombre, hombre sordo: tono de piel claro, sordera, sordo, tono de piel claro
ğŸ§ğŸ¼â€â™‚	hombre, hombre sordo: tono de piel claro medio, sordera, sordo, tono de piel claro medio
ğŸ§ğŸ½â€â™‚	hombre, hombre sordo: tono de piel medio, sordera, sordo, tono de piel medio
ğŸ§ğŸ¾â€â™‚	hombre, hombre sordo: tono de piel oscuro medio, sordera, sordo, tono de piel oscuro medio
ğŸ§ğŸ¿â€â™‚	hombre, hombre sordo: tono de piel oscuro, sordera, sordo, tono de piel oscuro
ğŸ§ğŸ»â€â™€	mujer, mujer sorda: tono de piel claro, sorda, sordera, tono de piel claro
ğŸ§ğŸ¼â€â™€	mujer, mujer sorda: tono de piel claro medio, sorda, sordera, tono de piel claro medio
ğŸ§ğŸ½â€â™€	mujer, mujer sorda: tono de piel medio, sorda, sordera, tono de piel medio
ğŸ§ğŸ¾â€â™€	mujer, mujer sorda: tono de piel oscuro medio, sorda, sordera, tono de piel oscuro medio
ğŸ§ğŸ¿â€â™€	mujer, mujer sorda: tono de piel oscuro, sorda, sordera, tono de piel oscuro
ğŸ™‡ğŸ»	disculpa, gesto, perdÃ³n, persona haciendo una reverencia, persona haciendo una reverencia: tono de piel claro, reverencia, tono de piel claro
ğŸ™‡ğŸ¼	disculpa, gesto, perdÃ³n, persona haciendo una reverencia, persona haciendo una reverencia: tono de piel claro medio, reverencia, tono de piel claro medio
ğŸ™‡ğŸ½	disculpa, gesto, perdÃ³n, persona haciendo una reverencia, persona haciendo una reverencia: tono de piel medio, reverencia, tono de piel medio
ğŸ™‡ğŸ¾	disculpa, gesto, perdÃ³n, persona haciendo una reverencia, persona haciendo una reverencia: tono de piel oscuro medio, reverencia, tono de piel oscuro medio
ğŸ™‡ğŸ¿	disculpa, gesto, perdÃ³n, persona haciendo una reverencia, persona haciendo una reverencia: tono de piel oscuro, reverencia, tono de piel oscuro
ğŸ™‡ğŸ»â€â™‚	disculpa, gesto, hombre haciendo una reverencia, hombre haciendo una reverencia: tono de piel claro, perdÃ³n, reverencia, tono de piel claro
ğŸ™‡ğŸ¼â€â™‚	disculpa, gesto, hombre haciendo una reverencia, hombre haciendo una reverencia: tono de piel claro medio, perdÃ³n, reverencia, tono de piel claro medio
ğŸ™‡ğŸ½â€â™‚	disculpa, gesto, hombre haciendo una reverencia, hombre haciendo una reverencia: tono de piel medio, perdÃ³n, reverencia, tono de piel medio
ğŸ™‡ğŸ¾â€â™‚	disculpa, gesto, hombre haciendo una reverencia, hombre haciendo una reverencia: tono de piel oscuro medio, perdÃ³n, reverencia, tono de piel oscuro medio
ğŸ™‡ğŸ¿â€â™‚	disculpa, gesto, hombre haciendo una reverencia, hombre haciendo una reverencia: tono de piel oscuro, perdÃ³n, reverencia, tono de piel oscuro
ğŸ™‡ğŸ»â€â™€	disculpa, gesto, mujer haciendo una reverencia, mujer haciendo una reverencia: tono de piel claro, perdÃ³n, reverencia, tono de piel claro
ğŸ™‡ğŸ¼â€â™€	disculpa, gesto, mujer haciendo una reverencia, mujer haciendo una reverencia: tono de piel claro medio, perdÃ³n, reverencia, tono de piel claro medio
ğŸ™‡ğŸ½â€â™€	disculpa, gesto, mujer haciendo una reverencia, mujer haciendo una reverencia: tono de piel medio, perdÃ³n, reverencia, tono de piel medio
ğŸ™‡ğŸ¾â€â™€	disculpa, gesto, mujer haciendo una reverencia, mujer haciendo una reverencia: tono de piel oscuro medio, perdÃ³n, reverencia, tono de piel oscuro medio
ğŸ™‡ğŸ¿â€â™€	disculpa, gesto, mujer haciendo una reverencia, mujer haciendo una reverencia: tono de piel oscuro, perdÃ³n, reverencia, tono de piel oscuro
ğŸ¤¦	persona con la mano en la frente
ğŸ¤¦ğŸ»	persona con la mano en la frente, persona con la mano en la frente: tono de piel claro, tono de piel claro
ğŸ¤¦ğŸ¼	persona con la mano en la frente, persona con la mano en la frente: tono de piel claro medio, tono de piel claro medio
ğŸ¤¦ğŸ½	persona con la mano en la frente, persona con la mano en la frente: tono de piel medio, tono de piel medio
ğŸ¤¦ğŸ¾	persona con la mano en la frente, persona con la mano en la frente: tono de piel oscuro medio, tono de piel oscuro medio
ğŸ¤¦ğŸ¿	persona con la mano en la frente, persona con la mano en la frente: tono de piel oscuro, tono de piel oscuro
ğŸ¤¦â€â™‚	exasperaciÃ³n, facepalm, hombre, hombre con la mano en la frente, incredulidad
ğŸ¤¦ğŸ»â€â™‚	exasperaciÃ³n, facepalm, hombre, hombre con la mano en la frente, hombre con la mano en la frente: tono de piel claro, incredulidad, tono de piel claro
ğŸ¤¦ğŸ¼â€â™‚	exasperaciÃ³n, facepalm, hombre, hombre con la mano en la frente, hombre con la mano en la frente: tono de piel claro medio, incredulidad, tono de piel claro medio
ğŸ¤¦ğŸ½â€â™‚	exasperaciÃ³n, facepalm, hombre, hombre con la mano en la frente, hombre con la mano en la frente: tono de piel medio, incredulidad, tono de piel medio
ğŸ¤¦ğŸ¾â€â™‚	exasperaciÃ³n, facepalm, hombre, hombre con la mano en la frente, hombre con la mano en la frente: tono de piel oscuro medio, incredulidad, tono de piel oscuro medio
ğŸ¤¦ğŸ¿â€â™‚	exasperaciÃ³n, facepalm, hombre, hombre con la mano en la frente, hombre con la mano en la frente: tono de piel oscuro, incredulidad, tono de piel oscuro
ğŸ¤¦â€â™€	exasperaciÃ³n, facepalm, incredulidad, mujer, mujer con la mano en la frente
ğŸ¤¦ğŸ»â€â™€	exasperaciÃ³n, facepalm, incredulidad, mujer, mujer con la mano en la frente, mujer con la mano en la frente: tono de piel claro, tono de piel claro
ğŸ¤¦ğŸ¼â€â™€	exasperaciÃ³n, facepalm, incredulidad, mujer, mujer con la mano en la frente, mujer con la mano en la frente: tono de piel claro medio, tono de piel claro medio
ğŸ¤¦ğŸ½â€â™€	exasperaciÃ³n, facepalm, incredulidad, mujer, mujer con la mano en la frente, mujer con la mano en la frente: tono de piel medio, tono de piel medio
ğŸ¤¦ğŸ¾â€â™€	exasperaciÃ³n, facepalm, incredulidad, mujer, mujer con la mano en la frente, mujer con la mano en la frente: tono de piel oscuro medio, tono de piel oscuro medio
ğŸ¤¦ğŸ¿â€â™€	exasperaciÃ³n, facepalm, incredulidad, mujer, mujer con la mano en la frente, mujer con la mano en la frente: tono de piel oscuro, tono de piel oscuro
ğŸ¤·	duda, encogerse, hombros, ignorancia, indiferencia
ğŸ¤·ğŸ»	duda, encogerse, hombros, ignorancia, indiferencia, persona encogida de hombros: tono de piel claro, tono de piel claro
ğŸ¤·ğŸ¼	duda, encogerse, hombros, ignorancia, indiferencia, persona encogida de hombros: tono de piel claro medio, tono de piel claro medio
ğŸ¤·ğŸ½	duda, encogerse, hombros, ignorancia, indiferencia, persona encogida de hombros: tono de piel medio, tono de piel medio
ğŸ¤·ğŸ¾	duda, encogerse, hombros, ignorancia, indiferencia, persona encogida de hombros: tono de piel oscuro medio, tono de piel oscuro medio
ğŸ¤·ğŸ¿	duda, encogerse, hombros, ignorancia, indiferencia, persona encogida de hombros: tono de piel oscuro, tono de piel oscuro
ğŸ¤·ğŸ»â€â™‚	duda, encogerse, hombre encogido de hombros, hombre encogido de hombros: tono de piel claro, hombros, indiferencia, tono de piel claro
ğŸ¤·ğŸ¼â€â™‚	duda, encogerse, hombre encogido de hombros, hombre encogido de hombros: tono de piel claro medio, hombros, indiferencia, tono de piel claro medio
ğŸ¤·ğŸ½â€â™‚	duda, encogerse, hombre encogido de hombros, hombre encogido de hombros: tono de piel medio, hombros, indiferencia, tono de piel medio
ğŸ¤·ğŸ¾â€â™‚	duda, encogerse, hombre encogido de hombros, hombre encogido de hombros: tono de piel oscuro medio, hombros, indiferencia, tono de piel oscuro medio
ğŸ¤·ğŸ¿â€â™‚	duda, encogerse, hombre encogido de hombros, hombre encogido de hombros: tono de piel oscuro, hombros, indiferencia, tono de piel oscuro
ğŸ¤·ğŸ»â€â™€	duda, encogerse, hombros, indiferencia, mujer encogida de hombros, mujer encogida de hombros: tono de piel claro, tono de piel claro
ğŸ¤·ğŸ¼â€â™€	duda, encogerse, hombros, indiferencia, mujer encogida de hombros, mujer encogida de hombros: tono de piel claro medio, tono de piel claro medio
ğŸ¤·ğŸ½â€â™€	duda, encogerse, hombros, indiferencia, mujer encogida de hombros, mujer encogida de hombros: tono de piel medio, tono de piel medio
ğŸ¤·ğŸ¾â€â™€	duda, encogerse, hombros, indiferencia, mujer encogida de hombros, mujer encogida de hombros: tono de piel oscuro medio, tono de piel oscuro medio
ğŸ¤·ğŸ¿â€â™€	duda, encogerse, hombros, indiferencia, mujer encogida de hombros, mujer encogida de hombros: tono de piel oscuro, tono de piel oscuro
ğŸ‘¨â€âš•	doctor, enfermero, mÃ©dico, profesional sanitario hombre
ğŸ‘¨ğŸ»â€âš•	doctor, enfermero, mÃ©dico, profesional sanitario hombre, profesional sanitario hombre: tono de piel claro, tono de piel claro
ğŸ‘¨ğŸ¼â€âš•	doctor, enfermero, mÃ©dico, profesional sanitario hombre, profesional sanitario hombre: tono de piel claro medio, tono de piel claro medio
ğŸ‘¨ğŸ½â€âš•	doctor, enfermero, mÃ©dico, profesional sanitario hombre, profesional sanitario hombre: tono de piel medio, tono de piel medio
ğŸ‘¨ğŸ¾â€âš•	doctor, enfermero, mÃ©dico, profesional sanitario hombre, profesional sanitario hombre: tono de piel oscuro medio, tono de piel oscuro medio
ğŸ‘¨ğŸ¿â€âš•	doctor, enfermero, mÃ©dico, profesional sanitario hombre, profesional sanitario hombre: tono de piel oscuro, tono de piel oscuro
ğŸ‘©â€âš•	doctora, enfermera, mÃ©dica, profesional sanitario mujer
ğŸ‘©ğŸ»â€âš•	doctora, enfermera, mÃ©dica, profesional sanitario mujer, profesional sanitario mujer: tono de piel claro, tono de piel claro
ğŸ‘©ğŸ¼â€âš•	doctora, enfermera, mÃ©dica, profesional sanitario mujer, profesional sanitario mujer: tono de piel claro medio, tono de piel claro medio
ğŸ‘©ğŸ½â€âš•	doctora, enfermera, mÃ©dica, profesional sanitario mujer, profesional sanitario mujer: tono de piel medio, tono de piel medio
ğŸ‘©ğŸ¾â€âš•	doctora, enfermera, mÃ©dica, profesional sanitario mujer, profesional sanitario mujer: tono de piel oscuro medio, tono de piel oscuro medio
ğŸ‘©ğŸ¿â€âš•	doctora, enfermera, mÃ©dica, profesional sanitario mujer, profesional sanitario mujer: tono de piel oscuro, tono de piel oscuro
ğŸ‘¨ğŸ»â€ğŸ“	estudiante, estudiante hombre: tono de piel claro, graduado, hombre, licenciado, tono de piel claro, universitario
ğŸ‘¨ğŸ¼â€ğŸ“	estudiante, estudiante hombre: tono de piel claro medio, graduado, hombre, licenciado, tono de piel claro medio, universitario
ğŸ‘¨ğŸ½â€ğŸ“	estudiante, estudiante hombre: tono de piel medio, graduado, hombre, licenciado, tono de piel medio, universitario
ğŸ‘¨ğŸ¾â€ğŸ“	estudiante, estudiante hombre: tono de piel oscuro medio, graduado, hombre, licenciado, tono de piel oscuro medio, universitario
ğŸ‘¨ğŸ¿â€ğŸ“	estudiante, estudiante hombre: tono de piel oscuro, graduado, hombre, licenciado, tono de piel oscuro, universitario
ğŸ‘©ğŸ»â€ğŸ“	estudiante, estudiante mujer: tono de piel claro, graduada, licenciada, mujer, tono de piel claro, universitaria
ğŸ‘©ğŸ¼â€ğŸ“	estudiante, estudiante mujer: tono de piel claro medio, graduada, licenciada, mujer, tono de piel claro medio, universitaria
ğŸ‘©ğŸ½â€ğŸ“	estudiante, estudiante mujer: tono de piel medio, graduada, licenciada, mujer, tono de piel medio, universitaria
ğŸ‘©ğŸ¾â€ğŸ“	estudiante, estudiante mujer: tono de piel oscuro medio, graduada, licenciada, mujer, tono de piel oscuro medio, universitaria
ğŸ‘©ğŸ¿â€ğŸ“	estudiante, estudiante mujer: tono de piel oscuro, graduada, licenciada, mujer, tono de piel oscuro, universitaria
ğŸ‘¨ğŸ»â€ğŸ«	educador, hombre, instructor, maestro, profesor, profesor: tono de piel claro, tono de piel claro
ğŸ‘¨ğŸ¼â€ğŸ«	educador, hombre, instructor, maestro, profesor, profesor: tono de piel claro medio, tono de piel claro medio
ğŸ‘¨ğŸ½â€ğŸ«	educador, hombre, instructor, maestro, profesor, profesor: tono de piel medio, tono de piel medio
ğŸ‘¨ğŸ¾â€ğŸ«	educador, hombre, instructor, maestro, profesor, profesor: tono de piel oscuro medio, tono de piel oscuro medio
ğŸ‘¨ğŸ¿â€ğŸ«	educador, hombre, instructor, maestro, profesor, profesor: tono de piel oscuro, tono de piel oscuro
ğŸ‘©ğŸ»â€ğŸ«	educadora, instructora, maestra, mujer, profesora, profesora: tono de piel claro, tono de piel claro
ğŸ‘©ğŸ¼â€ğŸ«	educadora, instructora, maestra, mujer, profesora, profesora: tono de piel claro medio, tono de piel claro medio
ğŸ‘©ğŸ½â€ğŸ«	educadora, instructora, maestra, mujer, profesora, profesora: tono de piel medio, tono de piel medio
ğŸ‘©ğŸ¾â€ğŸ«	educadora, instructora, maestra, mujer, profesora, profesora: tono de piel oscuro medio, tono de piel oscuro medio
ğŸ‘©ğŸ¿â€ğŸ«	educadora, instructora, maestra, mujer, profesora, profesora: tono de piel oscuro, tono de piel oscuro
ğŸ‘¨ğŸ»â€âš–	balanza, hombre, juez, juez: tono de piel claro, justicia, magistrado, tono de piel claro
ğŸ‘¨ğŸ¼â€âš–	balanza, hombre, juez, juez: tono de piel claro medio, justicia, magistrado, tono de piel claro medio
ğŸ‘¨ğŸ½â€âš–	balanza, hombre, juez, juez: tono de piel medio, justicia, magistrado, tono de piel medio
ğŸ‘¨ğŸ¾â€âš–	balanza, hombre, juez, juez: tono de piel oscuro medio, justicia, magistrado, tono de piel oscuro medio
ğŸ‘¨ğŸ¿â€âš–	balanza, hombre, juez, juez: tono de piel oscuro, justicia, magistrado, tono de piel oscuro
ğŸ‘©ğŸ»â€âš–	balanza, jueza, jueza: tono de piel claro, justicia, magistrada, mujer, tono de piel claro
ğŸ‘©ğŸ¼â€âš–	balanza, jueza, jueza: tono de piel claro medio, justicia, magistrada, mujer, tono de piel claro medio
ğŸ‘©ğŸ½â€âš–	balanza, jueza, jueza: tono de piel medio, justicia, magistrada, mujer, tono de piel medio
ğŸ‘©ğŸ¾â€âš–	balanza, jueza, jueza: tono de piel oscuro medio, justicia, magistrada, mujer, tono de piel oscuro medio
ğŸ‘©ğŸ¿â€âš–	balanza, jueza, jueza: tono de piel oscuro, justicia, magistrada, mujer, tono de piel oscuro
ğŸ‘¨ğŸ»â€ğŸŒ¾	agricultor, agricultor: tono de piel claro, campo, granjero, hombre, labrador, tono de piel claro
ğŸ‘¨ğŸ¼â€ğŸŒ¾	agricultor, agricultor: tono de piel claro medio, campo, granjero, hombre, labrador, tono de piel claro medio
ğŸ‘¨ğŸ½â€ğŸŒ¾	agricultor, agricultor: tono de piel medio, campo, granjero, hombre, labrador, tono de piel medio
ğŸ‘¨ğŸ¾â€ğŸŒ¾	agricultor, agricultor: tono de piel oscuro medio, campo, granjero, hombre, labrador, tono de piel oscuro medio
ğŸ‘¨ğŸ¿â€ğŸŒ¾	agricultor, agricultor: tono de piel oscuro, campo, granjero, hombre, labrador, tono de piel oscuro
ğŸ‘©ğŸ»â€ğŸŒ¾	agricultora, agricultora: tono de piel claro, campo, granjera, labradora, mujer, tono de piel claro
ğŸ‘©ğŸ¼â€ğŸŒ¾	agricultora, agricultora: tono de piel claro medio, campo, granjera, labradora, mujer, tono de piel claro medio
ğŸ‘©ğŸ½â€ğŸŒ¾	agricultora, agricultora: tono de piel medio, campo, granjera, labradora, mujer, tono de piel medio
ğŸ‘©ğŸ¾â€ğŸŒ¾	agricultora, agricultora: tono de piel oscuro medio, campo, granjera, labradora, mujer, tono de piel oscuro medio
ğŸ‘©ğŸ¿â€ğŸŒ¾	agricultora, agricultora: tono de piel oscuro, campo, granjera, labradora, mujer, tono de piel oscuro
ğŸ‘¨ğŸ»â€ğŸ³	chef, cocinero, cocinero: tono de piel claro, hombre, pinche, tono de piel claro
ğŸ‘¨ğŸ¼â€ğŸ³	chef, cocinero, cocinero: tono de piel claro medio, hombre, pinche, tono de piel claro medio
ğŸ‘¨ğŸ½â€ğŸ³	chef, cocinero, cocinero: tono de piel medio, hombre, pinche, tono de piel medio
ğŸ‘¨ğŸ¾â€ğŸ³	chef, cocinero, cocinero: tono de piel oscuro medio, hombre, pinche, tono de piel oscuro medio
ğŸ‘¨ğŸ¿â€ğŸ³	chef, cocinero, cocinero: tono de piel oscuro, hombre, pinche, tono de piel oscuro
ğŸ‘©ğŸ»â€ğŸ³	chef, cocinera, cocinera: tono de piel claro, mujer, pinche, tono de piel claro
ğŸ‘©ğŸ¼â€ğŸ³	chef, cocinera, cocinera: tono de piel claro medio, mujer, pinche, tono de piel claro medio
ğŸ‘©ğŸ½â€ğŸ³	chef, cocinera, cocinera: tono de piel medio, mujer, pinche, tono de piel medio
ğŸ‘©ğŸ¾â€ğŸ³	chef, cocinera, cocinera: tono de piel oscuro medio, mujer, pinche, tono de piel oscuro medio
ğŸ‘©ğŸ¿â€ğŸ³	chef, cocinera, cocinera: tono de piel oscuro, mujer, pinche, tono de piel oscuro
ğŸ‘¨ğŸ»â€ğŸ”§	electricista, fontanero, hombre, mecÃ¡nico, mecÃ¡nico: tono de piel claro, operario, tono de piel claro
ğŸ‘¨ğŸ¼â€ğŸ”§	electricista, fontanero, hombre, mecÃ¡nico, mecÃ¡nico: tono de piel claro medio, operario, tono de piel claro medio
ğŸ‘¨ğŸ½â€ğŸ”§	electricista, fontanero, hombre, mecÃ¡nico, mecÃ¡nico: tono de piel medio, operario, tono de piel medio
ğŸ‘¨ğŸ¾â€ğŸ”§	electricista, fontanero, hombre, mecÃ¡nico, mecÃ¡nico: tono de piel oscuro medio, operario, tono de piel oscuro medio
ğŸ‘¨ğŸ¿â€ğŸ”§	electricista, fontanero, hombre, mecÃ¡nico, mecÃ¡nico: tono de piel oscuro, operario, tono de piel oscuro
ğŸ‘©ğŸ»â€ğŸ”§	electricista, fontanera, mecÃ¡nica, mecÃ¡nica: tono de piel claro, mujer, operaria, tono de piel claro
ğŸ‘©ğŸ¼â€ğŸ”§	electricista, fontanera, mecÃ¡nica, mecÃ¡nica: tono de piel claro medio, mujer, operaria, tono de piel claro medio
ğŸ‘©ğŸ½â€ğŸ”§	electricista, fontanera, mecÃ¡nica, mecÃ¡nica: tono de piel medio, mujer, operaria, tono de piel medio
ğŸ‘©ğŸ¾â€ğŸ”§	electricista, fontanera, mecÃ¡nica, mecÃ¡nica: tono de piel oscuro medio, mujer, operaria, tono de piel oscuro medio
ğŸ‘©ğŸ¿â€ğŸ”§	electricista, fontanera, mecÃ¡nica, mecÃ¡nica: tono de piel oscuro, mujer, operaria, tono de piel oscuro
ğŸ‘¨ğŸ»â€ğŸ­	fÃ¡brica, montaje, obrero, operario, operario: tono de piel claro, tono de piel claro, trabajador
ğŸ‘¨ğŸ¼â€ğŸ­	fÃ¡brica, montaje, obrero, operario, operario: tono de piel claro medio, tono de piel claro medio, trabajador
ğŸ‘¨ğŸ½â€ğŸ­	fÃ¡brica, montaje, obrero, operario, operario: tono de piel medio, tono de piel medio, trabajador
ğŸ‘¨ğŸ¾â€ğŸ­	fÃ¡brica, montaje, obrero, operario, operario: tono de piel oscuro medio, tono de piel oscuro medio, trabajador
ğŸ‘¨ğŸ¿â€ğŸ­	fÃ¡brica, montaje, obrero, operario, operario: tono de piel oscuro, tono de piel oscuro, trabajador
ğŸ‘©ğŸ»â€ğŸ­	fÃ¡brica, montaje, obrera, operaria, operaria: tono de piel claro, tono de piel claro, trabajadora
ğŸ‘©ğŸ¼â€ğŸ­	fÃ¡brica, montaje, obrera, operaria, operaria: tono de piel claro medio, tono de piel claro medio, trabajadora
ğŸ‘©ğŸ½â€ğŸ­	fÃ¡brica, montaje, obrera, operaria, operaria: tono de piel medio, tono de piel medio, trabajadora
ğŸ‘©ğŸ¾â€ğŸ­	fÃ¡brica, montaje, obrera, operaria, operaria: tono de piel oscuro medio, tono de piel oscuro medio, trabajadora
ğŸ‘©ğŸ¿â€ğŸ­	fÃ¡brica, montaje, obrera, operaria, operaria: tono de piel oscuro, tono de piel oscuro, trabajadora
ğŸ‘¨ğŸ»â€ğŸ’¼	director, empresa, hombre, oficina, oficinista, oficinista hombre: tono de piel claro, tono de piel claro
ğŸ‘¨ğŸ¼â€ğŸ’¼	director, empresa, hombre, oficina, oficinista, oficinista hombre: tono de piel claro medio, tono de piel claro medio
ğŸ‘¨ğŸ½â€ğŸ’¼	director, empresa, hombre, oficina, oficinista, oficinista hombre: tono de piel medio, tono de piel medio
ğŸ‘¨ğŸ¾â€ğŸ’¼	director, empresa, hombre, oficina, oficinista, oficinista hombre: tono de piel oscuro medio, tono de piel oscuro medio
ğŸ‘¨ğŸ¿â€ğŸ’¼	director, empresa, hombre, oficina, oficinista, oficinista hombre: tono de piel oscuro, tono de piel oscuro
ğŸ‘©ğŸ»â€ğŸ’¼	directora, empresa, mujer, oficina, oficinista, oficinista mujer: tono de piel claro, tono de piel claro
ğŸ‘©ğŸ¼â€ğŸ’¼	directora, empresa, mujer, oficina, oficinista, oficinista mujer: tono de piel claro medio, tono de piel claro medio
ğŸ‘©ğŸ½â€ğŸ’¼	directora, empresa, mujer, oficina, oficinista, oficinista mujer: tono de piel medio, tono de piel medio
ğŸ‘©ğŸ¾â€ğŸ’¼	directora, empresa, mujer, oficina, oficinista, oficinista mujer: tono de piel oscuro medio, tono de piel oscuro medio
ğŸ‘©ğŸ¿â€ğŸ’¼	directora, empresa, mujer, oficina, oficinista, oficinista mujer: tono de piel oscuro, tono de piel oscuro
ğŸ‘¨ğŸ»â€ğŸ”¬	biÃ³logo, cientÃ­fico, cientÃ­fico: tono de piel claro, fÃ­sico, hombre, quÃ­mico, tono de piel claro
ğŸ‘¨ğŸ¼â€ğŸ”¬	biÃ³logo, cientÃ­fico, cientÃ­fico: tono de piel claro medio, fÃ­sico, hombre, quÃ­mico, tono de piel claro medio
ğŸ‘¨ğŸ½â€ğŸ”¬	biÃ³logo, cientÃ­fico, cientÃ­fico: tono de piel medio, fÃ­sico, hombre, quÃ­mico, tono de piel medio
ğŸ‘¨ğŸ¾â€ğŸ”¬	biÃ³logo, cientÃ­fico, cientÃ­fico: tono de piel oscuro medio, fÃ­sico, hombre, quÃ­mico, tono de piel oscuro medio
ğŸ‘¨ğŸ¿â€ğŸ”¬	biÃ³logo, cientÃ­fico, cientÃ­fico: tono de piel oscuro, fÃ­sico, hombre, quÃ­mico, tono de piel oscuro
ğŸ‘©ğŸ»â€ğŸ”¬	biÃ³loga, cientÃ­fica, cientÃ­fica: tono de piel claro, fÃ­sica, mujer, quÃ­mica, tono de piel claro
ğŸ‘©ğŸ¼â€ğŸ”¬	biÃ³loga, cientÃ­fica, cientÃ­fica: tono de piel claro medio, fÃ­sica, mujer, quÃ­mica, tono de piel claro medio
ğŸ‘©ğŸ½â€ğŸ”¬	biÃ³loga, cientÃ­fica, cientÃ­fica: tono de piel medio, fÃ­sica, mujer, quÃ­mica, tono de piel medio
ğŸ‘©ğŸ¾â€ğŸ”¬	biÃ³loga, cientÃ­fica, cientÃ­fica: tono de piel oscuro medio, fÃ­sica, mujer, quÃ­mica, tono de piel oscuro medio
ğŸ‘©ğŸ¿â€ğŸ”¬	biÃ³loga, cientÃ­fica, cientÃ­fica: tono de piel oscuro, fÃ­sica, mujer, quÃ­mica, tono de piel oscuro
ğŸ‘¨ğŸ»â€ğŸ’»	desarrollador, hombre, informÃ¡tico, programador, tecnÃ³logo, tecnÃ³logo: tono de piel claro, tono de piel claro
ğŸ‘¨ğŸ¼â€ğŸ’»	desarrollador, hombre, informÃ¡tico, programador, tecnÃ³logo, tecnÃ³logo: tono de piel claro medio, tono de piel claro medio
ğŸ‘¨ğŸ½â€ğŸ’»	desarrollador, hombre, informÃ¡tico, programador, tecnÃ³logo, tecnÃ³logo: tono de piel medio, tono de piel medio
ğŸ‘¨ğŸ¾â€ğŸ’»	desarrollador, hombre, informÃ¡tico, programador, tecnÃ³logo, tecnÃ³logo: tono de piel oscuro medio, tono de piel oscuro medio
ğŸ‘¨ğŸ¿â€ğŸ’»	desarrollador, hombre, informÃ¡tico, programador, tecnÃ³logo, tecnÃ³logo: tono de piel oscuro, tono de piel oscuro
ğŸ‘©ğŸ»â€ğŸ’»	desarrolladora, informÃ¡tica, mujer, programadora, tecnÃ³loga, tecnÃ³loga: tono de piel claro, tono de piel claro
ğŸ‘©ğŸ¼â€ğŸ’»	desarrolladora, informÃ¡tica, mujer, programadora, tecnÃ³loga, tecnÃ³loga: tono de piel claro medio, tono de piel claro medio
ğŸ‘©ğŸ½â€ğŸ’»	desarrolladora, informÃ¡tica, mujer, programadora, tecnÃ³loga, tecnÃ³loga: tono de piel medio, tono de piel medio
ğŸ‘©ğŸ¾â€ğŸ’»	desarrolladora, informÃ¡tica, mujer, programadora, tecnÃ³loga, tecnÃ³loga: tono de piel oscuro medio, tono de piel oscuro medio
ğŸ‘©ğŸ¿â€ğŸ’»	desarrolladora, informÃ¡tica, mujer, programadora, tecnÃ³loga, tecnÃ³loga: tono de piel oscuro, tono de piel oscuro
ğŸ‘¨ğŸ»â€ğŸ¤	artista, cantante hombre, cantante hombre: tono de piel claro, estrella, hombre, rock, tono de piel claro
ğŸ‘¨ğŸ¼â€ğŸ¤	artista, cantante hombre, cantante hombre: tono de piel claro medio, estrella, hombre, rock, tono de piel claro medio
ğŸ‘¨ğŸ½â€ğŸ¤	artista, cantante hombre, cantante hombre: tono de piel medio, estrella, hombre, rock, tono de piel medio
ğŸ‘¨ğŸ¾â€ğŸ¤	artista, cantante hombre, cantante hombre: tono de piel oscuro medio, estrella, hombre, rock, tono de piel oscuro medio
ğŸ‘¨ğŸ¿â€ğŸ¤	artista, cantante hombre, cantante hombre: tono de piel oscuro, estrella, hombre, rock, tono de piel oscuro
ğŸ‘©ğŸ»â€ğŸ¤	artista, cantante mujer, cantante mujer: tono de piel claro, estrella, mujer, rock, tono de piel claro
ğŸ‘©ğŸ¼â€ğŸ¤	artista, cantante mujer, cantante mujer: tono de piel claro medio, estrella, mujer, rock, tono de piel claro medio
ğŸ‘©ğŸ½â€ğŸ¤	artista, cantante mujer, cantante mujer: tono de piel medio, estrella, mujer, rock, tono de piel medio
ğŸ‘©ğŸ¾â€ğŸ¤	artista, cantante mujer, cantante mujer: tono de piel oscuro medio, estrella, mujer, rock, tono de piel oscuro medio
ğŸ‘©ğŸ¿â€ğŸ¤	artista, cantante mujer, cantante mujer: tono de piel oscuro, estrella, mujer, rock, tono de piel oscuro
ğŸ‘¨ğŸ»â€ğŸ¨	artista hombre, artista hombre: tono de piel claro, hombre, paleta, pintor, pinturas, tono de piel claro
ğŸ‘¨ğŸ¼â€ğŸ¨	artista hombre, artista hombre: tono de piel claro medio, hombre, paleta, pintor, pinturas, tono de piel claro medio
ğŸ‘¨ğŸ½â€ğŸ¨	artista hombre, artista hombre: tono de piel medio, hombre, paleta, pintor, pinturas, tono de piel medio
ğŸ‘¨ğŸ¾â€ğŸ¨	artista hombre, artista hombre: tono de piel oscuro medio, hombre, paleta, pintor, pinturas, tono de piel oscuro medio
ğŸ‘¨ğŸ¿â€ğŸ¨	artista hombre, artista hombre: tono de piel oscuro, hombre, paleta, pintor, pinturas, tono de piel oscuro
ğŸ‘©ğŸ»â€ğŸ¨	artista mujer, artista mujer: tono de piel claro, mujer, paleta, pintora, pinturas, tono de piel claro
ğŸ‘©ğŸ¼â€ğŸ¨	artista mujer, artista mujer: tono de piel claro medio, mujer, paleta, pintora, pinturas, tono de piel claro medio
ğŸ‘©ğŸ½â€ğŸ¨	artista mujer, artista mujer: tono de piel medio, mujer, paleta, pintora, pinturas, tono de piel medio
ğŸ‘©ğŸ¾â€ğŸ¨	artista mujer, artista mujer: tono de piel oscuro medio, mujer, paleta, pintora, pinturas, tono de piel oscuro medio
ğŸ‘©ğŸ¿â€ğŸ¨	artista mujer, artista mujer: tono de piel oscuro, mujer, paleta, pintora, pinturas, tono de piel oscuro
ğŸ‘¨ğŸ»â€âœˆ	aviÃ³n, hombre, piloto, piloto hombre: tono de piel claro, tono de piel claro, vuelo
ğŸ‘¨ğŸ¼â€âœˆ	aviÃ³n, hombre, piloto, piloto hombre: tono de piel claro medio, tono de piel claro medio, vuelo
ğŸ‘¨ğŸ½â€âœˆ	aviÃ³n, hombre, piloto, piloto hombre: tono de piel medio, tono de piel medio, vuelo
ğŸ‘¨ğŸ¾â€âœˆ	aviÃ³n, hombre, piloto, piloto hombre: tono de piel oscuro medio, tono de piel oscuro medio, vuelo
ğŸ‘¨ğŸ¿â€âœˆ	aviÃ³n, hombre, piloto, piloto hombre: tono de piel oscuro, tono de piel oscuro, vuelo
ğŸ‘©ğŸ»â€âœˆ	aviÃ³n, mujer, piloto, piloto mujer: tono de piel claro, tono de piel claro, vuelo
ğŸ‘©ğŸ¼â€âœˆ	aviÃ³n, mujer, piloto, piloto mujer: tono de piel claro medio, tono de piel claro medio, vuelo
ğŸ‘©ğŸ½â€âœˆ	aviÃ³n, mujer, piloto, piloto mujer: tono de piel medio, tono de piel medio, vuelo
ğŸ‘©ğŸ¾â€âœˆ	aviÃ³n, mujer, piloto, piloto mujer: tono de piel oscuro medio, tono de piel oscuro medio, vuelo
ğŸ‘©ğŸ¿â€âœˆ	aviÃ³n, mujer, piloto, piloto mujer: tono de piel oscuro, tono de piel oscuro, vuelo
ğŸ‘¨ğŸ»â€ğŸš€	astronauta, astronauta hombre: tono de piel claro, cohete, espacio, hombre, tono de piel claro
ğŸ‘¨ğŸ¼â€ğŸš€	astronauta, astronauta hombre: tono de piel claro medio, cohete, espacio, hombre, tono de piel claro medio
ğŸ‘¨ğŸ½â€ğŸš€	astronauta, astronauta hombre: tono de piel medio, cohete, espacio, hombre, tono de piel medio
ğŸ‘¨ğŸ¾â€ğŸš€	astronauta, astronauta hombre: tono de piel oscuro medio, cohete, espacio, hombre, tono de piel oscuro medio
ğŸ‘¨ğŸ¿â€ğŸš€	astronauta, astronauta hombre: tono de piel oscuro, cohete, espacio, hombre, tono de piel oscuro
ğŸ‘©ğŸ»â€ğŸš€	astronauta, astronauta mujer: tono de piel claro, cohete, espacio, mujer, tono de piel claro
ğŸ‘©ğŸ¼â€ğŸš€	astronauta, astronauta mujer: tono de piel claro medio, cohete, espacio, mujer, tono de piel claro medio
ğŸ‘©ğŸ½â€ğŸš€	astronauta, astronauta mujer: tono de piel medio, cohete, espacio, mujer, tono de piel medio
ğŸ‘©ğŸ¾â€ğŸš€	astronauta, astronauta mujer: tono de piel oscuro medio, cohete, espacio, mujer, tono de piel oscuro medio
ğŸ‘©ğŸ¿â€ğŸš€	astronauta, astronauta mujer: tono de piel oscuro, cohete, espacio, mujer, tono de piel oscuro
ğŸ‘¨â€ğŸš’	bombero
ğŸ‘¨ğŸ»â€ğŸš’	bombero, bombero: tono de piel claro, tono de piel claro
ğŸ‘¨ğŸ¼â€ğŸš’	bombero, bombero: tono de piel claro medio, tono de piel claro medio
ğŸ‘¨ğŸ½â€ğŸš’	bombero, bombero: tono de piel medio, tono de piel medio
ğŸ‘¨ğŸ¾â€ğŸš’	bombero, bombero: tono de piel oscuro medio, tono de piel oscuro medio
ğŸ‘¨ğŸ¿â€ğŸš’	bombero, bombero: tono de piel oscuro, tono de piel oscuro
ğŸ‘©â€ğŸš’	bombera
ğŸ‘©ğŸ»â€ğŸš’	bombera, bombera: tono de piel claro, tono de piel claro
ğŸ‘©ğŸ¼â€ğŸš’	bombera, bombera: tono de piel claro medio, tono de piel claro medio
ğŸ‘©ğŸ½â€ğŸš’	bombera, bombera: tono de piel medio, tono de piel medio
ğŸ‘©ğŸ¾â€ğŸš’	bombera, bombera: tono de piel oscuro medio, tono de piel oscuro medio
ğŸ‘©ğŸ¿â€ğŸš’	bombera, bombera: tono de piel oscuro, tono de piel oscuro
ğŸ‘®	agente, oficial, policÃ­a
ğŸ‘®ğŸ»	agente, agente de policÃ­a: tono de piel claro, oficial, policÃ­a, tono de piel claro
ğŸ‘®ğŸ¼	agente, agente de policÃ­a: tono de piel claro medio, oficial, policÃ­a, tono de piel claro medio
ğŸ‘®ğŸ½	agente, agente de policÃ­a: tono de piel medio, oficial, policÃ­a, tono de piel medio
ğŸ‘®ğŸ¾	agente, agente de policÃ­a: tono de piel oscuro medio, oficial, policÃ­a, tono de piel oscuro medio
ğŸ‘®ğŸ¿	agente, agente de policÃ­a: tono de piel oscuro, oficial, policÃ­a, tono de piel oscuro
ğŸ‘®â€â™‚	agente, agente de policÃ­a hombre, oficial hombre, policÃ­a
ğŸ‘®ğŸ»â€â™‚	agente, agente de policÃ­a hombre, agente de policÃ­a hombre: tono de piel claro, oficial hombre, policÃ­a, tono de piel claro
ğŸ‘®ğŸ¼â€â™‚	agente, agente de policÃ­a hombre, agente de policÃ­a hombre: tono de piel claro medio, oficial hombre, policÃ­a, tono de piel claro medio
ğŸ‘®ğŸ½â€â™‚	agente, agente de policÃ­a hombre, agente de policÃ­a hombre: tono de piel medio, oficial hombre, policÃ­a, tono de piel medio
ğŸ‘®ğŸ¾â€â™‚	agente, agente de policÃ­a hombre, agente de policÃ­a hombre: tono de piel oscuro medio, oficial hombre, policÃ­a, tono de piel oscuro medio
ğŸ‘®ğŸ¿â€â™‚	agente, agente de policÃ­a hombre, agente de policÃ­a hombre: tono de piel oscuro, oficial hombre, policÃ­a, tono de piel oscuro
ğŸ‘®â€â™€	agente, agente de policÃ­a mujer, oficial mujer, policÃ­a
ğŸ‘®ğŸ»â€â™€	agente, agente de policÃ­a mujer, agente de policÃ­a mujer: tono de piel claro, oficial mujer, policÃ­a, tono de piel claro
ğŸ‘®ğŸ¼â€â™€	agente, agente de policÃ­a mujer, agente de policÃ­a mujer: tono de piel claro medio, oficial mujer, policÃ­a, tono de piel claro medio
ğŸ‘®ğŸ½â€â™€	agente, agente de policÃ­a mujer, agente de policÃ­a mujer: tono de piel medio, oficial mujer, policÃ­a, tono de piel medio
ğŸ‘®ğŸ¾â€â™€	agente, agente de policÃ­a mujer, agente de policÃ­a mujer: tono de piel oscuro medio, oficial mujer, policÃ­a, tono de piel oscuro medio
ğŸ‘®ğŸ¿â€â™€	agente, agente de policÃ­a mujer, agente de policÃ­a mujer: tono de piel oscuro, oficial mujer, policÃ­a, tono de piel oscuro
ğŸ•µï¸	detective, espÃ­a, investigador, investigar, lupa
ğŸ•µğŸ»	detective, detective: tono de piel claro, espÃ­a, investigador, investigar, lupa, tono de piel claro
ğŸ•µğŸ¼	detective, detective: tono de piel claro medio, espÃ­a, investigador, investigar, lupa, tono de piel claro medio
ğŸ•µğŸ½	detective, detective: tono de piel medio, espÃ­a, investigador, investigar, lupa, tono de piel medio
ğŸ•µğŸ¾	detective, detective: tono de piel oscuro medio, espÃ­a, investigador, investigar, lupa, tono de piel oscuro medio
ğŸ•µğŸ¿	detective, detective: tono de piel oscuro, espÃ­a, investigador, investigar, lupa, tono de piel oscuro
ğŸ•µğŸ»â€â™‚	agente, detective, detective hombre: tono de piel claro, espÃ­a, hombre, investigador, tono de piel claro
ğŸ•µğŸ¼â€â™‚	agente, detective, detective hombre: tono de piel claro medio, espÃ­a, hombre, investigador, tono de piel claro medio
ğŸ•µğŸ½â€â™‚	agente, detective, detective hombre: tono de piel medio, espÃ­a, hombre, investigador, tono de piel medio
ğŸ•µğŸ¾â€â™‚	agente, detective, detective hombre: tono de piel oscuro medio, espÃ­a, hombre, investigador, tono de piel oscuro medio
ğŸ•µğŸ¿â€â™‚	agente, detective, detective hombre: tono de piel oscuro, espÃ­a, hombre, investigador, tono de piel oscuro
ğŸ•µğŸ»â€â™€	agente, detective, detective mujer: tono de piel claro, espÃ­a, investigadora, mujer, tono de piel claro
ğŸ•µğŸ¼â€â™€	agente, detective, detective mujer: tono de piel claro medio, espÃ­a, investigadora, mujer, tono de piel claro medio
ğŸ•µğŸ½â€â™€	agente, detective, detective mujer: tono de piel medio, espÃ­a, investigadora, mujer, tono de piel medio
ğŸ•µğŸ¾â€â™€	agente, detective, detective mujer: tono de piel oscuro medio, espÃ­a, investigadora, mujer, tono de piel oscuro medio
ğŸ•µğŸ¿â€â™€	agente, detective, detective mujer: tono de piel oscuro, espÃ­a, investigadora, mujer, tono de piel oscuro
ğŸ’‚	guardia real, guardia real britÃ¡nica, guardia real con sombrero, guardia real inglesa
ğŸ’‚ğŸ»	guardia real, guardia real britÃ¡nica, guardia real con sombrero, guardia real inglesa, guardia: tono de piel claro, tono de piel claro
ğŸ’‚ğŸ¼	guardia real, guardia real britÃ¡nica, guardia real con sombrero, guardia real inglesa, guardia: tono de piel claro medio, tono de piel claro medio
ğŸ’‚ğŸ½	guardia real, guardia real britÃ¡nica, guardia real con sombrero, guardia real inglesa, guardia: tono de piel medio, tono de piel medio
ğŸ’‚ğŸ¾	guardia real, guardia real britÃ¡nica, guardia real con sombrero, guardia real inglesa, guardia: tono de piel oscuro medio, tono de piel oscuro medio
ğŸ’‚ğŸ¿	guardia real, guardia real britÃ¡nica, guardia real con sombrero, guardia real inglesa, guardia: tono de piel oscuro, tono de piel oscuro
ğŸ’‚â€â™‚	hombre de guardia real, hombre de guardia real britÃ¡nica, hombre de la guardia real con sombrero, hombre vigilante
ğŸ’‚ğŸ»â€â™‚	guardia hombre: tono de piel claro, hombre de guardia real, hombre de guardia real britÃ¡nica, hombre de la guardia real con sombrero, hombre vigilante, tono de piel claro
ğŸ’‚ğŸ¼â€â™‚	guardia hombre: tono de piel claro medio, hombre de guardia real, hombre de guardia real britÃ¡nica, hombre de la guardia real con sombrero, hombre vigilante, tono de piel claro medio
ğŸ’‚ğŸ½â€â™‚	guardia hombre: tono de piel medio, hombre de guardia real, hombre de guardia real britÃ¡nica, hombre de la guardia real con sombrero, hombre vigilante, tono de piel medio
ğŸ’‚ğŸ¾â€â™‚	guardia hombre: tono de piel oscuro medio, hombre de guardia real, hombre de guardia real britÃ¡nica, hombre de la guardia real con sombrero, hombre vigilante, tono de piel oscuro medio
ğŸ’‚ğŸ¿â€â™‚	guardia hombre: tono de piel oscuro, hombre de guardia real, hombre de guardia real britÃ¡nica, hombre de la guardia real con sombrero, hombre vigilante, tono de piel oscuro
ğŸ’‚â€â™€	mujer de guardia real, mujer de la guardia real britÃ¡nica, mujer guardia real con sombrero, mujer vigilante
ğŸ’‚ğŸ»â€â™€	guardia mujer: tono de piel claro, mujer de guardia real, mujer de la guardia real britÃ¡nica, mujer guardia real con sombrero, mujer vigilante, tono de piel claro
ğŸ’‚ğŸ¼â€â™€	guardia mujer: tono de piel claro medio, mujer de guardia real, mujer de la guardia real britÃ¡nica, mujer guardia real con sombrero, mujer vigilante, tono de piel claro medio
ğŸ’‚ğŸ½â€â™€	guardia mujer: tono de piel medio, mujer de guardia real, mujer de la guardia real britÃ¡nica, mujer guardia real con sombrero, mujer vigilante, tono de piel medio
ğŸ’‚ğŸ¾â€â™€	guardia mujer: tono de piel oscuro medio, mujer de guardia real, mujer de la guardia real britÃ¡nica, mujer guardia real con sombrero, mujer vigilante, tono de piel oscuro medio
ğŸ’‚ğŸ¿â€â™€	guardia mujer: tono de piel oscuro, mujer de guardia real, mujer de la guardia real britÃ¡nica, mujer guardia real con sombrero, mujer vigilante, tono de piel oscuro
ğŸ‘·	persona obrera de construcciÃ³n
ğŸ‘·ğŸ»	persona obrera de construcciÃ³n, persona obrera de construcciÃ³n: tono de piel claro, tono de piel claro
ğŸ‘·ğŸ¼	persona obrera de construcciÃ³n, persona obrera de construcciÃ³n: tono de piel claro medio, tono de piel claro medio
ğŸ‘·ğŸ½	persona obrera de construcciÃ³n, persona obrera de construcciÃ³n: tono de piel medio, tono de piel medio
ğŸ‘·ğŸ¾	persona obrera de construcciÃ³n, persona obrera de construcciÃ³n: tono de piel oscuro medio, tono de piel oscuro medio
ğŸ‘·ğŸ¿	persona obrera de construcciÃ³n, persona obrera de construcciÃ³n: tono de piel oscuro, tono de piel oscuro
ğŸ‘·â€â™‚	obrero de construcciÃ³n
ğŸ‘·ğŸ»â€â™‚	obrero de construcciÃ³n, obrero de construcciÃ³n: tono de piel claro, tono de piel claro
ğŸ‘·ğŸ¼â€â™‚	obrero de construcciÃ³n, obrero de construcciÃ³n: tono de piel claro medio, tono de piel claro medio
ğŸ‘·ğŸ½â€â™‚	obrero de construcciÃ³n, obrero de construcciÃ³n: tono de piel medio, tono de piel medio
ğŸ‘·ğŸ¾â€â™‚	obrero de construcciÃ³n, obrero de construcciÃ³n: tono de piel oscuro medio, tono de piel oscuro medio
ğŸ‘·ğŸ¿â€â™‚	obrero de construcciÃ³n, obrero de construcciÃ³n: tono de piel oscuro, tono de piel oscuro
ğŸ‘·â€â™€	obrera de construcciÃ³n
ğŸ‘·ğŸ»â€â™€	obrera de construcciÃ³n, obrera de construcciÃ³n: tono de piel claro, tono de piel claro
ğŸ‘·ğŸ¼â€â™€	obrera de construcciÃ³n, obrera de construcciÃ³n: tono de piel claro medio, tono de piel claro medio
ğŸ‘·ğŸ½â€â™€	obrera de construcciÃ³n, obrera de construcciÃ³n: tono de piel medio, tono de piel medio
ğŸ‘·ğŸ¾â€â™€	obrera de construcciÃ³n, obrera de construcciÃ³n: tono de piel oscuro medio, tono de piel oscuro medio
ğŸ‘·ğŸ¿â€â™€	obrera de construcciÃ³n, obrera de construcciÃ³n: tono de piel oscuro, tono de piel oscuro
ğŸ¤´	cara, cuento, fantasÃ­a, persona, realeza
ğŸ¤´ğŸ»	cara, cuento, fantasÃ­a, persona, prÃ­ncipe: tono de piel claro, realeza, tono de piel claro
ğŸ¤´ğŸ¼	cara, cuento, fantasÃ­a, persona, prÃ­ncipe: tono de piel claro medio, realeza, tono de piel claro medio
ğŸ¤´ğŸ½	cara, cuento, fantasÃ­a, persona, prÃ­ncipe: tono de piel medio, realeza, tono de piel medio
ğŸ¤´ğŸ¾	cara, cuento, fantasÃ­a, persona, prÃ­ncipe: tono de piel oscuro medio, realeza, tono de piel oscuro medio
ğŸ¤´ğŸ¿	cara, cuento, fantasÃ­a, persona, prÃ­ncipe: tono de piel oscuro, realeza, tono de piel oscuro
ğŸ‘¸	cara, cuento, fantasÃ­a, persona, realeza
ğŸ‘¸ğŸ»	cara, cuento, fantasÃ­a, persona, princesa: tono de piel claro, realeza, tono de piel claro
ğŸ‘¸ğŸ¼	cara, cuento, fantasÃ­a, persona, princesa: tono de piel claro medio, realeza, tono de piel claro medio
ğŸ‘¸ğŸ½	cara, cuento, fantasÃ­a, persona, princesa: tono de piel medio, realeza, tono de piel medio
ğŸ‘¸ğŸ¾	cara, cuento, fantasÃ­a, persona, princesa: tono de piel oscuro medio, realeza, tono de piel oscuro medio
ğŸ‘¸ğŸ¿	cara, cuento, fantasÃ­a, persona, princesa: tono de piel oscuro, realeza, tono de piel oscuro
ğŸ‘³	cara, persona, turbante
ğŸ‘³ğŸ»	cara, persona, persona con turbante: tono de piel claro, tono de piel claro, turbante
ğŸ‘³ğŸ¼	cara, persona, persona con turbante: tono de piel claro medio, tono de piel claro medio, turbante
ğŸ‘³ğŸ½	cara, persona, persona con turbante: tono de piel medio, tono de piel medio, turbante
ğŸ‘³ğŸ¾	cara, persona, persona con turbante: tono de piel oscuro medio, tono de piel oscuro medio, turbante
ğŸ‘³ğŸ¿	cara, persona, persona con turbante: tono de piel oscuro, tono de piel oscuro, turbante
ğŸ‘³ğŸ»â€â™‚	hombre, hombre con turbante, hombre con turbante: tono de piel claro, tono de piel claro, turbante
ğŸ‘³ğŸ¼â€â™‚	hombre, hombre con turbante, hombre con turbante: tono de piel claro medio, tono de piel claro medio, turbante
ğŸ‘³ğŸ½â€â™‚	hombre, hombre con turbante, hombre con turbante: tono de piel medio, tono de piel medio, turbante
ğŸ‘³ğŸ¾â€â™‚	hombre, hombre con turbante, hombre con turbante: tono de piel oscuro medio, tono de piel oscuro medio, turbante
ğŸ‘³ğŸ¿â€â™‚	hombre, hombre con turbante, hombre con turbante: tono de piel oscuro, tono de piel oscuro, turbante
ğŸ‘³ğŸ»â€â™€	mujer, mujer con turbante, mujer con turbante: tono de piel claro, tono de piel claro, turbante
ğŸ‘³ğŸ¼â€â™€	mujer, mujer con turbante, mujer con turbante: tono de piel claro medio, tono de piel claro medio, turbante
ğŸ‘³ğŸ½â€â™€	mujer, mujer con turbante, mujer con turbante: tono de piel medio, tono de piel medio, turbante
ğŸ‘³ğŸ¾â€â™€	mujer, mujer con turbante, mujer con turbante: tono de piel oscuro medio, tono de piel oscuro medio, turbante
ğŸ‘³ğŸ¿â€â™€	mujer, mujer con turbante, mujer con turbante: tono de piel oscuro, tono de piel oscuro, turbante
ğŸ‘²ğŸ»	gorro, gua, hombre, hombre con gorro chino, hombre con gorro chino: tono de piel claro, mao, tono de piel claro
ğŸ‘²ğŸ¼	gorro, gua, hombre, hombre con gorro chino, hombre con gorro chino: tono de piel claro medio, mao, tono de piel claro medio
ğŸ‘²ğŸ½	gorro, gua, hombre, hombre con gorro chino, hombre con gorro chino: tono de piel medio, mao, tono de piel medio
ğŸ‘²ğŸ¾	gorro, gua, hombre, hombre con gorro chino, hombre con gorro chino: tono de piel oscuro medio, mao, tono de piel oscuro medio
ğŸ‘²ğŸ¿	gorro, gua, hombre, hombre con gorro chino, hombre con gorro chino: tono de piel oscuro, mao, tono de piel oscuro
ğŸ§•ğŸ»	hiyab, mujer con hiyab, mujer con hiyab: tono de piel claro, paÃ±uelo, tono de piel claro
ğŸ§•ğŸ¼	hiyab, mujer con hiyab, mujer con hiyab: tono de piel claro medio, paÃ±uelo, tono de piel claro medio
ğŸ§•ğŸ½	hiyab, mujer con hiyab, mujer con hiyab: tono de piel medio, paÃ±uelo, tono de piel medio
ğŸ§•ğŸ¾	hiyab, mujer con hiyab, mujer con hiyab: tono de piel oscuro medio, paÃ±uelo, tono de piel oscuro medio
ğŸ§•ğŸ¿	hiyab, mujer con hiyab, mujer con hiyab: tono de piel oscuro, paÃ±uelo, tono de piel oscuro
ğŸ¤µğŸ»	esmoquin, hombre, hombre con esmoquin, hombre con esmoquin: tono de piel claro, novio, tono de piel claro
ğŸ¤µğŸ¼	esmoquin, hombre, hombre con esmoquin, hombre con esmoquin: tono de piel claro medio, novio, tono de piel claro medio
ğŸ¤µğŸ½	esmoquin, hombre, hombre con esmoquin, hombre con esmoquin: tono de piel medio, novio, tono de piel medio
ğŸ¤µğŸ¾	esmoquin, hombre, hombre con esmoquin, hombre con esmoquin: tono de piel oscuro medio, novio, tono de piel oscuro medio
ğŸ¤µğŸ¿	esmoquin, hombre, hombre con esmoquin, hombre con esmoquin: tono de piel oscuro, novio, tono de piel oscuro
ğŸ‘°	boda, casamiento, mujer, novia, velo
ğŸ‘°ğŸ»	boda, casamiento, mujer, novia, novia con velo: tono de piel claro, tono de piel claro, velo
ğŸ‘°ğŸ¼	boda, casamiento, mujer, novia, novia con velo: tono de piel claro medio, tono de piel claro medio, velo
ğŸ‘°ğŸ½	boda, casamiento, mujer, novia, novia con velo: tono de piel medio, tono de piel medio, velo
ğŸ‘°ğŸ¾	boda, casamiento, mujer, novia, novia con velo: tono de piel oscuro medio, tono de piel oscuro medio, velo
ğŸ‘°ğŸ¿	boda, casamiento, mujer, novia, novia con velo: tono de piel oscuro, tono de piel oscuro, velo
ğŸ¤°ğŸ»	embarazada, mujer, mujer embarazada: tono de piel claro, tono de piel claro
ğŸ¤°ğŸ¼	embarazada, mujer, mujer embarazada: tono de piel claro medio, tono de piel claro medio
ğŸ¤°ğŸ½	embarazada, mujer, mujer embarazada: tono de piel medio, tono de piel medio
ğŸ¤°ğŸ¾	embarazada, mujer, mujer embarazada: tono de piel oscuro medio, tono de piel oscuro medio
ğŸ¤°ğŸ¿	embarazada, mujer, mujer embarazada: tono de piel oscuro, tono de piel oscuro
ğŸ¤±ğŸ»	amamantar, bebÃ©, dar pecho, lactancia materna, lactancia materna: tono de piel claro, pecho, tono de piel claro
ğŸ¤±ğŸ¼	amamantar, bebÃ©, dar pecho, lactancia materna, lactancia materna: tono de piel claro medio, pecho, tono de piel claro medio
ğŸ¤±ğŸ½	amamantar, bebÃ©, dar pecho, lactancia materna, lactancia materna: tono de piel medio, pecho, tono de piel medio
ğŸ¤±ğŸ¾	amamantar, bebÃ©, dar pecho, lactancia materna, lactancia materna: tono de piel oscuro medio, pecho, tono de piel oscuro medio
ğŸ¤±ğŸ¿	amamantar, bebÃ©, dar pecho, lactancia materna, lactancia materna: tono de piel oscuro, pecho, tono de piel oscuro
ğŸ‘¼	bebÃ©, cara, cuento de hadas, fantasÃ­a, Ã¡ngel
ğŸ‘¼ğŸ»	bebÃ©, bebÃ© Ã¡ngel: tono de piel claro, cara, cuento de hadas, fantasÃ­a, tono de piel claro, Ã¡ngel
ğŸ‘¼ğŸ¼	bebÃ©, bebÃ© Ã¡ngel: tono de piel claro medio, cara, cuento de hadas, fantasÃ­a, tono de piel claro medio, Ã¡ngel
ğŸ‘¼ğŸ½	bebÃ©, bebÃ© Ã¡ngel: tono de piel medio, cara, cuento de hadas, fantasÃ­a, tono de piel medio, Ã¡ngel
ğŸ‘¼ğŸ¾	bebÃ©, bebÃ© Ã¡ngel: tono de piel oscuro medio, cara, cuento de hadas, fantasÃ­a, tono de piel oscuro medio, Ã¡ngel
ğŸ‘¼ğŸ¿	bebÃ©, bebÃ© Ã¡ngel: tono de piel oscuro, cara, cuento de hadas, fantasÃ­a, tono de piel oscuro, Ã¡ngel
ğŸ…	Navidad, claus, noel, papÃ¡, santa
ğŸ…ğŸ»	Navidad, PapÃ¡ Noel: tono de piel claro, claus, noel, papÃ¡, santa, tono de piel claro
ğŸ…ğŸ¼	Navidad, PapÃ¡ Noel: tono de piel claro medio, claus, noel, papÃ¡, santa, tono de piel claro medio
ğŸ…ğŸ½	Navidad, PapÃ¡ Noel: tono de piel medio, claus, noel, papÃ¡, santa, tono de piel medio
ğŸ…ğŸ¾	Navidad, PapÃ¡ Noel: tono de piel oscuro medio, claus, noel, papÃ¡, santa, tono de piel oscuro medio
ğŸ…ğŸ¿	Navidad, PapÃ¡ Noel: tono de piel oscuro, claus, noel, papÃ¡, santa, tono de piel oscuro
ğŸ¤¶	Navidad, mamÃ¡, mamÃ¡ noel, seÃ±ora Claus
ğŸ¤¶ğŸ»	MamÃ¡ Noel: tono de piel claro, Navidad, mamÃ¡, mamÃ¡ noel, seÃ±ora Claus, tono de piel claro
ğŸ¤¶ğŸ¼	MamÃ¡ Noel: tono de piel claro medio, Navidad, mamÃ¡, mamÃ¡ noel, seÃ±ora Claus, tono de piel claro medio
ğŸ¤¶ğŸ½	MamÃ¡ Noel: tono de piel medio, Navidad, mamÃ¡, mamÃ¡ noel, seÃ±ora Claus, tono de piel medio
ğŸ¤¶ğŸ¾	MamÃ¡ Noel: tono de piel oscuro medio, Navidad, mamÃ¡, mamÃ¡ noel, seÃ±ora Claus, tono de piel oscuro medio
ğŸ¤¶ğŸ¿	MamÃ¡ Noel: tono de piel oscuro, Navidad, mamÃ¡, mamÃ¡ noel, seÃ±ora Claus, tono de piel oscuro
ğŸ¦¸	bien, heroÃ­na, hÃ©roe, superheroÃ­na, superpoder
ğŸ¦¸ğŸ»	bien, heroÃ­na, hÃ©roe, superheroÃ­na, superheroÃ­na: tono de piel claro, superpoder, tono de piel claro
ğŸ¦¸ğŸ¼	bien, heroÃ­na, hÃ©roe, superheroÃ­na, superheroÃ­na: tono de piel claro medio, superpoder, tono de piel claro medio
ğŸ¦¸ğŸ½	bien, heroÃ­na, hÃ©roe, superheroÃ­na, superheroÃ­na: tono de piel medio, superpoder, tono de piel medio
ğŸ¦¸ğŸ¾	bien, heroÃ­na, hÃ©roe, superheroÃ­na, superheroÃ­na: tono de piel oscuro medio, superpoder, tono de piel oscuro medio
ğŸ¦¸ğŸ¿	bien, heroÃ­na, hÃ©roe, superheroÃ­na, superheroÃ­na: tono de piel oscuro, superpoder, tono de piel oscuro
ğŸ¦¸â€â™‚	bien, hombre, hÃ©roe, superhÃ©roe, superpoder
ğŸ¦¸ğŸ»â€â™‚	bien, hombre, hÃ©roe, superhÃ©roe, superhÃ©roe: tono de piel claro, superpoder, tono de piel claro
ğŸ¦¸ğŸ¼â€â™‚	bien, hombre, hÃ©roe, superhÃ©roe, superhÃ©roe: tono de piel claro medio, superpoder, tono de piel claro medio
ğŸ¦¸ğŸ½â€â™‚	bien, hombre, hÃ©roe, superhÃ©roe, superhÃ©roe: tono de piel medio, superpoder, tono de piel medio
ğŸ¦¸ğŸ¾â€â™‚	bien, hombre, hÃ©roe, superhÃ©roe, superhÃ©roe: tono de piel oscuro medio, superpoder, tono de piel oscuro medio
ğŸ¦¸ğŸ¿â€â™‚	bien, hombre, hÃ©roe, superhÃ©roe, superhÃ©roe: tono de piel oscuro, superpoder, tono de piel oscuro
ğŸ¦¸â€â™€	bien, heroÃ­na, hÃ©roe, mujer, mujer superheroÃ­na, superpoder
ğŸ¦¸ğŸ»â€â™€	bien, heroÃ­na, hÃ©roe, mujer, mujer superheroÃ­na, mujer superheroÃ­na: tono de piel claro, superpoder, tono de piel claro
ğŸ¦¸ğŸ¼â€â™€	bien, heroÃ­na, hÃ©roe, mujer, mujer superheroÃ­na, mujer superheroÃ­na: tono de piel claro medio, superpoder, tono de piel claro medio
ğŸ¦¸ğŸ½â€â™€	bien, heroÃ­na, hÃ©roe, mujer, mujer superheroÃ­na, mujer superheroÃ­na: tono de piel medio, superpoder, tono de piel medio
ğŸ¦¸ğŸ¾â€â™€	bien, heroÃ­na, hÃ©roe, mujer, mujer superheroÃ­na, mujer superheroÃ­na: tono de piel oscuro medio, superpoder, tono de piel oscuro medio
ğŸ¦¸ğŸ¿â€â™€	bien, heroÃ­na, hÃ©roe, mujer, mujer superheroÃ­na, mujer superheroÃ­na: tono de piel oscuro, superpoder, tono de piel oscuro
ğŸ¦¹	delito, mal, superpoder, supervillano, villano
ğŸ¦¹ğŸ»	delito, mal, superpoder, supervillano, supervillano: tono de piel claro, tono de piel claro, villano
ğŸ¦¹ğŸ¼	delito, mal, superpoder, supervillano, supervillano: tono de piel claro medio, tono de piel claro medio, villano
ğŸ¦¹ğŸ½	delito, mal, superpoder, supervillano, supervillano: tono de piel medio, tono de piel medio, villano
ğŸ¦¹ğŸ¾	delito, mal, superpoder, supervillano, supervillano: tono de piel oscuro medio, tono de piel oscuro medio, villano
ğŸ¦¹ğŸ¿	delito, mal, superpoder, supervillano, supervillano: tono de piel oscuro, tono de piel oscuro, villano
ğŸ¦¹â€â™‚	delito, hombre, hombre supervillano, mal, superpoder, villano
ğŸ¦¹ğŸ»â€â™‚	delito, hombre, hombre supervillano, hombre supervillano: tono de piel claro, mal, superpoder, tono de piel claro, villano
ğŸ¦¹ğŸ¼â€â™‚	delito, hombre, hombre supervillano, hombre supervillano: tono de piel claro medio, mal, superpoder, tono de piel claro medio, villano
ğŸ¦¹ğŸ½â€â™‚	delito, hombre, hombre supervillano, hombre supervillano: tono de piel medio, mal, superpoder, tono de piel medio, villano
ğŸ¦¹ğŸ¾â€â™‚	delito, hombre, hombre supervillano, hombre supervillano: tono de piel oscuro medio, mal, superpoder, tono de piel oscuro medio, villano
ğŸ¦¹ğŸ¿â€â™‚	delito, hombre, hombre supervillano, hombre supervillano: tono de piel oscuro, mal, superpoder, tono de piel oscuro, villano
ğŸ¦¹â€â™€	delito, mal, mujer, superpoder, supervillana, villana
ğŸ¦¹ğŸ»â€â™€	delito, mal, mujer, superpoder, supervillana, supervillana: tono de piel claro, tono de piel claro, villana
ğŸ¦¹ğŸ¼â€â™€	delito, mal, mujer, superpoder, supervillana, supervillana: tono de piel claro medio, tono de piel claro medio, villana
ğŸ¦¹ğŸ½â€â™€	delito, mal, mujer, superpoder, supervillana, supervillana: tono de piel medio, tono de piel medio, villana
ğŸ¦¹ğŸ¾â€â™€	delito, mal, mujer, superpoder, supervillana, supervillana: tono de piel oscuro medio, tono de piel oscuro medio, villana
ğŸ¦¹ğŸ¿â€â™€	delito, mal, mujer, superpoder, supervillana, supervillana: tono de piel oscuro, tono de piel oscuro, villana
ğŸ§™ğŸ»	bruja, brujo, hechicera, hechicero, persona maga, persona maga: tono de piel claro, tono de piel claro
ğŸ§™ğŸ¼	bruja, brujo, hechicera, hechicero, persona maga, persona maga: tono de piel claro medio, tono de piel claro medio
ğŸ§™ğŸ½	bruja, brujo, hechicera, hechicero, persona maga, persona maga: tono de piel medio, tono de piel medio
ğŸ§™ğŸ¾	bruja, brujo, hechicera, hechicero, persona maga, persona maga: tono de piel oscuro medio, tono de piel oscuro medio
ğŸ§™ğŸ¿	bruja, brujo, hechicera, hechicero, persona maga, persona maga: tono de piel oscuro, tono de piel oscuro
ğŸ§™ğŸ»â€â™‚	brujo, hechicero, mago, mago: tono de piel claro, tono de piel claro
ğŸ§™ğŸ¼â€â™‚	brujo, hechicero, mago, mago: tono de piel claro medio, tono de piel claro medio
ğŸ§™ğŸ½â€â™‚	brujo, hechicero, mago, mago: tono de piel medio, tono de piel medio
ğŸ§™ğŸ¾â€â™‚	brujo, hechicero, mago, mago: tono de piel oscuro medio, tono de piel oscuro medio
ğŸ§™ğŸ¿â€â™‚	brujo, hechicero, mago, mago: tono de piel oscuro, tono de piel oscuro
ğŸ§™ğŸ»â€â™€	bruja, hechicera, maga, maga: tono de piel claro, tono de piel claro
ğŸ§™ğŸ¼â€â™€	bruja, hechicera, maga, maga: tono de piel claro medio, tono de piel claro medio
ğŸ§™ğŸ½â€â™€	bruja, hechicera, maga, maga: tono de piel medio, tono de piel medio
ğŸ§™ğŸ¾â€â™€	bruja, hechicera, maga, maga: tono de piel oscuro medio, tono de piel oscuro medio
ğŸ§™ğŸ¿â€â™€	bruja, hechicera, maga, maga: tono de piel oscuro, tono de piel oscuro
ğŸ§š	campanita, hada, oberÃ³n, puck, titania
ğŸ§šğŸ»	campanita, hada, hada: tono de piel claro, oberÃ³n, puck, titania, tono de piel claro
ğŸ§šğŸ¼	campanita, hada, hada: tono de piel claro medio, oberÃ³n, puck, titania, tono de piel claro medio
ğŸ§šğŸ½	campanita, hada, hada: tono de piel medio, oberÃ³n, puck, titania, tono de piel medio
ğŸ§šğŸ¾	campanita, hada, hada: tono de piel oscuro medio, oberÃ³n, puck, titania, tono de piel oscuro medio
ğŸ§šğŸ¿	campanita, hada, hada: tono de piel oscuro, oberÃ³n, puck, titania, tono de piel oscuro
ğŸ§šğŸ»â€â™‚	hada, hada hombre, hada hombre: tono de piel claro, oberÃ³n, puck, tono de piel claro
ğŸ§šğŸ¼â€â™‚	hada, hada hombre, hada hombre: tono de piel claro medio, oberÃ³n, puck, tono de piel claro medio
ğŸ§šğŸ½â€â™‚	hada, hada hombre, hada hombre: tono de piel medio, oberÃ³n, puck, tono de piel medio
ğŸ§šğŸ¾â€â™‚	hada, hada hombre, hada hombre: tono de piel oscuro medio, oberÃ³n, puck, tono de piel oscuro medio
ğŸ§šğŸ¿â€â™‚	hada, hada hombre, hada hombre: tono de piel oscuro, oberÃ³n, puck, tono de piel oscuro
ğŸ§šğŸ»â€â™€	campanilla, hada, hada mujer, hada mujer: tono de piel claro, titania, tono de piel claro
ğŸ§šğŸ¼â€â™€	campanilla, hada, hada mujer, hada mujer: tono de piel claro medio, titania, tono de piel claro medio
ğŸ§šğŸ½â€â™€	campanilla, hada, hada mujer, hada mujer: tono de piel medio, titania, tono de piel medio
ğŸ§šğŸ¾â€â™€	campanilla, hada, hada mujer, hada mujer: tono de piel oscuro medio, titania, tono de piel oscuro medio
ğŸ§šğŸ¿â€â™€	campanilla, hada, hada mujer, hada mujer: tono de piel oscuro, titania, tono de piel oscuro
ğŸ§›	drÃ¡cula, muerto viviente, vampiro
ğŸ§›ğŸ»	drÃ¡cula, muerto viviente, tono de piel claro, vampiro, vampiro: tono de piel claro
ğŸ§›ğŸ¼	drÃ¡cula, muerto viviente, tono de piel claro medio, vampiro, vampiro: tono de piel claro medio
ğŸ§›ğŸ½	drÃ¡cula, muerto viviente, tono de piel medio, vampiro, vampiro: tono de piel medio
ğŸ§›ğŸ¾	drÃ¡cula, muerto viviente, tono de piel oscuro medio, vampiro, vampiro: tono de piel oscuro medio
ğŸ§›ğŸ¿	drÃ¡cula, muerto viviente, tono de piel oscuro, vampiro, vampiro: tono de piel oscuro
ğŸ§›â€â™‚	drÃ¡cula, muerto viviente, vampiro
ğŸ§›ğŸ»â€â™‚	drÃ¡cula, muerto viviente, tono de piel claro, vampiro, vampiro hombre: tono de piel claro
ğŸ§›ğŸ¼â€â™‚	drÃ¡cula, muerto viviente, tono de piel claro medio, vampiro, vampiro hombre: tono de piel claro medio
ğŸ§›ğŸ½â€â™‚	drÃ¡cula, muerto viviente, tono de piel medio, vampiro, vampiro hombre: tono de piel medio
ğŸ§›ğŸ¾â€â™‚	drÃ¡cula, muerto viviente, tono de piel oscuro medio, vampiro, vampiro hombre: tono de piel oscuro medio
ğŸ§›ğŸ¿â€â™‚	drÃ¡cula, muerto viviente, tono de piel oscuro, vampiro, vampiro hombre: tono de piel oscuro
ğŸ§›â€â™€	muerta viviente, vampiresa
ğŸ§›ğŸ»â€â™€	muerta viviente, tono de piel claro, vampiresa, vampiresa: tono de piel claro
ğŸ§›ğŸ¼â€â™€	muerta viviente, tono de piel claro medio, vampiresa, vampiresa: tono de piel claro medio
ğŸ§›ğŸ½â€â™€	muerta viviente, tono de piel medio, vampiresa, vampiresa: tono de piel medio
ğŸ§›ğŸ¾â€â™€	muerta viviente, tono de piel oscuro medio, vampiresa, vampiresa: tono de piel oscuro medio
ğŸ§›ğŸ¿â€â™€	muerta viviente, tono de piel oscuro, vampiresa, vampiresa: tono de piel oscuro
ğŸ§œğŸ»	persona sirena, persona sirena: tono de piel claro, sirena, tono de piel claro
ğŸ§œğŸ¼	persona sirena, persona sirena: tono de piel claro medio, sirena, tono de piel claro medio
ğŸ§œğŸ½	persona sirena, persona sirena: tono de piel medio, sirena, tono de piel medio
ğŸ§œğŸ¾	persona sirena, persona sirena: tono de piel oscuro medio, sirena, tono de piel oscuro medio
ğŸ§œğŸ¿	persona sirena, persona sirena: tono de piel oscuro, sirena, tono de piel oscuro
ğŸ§œğŸ»â€â™‚	sirena, sirena hombre, sirena hombre: tono de piel claro, tono de piel claro, tritÃ³n
ğŸ§œğŸ¼â€â™‚	sirena, sirena hombre, sirena hombre: tono de piel claro medio, tono de piel claro medio, tritÃ³n
ğŸ§œğŸ½â€â™‚	sirena, sirena hombre, sirena hombre: tono de piel medio, tono de piel medio, tritÃ³n
ğŸ§œğŸ¾â€â™‚	sirena, sirena hombre, sirena hombre: tono de piel oscuro medio, tono de piel oscuro medio, tritÃ³n
ğŸ§œğŸ¿â€â™‚	sirena, sirena hombre, sirena hombre: tono de piel oscuro, tono de piel oscuro, tritÃ³n
ğŸ§œğŸ»â€â™€	sirena, sirena: tono de piel claro, tono de piel claro
ğŸ§œğŸ¼â€â™€	sirena, sirena: tono de piel claro medio, tono de piel claro medio
ğŸ§œğŸ½â€â™€	sirena, sirena: tono de piel medio, tono de piel medio
ğŸ§œğŸ¾â€â™€	sirena, sirena: tono de piel oscuro medio, tono de piel oscuro medio
ğŸ§œğŸ¿â€â™€	sirena, sirena: tono de piel oscuro, tono de piel oscuro
ğŸ§ğŸ»	elfo, elfo: tono de piel claro, mÃ¡gico, tono de piel claro
ğŸ§ğŸ¼	elfo, elfo: tono de piel claro medio, mÃ¡gico, tono de piel claro medio
ğŸ§ğŸ½	elfo, elfo: tono de piel medio, mÃ¡gico, tono de piel medio
ğŸ§ğŸ¾	elfo, elfo: tono de piel oscuro medio, mÃ¡gico, tono de piel oscuro medio
ğŸ§ğŸ¿	elfo, elfo: tono de piel oscuro, mÃ¡gico, tono de piel oscuro
ğŸ§ğŸ»â€â™‚	elfo, elfo hombre, elfo hombre: tono de piel claro, mÃ¡gico, tono de piel claro
ğŸ§ğŸ¼â€â™‚	elfo, elfo hombre, elfo hombre: tono de piel claro medio, mÃ¡gico, tono de piel claro medio
ğŸ§ğŸ½â€â™‚	elfo, elfo hombre, elfo hombre: tono de piel medio, mÃ¡gico, tono de piel medio
ğŸ§ğŸ¾â€â™‚	elfo, elfo hombre, elfo hombre: tono de piel oscuro medio, mÃ¡gico, tono de piel oscuro medio
ğŸ§ğŸ¿â€â™‚	elfo, elfo hombre, elfo hombre: tono de piel oscuro, mÃ¡gico, tono de piel oscuro
ğŸ§ğŸ»â€â™€	elfa, elfa: tono de piel claro, mujer, mÃ¡gico, tono de piel claro
ğŸ§ğŸ¼â€â™€	elfa, elfa: tono de piel claro medio, mujer, mÃ¡gico, tono de piel claro medio
ğŸ§ğŸ½â€â™€	elfa, elfa: tono de piel medio, mujer, mÃ¡gico, tono de piel medio
ğŸ§ğŸ¾â€â™€	elfa, elfa: tono de piel oscuro medio, mujer, mÃ¡gico, tono de piel oscuro medio
ğŸ§ğŸ¿â€â™€	elfa, elfa: tono de piel oscuro, mujer, mÃ¡gico, tono de piel oscuro
ğŸ§Ÿ	persona zombi
ğŸ§Ÿâ€â™‚	muerto viviente, zombi hombre
ğŸ§Ÿâ€â™€	muerta viviente, zombi hombre
ğŸ’†	persona recibiendo masaje
ğŸ’†ğŸ»	persona recibiendo masaje, persona recibiendo masaje: tono de piel claro, tono de piel claro
ğŸ’†ğŸ¼	persona recibiendo masaje, persona recibiendo masaje: tono de piel claro medio, tono de piel claro medio
ğŸ’†ğŸ½	persona recibiendo masaje, persona recibiendo masaje: tono de piel medio, tono de piel medio
ğŸ’†ğŸ¾	persona recibiendo masaje, persona recibiendo masaje: tono de piel oscuro medio, tono de piel oscuro medio
ğŸ’†ğŸ¿	persona recibiendo masaje, persona recibiendo masaje: tono de piel oscuro, tono de piel oscuro
ğŸ’†ğŸ»â€â™‚	cara, facial, hombre recibiendo masaje, hombre recibiendo masaje: tono de piel claro, masaje, salÃ³n, tono de piel claro
ğŸ’†ğŸ¼â€â™‚	cara, facial, hombre recibiendo masaje, hombre recibiendo masaje: tono de piel claro medio, masaje, salÃ³n, tono de piel claro medio
ğŸ’†ğŸ½â€â™‚	cara, facial, hombre recibiendo masaje, hombre recibiendo masaje: tono de piel medio, masaje, salÃ³n, tono de piel medio
ğŸ’†ğŸ¾â€â™‚	cara, facial, hombre recibiendo masaje, hombre recibiendo masaje: tono de piel oscuro medio, masaje, salÃ³n, tono de piel oscuro medio
ğŸ’†ğŸ¿â€â™‚	cara, facial, hombre recibiendo masaje, hombre recibiendo masaje: tono de piel oscuro, masaje, salÃ³n, tono de piel oscuro
ğŸ’†ğŸ»â€â™€	cara, facial, masaje, mujer recibiendo masaje, mujer recibiendo masaje: tono de piel claro, salÃ³n, tono de piel claro
ğŸ’†ğŸ¼â€â™€	cara, facial, masaje, mujer recibiendo masaje, mujer recibiendo masaje: tono de piel claro medio, salÃ³n, tono de piel claro medio
ğŸ’†ğŸ½â€â™€	cara, facial, masaje, mujer recibiendo masaje, mujer recibiendo masaje: tono de piel medio, salÃ³n, tono de piel medio
ğŸ’†ğŸ¾â€â™€	cara, facial, masaje, mujer recibiendo masaje, mujer recibiendo masaje: tono de piel oscuro medio, salÃ³n, tono de piel oscuro medio
ğŸ’†ğŸ¿â€â™€	cara, facial, masaje, mujer recibiendo masaje, mujer recibiendo masaje: tono de piel oscuro, salÃ³n, tono de piel oscuro
ğŸ’‡	persona cortÃ¡ndose el pelo
ğŸ’‡ğŸ»	persona cortÃ¡ndose el pelo, persona cortÃ¡ndose el pelo: tono de piel claro, tono de piel claro
ğŸ’‡ğŸ¼	persona cortÃ¡ndose el pelo, persona cortÃ¡ndose el pelo: tono de piel claro medio, tono de piel claro medio
ğŸ’‡ğŸ½	persona cortÃ¡ndose el pelo, persona cortÃ¡ndose el pelo: tono de piel medio, tono de piel medio
ğŸ’‡ğŸ¾	persona cortÃ¡ndose el pelo, persona cortÃ¡ndose el pelo: tono de piel oscuro medio, tono de piel oscuro medio
ğŸ’‡ğŸ¿	persona cortÃ¡ndose el pelo, persona cortÃ¡ndose el pelo: tono de piel oscuro, tono de piel oscuro
ğŸ’‡â€â™‚	corte de pelo, hombre, pelo, peluquerÃ­a, salÃ³n
ğŸ’‡ğŸ»â€â™‚	corte de pelo, hombre, hombre cortÃ¡ndose el pelo: tono de piel claro, pelo, peluquerÃ­a, salÃ³n, tono de piel claro
ğŸ’‡ğŸ¼â€â™‚	corte de pelo, hombre, hombre cortÃ¡ndose el pelo: tono de piel claro medio, pelo, peluquerÃ­a, salÃ³n, tono de piel claro medio
ğŸ’‡ğŸ½â€â™‚	corte de pelo, hombre, hombre cortÃ¡ndose el pelo: tono de piel medio, pelo, peluquerÃ­a, salÃ³n, tono de piel medio
ğŸ’‡ğŸ¾â€â™‚	corte de pelo, hombre, hombre cortÃ¡ndose el pelo: tono de piel oscuro medio, pelo, peluquerÃ­a, salÃ³n, tono de piel oscuro medio
ğŸ’‡ğŸ¿â€â™‚	corte de pelo, hombre, hombre cortÃ¡ndose el pelo: tono de piel oscuro, pelo, peluquerÃ­a, salÃ³n, tono de piel oscuro
ğŸ’‡â€â™€	corte de pelo, mujer, pelo, peluquero, peluquerÃ­a
ğŸ’‡ğŸ»â€â™€	corte de pelo, mujer, mujer cortÃ¡ndose el pelo: tono de piel claro, pelo, peluquero, peluquerÃ­a, tono de piel claro
ğŸ’‡ğŸ¼â€â™€	corte de pelo, mujer, mujer cortÃ¡ndose el pelo: tono de piel claro medio, pelo, peluquero, peluquerÃ­a, tono de piel claro medio
ğŸ’‡ğŸ½â€â™€	corte de pelo, mujer, mujer cortÃ¡ndose el pelo: tono de piel medio, pelo, peluquero, peluquerÃ­a, tono de piel medio
ğŸ’‡ğŸ¾â€â™€	corte de pelo, mujer, mujer cortÃ¡ndose el pelo: tono de piel oscuro medio, pelo, peluquero, peluquerÃ­a, tono de piel oscuro medio
ğŸ’‡ğŸ¿â€â™€	corte de pelo, mujer, mujer cortÃ¡ndose el pelo: tono de piel oscuro, pelo, peluquero, peluquerÃ­a, tono de piel oscuro
ğŸš¶ğŸ»	andar, caminando, caminar, persona caminando, persona caminando: tono de piel claro, tono de piel claro
ğŸš¶ğŸ¼	andar, caminando, caminar, persona caminando, persona caminando: tono de piel claro medio, tono de piel claro medio
ğŸš¶ğŸ½	andar, caminando, caminar, persona caminando, persona caminando: tono de piel medio, tono de piel medio
ğŸš¶ğŸ¾	andar, caminando, caminar, persona caminando, persona caminando: tono de piel oscuro medio, tono de piel oscuro medio
ğŸš¶ğŸ¿	andar, caminando, caminar, persona caminando, persona caminando: tono de piel oscuro, tono de piel oscuro
ğŸš¶ğŸ»â€â™‚	andar, caminata, hombre, hombre caminando, hombre caminando: tono de piel claro, marcha, tono de piel claro
ğŸš¶ğŸ¼â€â™‚	andar, caminata, hombre, hombre caminando, hombre caminando: tono de piel claro medio, marcha, tono de piel claro medio
ğŸš¶ğŸ½â€â™‚	andar, caminata, hombre, hombre caminando, hombre caminando: tono de piel medio, marcha, tono de piel medio
ğŸš¶ğŸ¾â€â™‚	andar, caminata, hombre, hombre caminando, hombre caminando: tono de piel oscuro medio, marcha, tono de piel oscuro medio
ğŸš¶ğŸ¿â€â™‚	andar, caminata, hombre, hombre caminando, hombre caminando: tono de piel oscuro, marcha, tono de piel oscuro
ğŸš¶ğŸ»â€â™€	andar, caminata, marcha, mujer, mujer caminando, mujer caminando: tono de piel claro, tono de piel claro
ğŸš¶ğŸ¼â€â™€	andar, caminata, marcha, mujer, mujer caminando, mujer caminando: tono de piel claro medio, tono de piel claro medio
ğŸš¶ğŸ½â€â™€	andar, caminata, marcha, mujer, mujer caminando, mujer caminando: tono de piel medio, tono de piel medio
ğŸš¶ğŸ¾â€â™€	andar, caminata, marcha, mujer, mujer caminando, mujer caminando: tono de piel oscuro medio, tono de piel oscuro medio
ğŸš¶ğŸ¿â€â™€	andar, caminata, marcha, mujer, mujer caminando, mujer caminando: tono de piel oscuro, tono de piel oscuro
ğŸ§ğŸ»	de pie, levantada, levantado, levantarse, persona de pie, persona de pie: tono de piel claro, tono de piel claro
ğŸ§ğŸ¼	de pie, levantada, levantado, levantarse, persona de pie, persona de pie: tono de piel claro medio, tono de piel claro medio
ğŸ§ğŸ½	de pie, levantada, levantado, levantarse, persona de pie, persona de pie: tono de piel medio, tono de piel medio
ğŸ§ğŸ¾	de pie, levantada, levantado, levantarse, persona de pie, persona de pie: tono de piel oscuro medio, tono de piel oscuro medio
ğŸ§ğŸ¿	de pie, levantada, levantado, levantarse, persona de pie, persona de pie: tono de piel oscuro, tono de piel oscuro
ğŸ§ğŸ»â€â™‚	de pie, hombre, hombre de pie, hombre de pie: tono de piel claro, levantado, levantarse, tono de piel claro
ğŸ§ğŸ¼â€â™‚	de pie, hombre, hombre de pie, hombre de pie: tono de piel claro medio, levantado, levantarse, tono de piel claro medio
ğŸ§ğŸ½â€â™‚	de pie, hombre, hombre de pie, hombre de pie: tono de piel medio, levantado, levantarse, tono de piel medio
ğŸ§ğŸ¾â€â™‚	de pie, hombre, hombre de pie, hombre de pie: tono de piel oscuro medio, levantado, levantarse, tono de piel oscuro medio
ğŸ§ğŸ¿â€â™‚	de pie, hombre, hombre de pie, hombre de pie: tono de piel oscuro, levantado, levantarse, tono de piel oscuro
ğŸ§ğŸ»â€â™€	de pie, levantada, levantarse, mujer, mujer de pie, mujer de pie: tono de piel claro, tono de piel claro
ğŸ§ğŸ¼â€â™€	de pie, levantada, levantarse, mujer, mujer de pie, mujer de pie: tono de piel claro medio, tono de piel claro medio
ğŸ§ğŸ½â€â™€	de pie, levantada, levantarse, mujer, mujer de pie, mujer de pie: tono de piel medio, tono de piel medio
ğŸ§ğŸ¾â€â™€	de pie, levantada, levantarse, mujer, mujer de pie, mujer de pie: tono de piel oscuro medio, tono de piel oscuro medio
ğŸ§ğŸ¿â€â™€	de pie, levantada, levantarse, mujer, mujer de pie, mujer de pie: tono de piel oscuro, tono de piel oscuro
ğŸ§ğŸ»	arrodillada, arrodillado, arrodillarse, de rodillas, persona de rodillas, persona de rodillas: tono de piel claro, tono de piel claro
ğŸ§ğŸ¼	arrodillada, arrodillado, arrodillarse, de rodillas, persona de rodillas, persona de rodillas: tono de piel claro medio, tono de piel claro medio
ğŸ§ğŸ½	arrodillada, arrodillado, arrodillarse, de rodillas, persona de rodillas, persona de rodillas: tono de piel medio, tono de piel medio
ğŸ§ğŸ¾	arrodillada, arrodillado, arrodillarse, de rodillas, persona de rodillas, persona de rodillas: tono de piel oscuro medio, tono de piel oscuro medio
ğŸ§ğŸ¿	arrodillada, arrodillado, arrodillarse, de rodillas, persona de rodillas, persona de rodillas: tono de piel oscuro, tono de piel oscuro
ğŸ§ğŸ»â€â™‚	arrodillado, arrodillarse, de rodillas, hombre, hombre de rodillas, hombre de rodillas: tono de piel claro, tono de piel claro
ğŸ§ğŸ¼â€â™‚	arrodillado, arrodillarse, de rodillas, hombre, hombre de rodillas, hombre de rodillas: tono de piel claro medio, tono de piel claro medio
ğŸ§ğŸ½â€â™‚	arrodillado, arrodillarse, de rodillas, hombre, hombre de rodillas, hombre de rodillas: tono de piel medio, tono de piel medio
ğŸ§ğŸ¾â€â™‚	arrodillado, arrodillarse, de rodillas, hombre, hombre de rodillas, hombre de rodillas: tono de piel oscuro medio, tono de piel oscuro medio
ğŸ§ğŸ¿â€â™‚	arrodillado, arrodillarse, de rodillas, hombre, hombre de rodillas, hombre de rodillas: tono de piel oscuro, tono de piel oscuro
ğŸ§ğŸ»â€â™€	arrodillada, arrodillarse, de rodillas, mujer, mujer de rodillas, mujer de rodillas: tono de piel claro, tono de piel claro
ğŸ§ğŸ¼â€â™€	arrodillada, arrodillarse, de rodillas, mujer, mujer de rodillas, mujer de rodillas: tono de piel claro medio, tono de piel claro medio
ğŸ§ğŸ½â€â™€	arrodillada, arrodillarse, de rodillas, mujer, mujer de rodillas, mujer de rodillas: tono de piel medio, tono de piel medio
ğŸ§ğŸ¾â€â™€	arrodillada, arrodillarse, de rodillas, mujer, mujer de rodillas, mujer de rodillas: tono de piel oscuro medio, tono de piel oscuro medio
ğŸ§ğŸ¿â€â™€	arrodillada, arrodillarse, de rodillas, mujer, mujer de rodillas, mujer de rodillas: tono de piel oscuro, tono de piel oscuro
ğŸ‘¨ğŸ»â€ğŸ¦¯	accesibilidad, bastÃ³n, ciego, hombre, hombre con bastÃ³n, hombre con bastÃ³n: tono de piel claro, invidente, tono de piel claro
ğŸ‘¨ğŸ¼â€ğŸ¦¯	accesibilidad, bastÃ³n, ciego, hombre, hombre con bastÃ³n, hombre con bastÃ³n: tono de piel claro medio, invidente, tono de piel claro medio
ğŸ‘¨ğŸ½â€ğŸ¦¯	accesibilidad, bastÃ³n, ciego, hombre, hombre con bastÃ³n, hombre con bastÃ³n: tono de piel medio, invidente, tono de piel medio
ğŸ‘¨ğŸ¾â€ğŸ¦¯	accesibilidad, bastÃ³n, ciego, hombre, hombre con bastÃ³n, hombre con bastÃ³n: tono de piel oscuro medio, invidente, tono de piel oscuro medio
ğŸ‘¨ğŸ¿â€ğŸ¦¯	accesibilidad, bastÃ³n, ciego, hombre, hombre con bastÃ³n, hombre con bastÃ³n: tono de piel oscuro, invidente, tono de piel oscuro
ğŸ‘©ğŸ»â€ğŸ¦¯	accesibilidad, bastÃ³n, ciega, invidente, mujer, mujer con bastÃ³n, mujer con bastÃ³n: tono de piel claro, tono de piel claro
ğŸ‘©ğŸ¼â€ğŸ¦¯	accesibilidad, bastÃ³n, ciega, invidente, mujer, mujer con bastÃ³n, mujer con bastÃ³n: tono de piel claro medio, tono de piel claro medio
ğŸ‘©ğŸ½â€ğŸ¦¯	accesibilidad, bastÃ³n, ciega, invidente, mujer, mujer con bastÃ³n, mujer con bastÃ³n: tono de piel medio, tono de piel medio
ğŸ‘©ğŸ¾â€ğŸ¦¯	accesibilidad, bastÃ³n, ciega, invidente, mujer, mujer con bastÃ³n, mujer con bastÃ³n: tono de piel oscuro medio, tono de piel oscuro medio
ğŸ‘©ğŸ¿â€ğŸ¦¯	accesibilidad, bastÃ³n, ciega, invidente, mujer, mujer con bastÃ³n, mujer con bastÃ³n: tono de piel oscuro, tono de piel oscuro
ğŸ‘¨ğŸ»â€ğŸ¦¼	accesibilidad, hombre, hombre en silla de ruedas elÃ©ctrica, hombre en silla de ruedas elÃ©ctrica: tono de piel claro, silla de ruedas, tono de piel claro
ğŸ‘¨ğŸ¼â€ğŸ¦¼	accesibilidad, hombre, hombre en silla de ruedas elÃ©ctrica, hombre en silla de ruedas elÃ©ctrica: tono de piel claro medio, silla de ruedas, tono de piel claro medio
ğŸ‘¨ğŸ½â€ğŸ¦¼	accesibilidad, hombre, hombre en silla de ruedas elÃ©ctrica, hombre en silla de ruedas elÃ©ctrica: tono de piel medio, silla de ruedas, tono de piel medio
ğŸ‘¨ğŸ¾â€ğŸ¦¼	accesibilidad, hombre, hombre en silla de ruedas elÃ©ctrica, hombre en silla de ruedas elÃ©ctrica: tono de piel oscuro medio, silla de ruedas, tono de piel oscuro medio
ğŸ‘¨ğŸ¿â€ğŸ¦¼	accesibilidad, hombre, hombre en silla de ruedas elÃ©ctrica, hombre en silla de ruedas elÃ©ctrica: tono de piel oscuro, silla de ruedas, tono de piel oscuro
ğŸ‘©ğŸ»â€ğŸ¦¼	accesibilidad, mujer, mujer en silla de ruedas elÃ©ctrica, mujer en silla de ruedas elÃ©ctrica: tono de piel claro, silla de ruedas, tono de piel claro
ğŸ‘©ğŸ¼â€ğŸ¦¼	accesibilidad, mujer, mujer en silla de ruedas elÃ©ctrica, mujer en silla de ruedas elÃ©ctrica: tono de piel claro medio, silla de ruedas, tono de piel claro medio
ğŸ‘©ğŸ½â€ğŸ¦¼	accesibilidad, mujer, mujer en silla de ruedas elÃ©ctrica, mujer en silla de ruedas elÃ©ctrica: tono de piel medio, silla de ruedas, tono de piel medio
ğŸ‘©ğŸ¾â€ğŸ¦¼	accesibilidad, mujer, mujer en silla de ruedas elÃ©ctrica, mujer en silla de ruedas elÃ©ctrica: tono de piel oscuro medio, silla de ruedas, tono de piel oscuro medio
ğŸ‘©ğŸ¿â€ğŸ¦¼	accesibilidad, mujer, mujer en silla de ruedas elÃ©ctrica, mujer en silla de ruedas elÃ©ctrica: tono de piel oscuro, silla de ruedas, tono de piel oscuro
ğŸ‘¨ğŸ»â€ğŸ¦½	accesibilidad, hombre, hombre en silla de ruedas manual, hombre en silla de ruedas manual: tono de piel claro, silla de ruedas, tono de piel claro
ğŸ‘¨ğŸ¼â€ğŸ¦½	accesibilidad, hombre, hombre en silla de ruedas manual, hombre en silla de ruedas manual: tono de piel claro medio, silla de ruedas, tono de piel claro medio
ğŸ‘¨ğŸ½â€ğŸ¦½	accesibilidad, hombre, hombre en silla de ruedas manual, hombre en silla de ruedas manual: tono de piel medio, silla de ruedas, tono de piel medio
ğŸ‘¨ğŸ¾â€ğŸ¦½	accesibilidad, hombre, hombre en silla de ruedas manual, hombre en silla de ruedas manual: tono de piel oscuro medio, silla de ruedas, tono de piel oscuro medio
ğŸ‘¨ğŸ¿â€ğŸ¦½	accesibilidad, hombre, hombre en silla de ruedas manual, hombre en silla de ruedas manual: tono de piel oscuro, silla de ruedas, tono de piel oscuro
ğŸ‘©ğŸ»â€ğŸ¦½	accesibilidad, mujer, mujer en silla de ruedas manual, mujer en silla de ruedas manual: tono de piel claro, silla de ruedas, tono de piel claro
ğŸ‘©ğŸ¼â€ğŸ¦½	accesibilidad, mujer, mujer en silla de ruedas manual, mujer en silla de ruedas manual: tono de piel claro medio, silla de ruedas, tono de piel claro medio
ğŸ‘©ğŸ½â€ğŸ¦½	accesibilidad, mujer, mujer en silla de ruedas manual, mujer en silla de ruedas manual: tono de piel medio, silla de ruedas, tono de piel medio
ğŸ‘©ğŸ¾â€ğŸ¦½	accesibilidad, mujer, mujer en silla de ruedas manual, mujer en silla de ruedas manual: tono de piel oscuro medio, silla de ruedas, tono de piel oscuro medio
ğŸ‘©ğŸ¿â€ğŸ¦½	accesibilidad, mujer, mujer en silla de ruedas manual, mujer en silla de ruedas manual: tono de piel oscuro, silla de ruedas, tono de piel oscuro
ğŸƒğŸ»	carrera, deporte, maratÃ³n, persona corriendo, persona corriendo: tono de piel claro, tono de piel claro
ğŸƒğŸ¼	carrera, deporte, maratÃ³n, persona corriendo, persona corriendo: tono de piel claro medio, tono de piel claro medio
ğŸƒğŸ½	carrera, deporte, maratÃ³n, persona corriendo, persona corriendo: tono de piel medio, tono de piel medio
ğŸƒğŸ¾	carrera, deporte, maratÃ³n, persona corriendo, persona corriendo: tono de piel oscuro medio, tono de piel oscuro medio
ğŸƒğŸ¿	carrera, deporte, maratÃ³n, persona corriendo, persona corriendo: tono de piel oscuro, tono de piel oscuro
ğŸƒğŸ»â€â™‚	carrera, correr, hombre, hombre corriendo, hombre corriendo: tono de piel claro, maratÃ³n, tono de piel claro
ğŸƒğŸ¼â€â™‚	carrera, correr, hombre, hombre corriendo, hombre corriendo: tono de piel claro medio, maratÃ³n, tono de piel claro medio
ğŸƒğŸ½â€â™‚	carrera, correr, hombre, hombre corriendo, hombre corriendo: tono de piel medio, maratÃ³n, tono de piel medio
ğŸƒğŸ¾â€â™‚	carrera, correr, hombre, hombre corriendo, hombre corriendo: tono de piel oscuro medio, maratÃ³n, tono de piel oscuro medio
ğŸƒğŸ¿â€â™‚	carrera, correr, hombre, hombre corriendo, hombre corriendo: tono de piel oscuro, maratÃ³n, tono de piel oscuro
ğŸƒğŸ»â€â™€	carrera, correr, maratÃ³n, mujer, mujer corriendo, mujer corriendo: tono de piel claro, tono de piel claro
ğŸƒğŸ¼â€â™€	carrera, correr, maratÃ³n, mujer, mujer corriendo, mujer corriendo: tono de piel claro medio, tono de piel claro medio
ğŸƒğŸ½â€â™€	carrera, correr, maratÃ³n, mujer, mujer corriendo, mujer corriendo: tono de piel medio, tono de piel medio
ğŸƒğŸ¾â€â™€	carrera, correr, maratÃ³n, mujer, mujer corriendo, mujer corriendo: tono de piel oscuro medio, tono de piel oscuro medio
ğŸƒğŸ¿â€â™€	carrera, correr, maratÃ³n, mujer, mujer corriendo, mujer corriendo: tono de piel oscuro, tono de piel oscuro
ğŸ’ƒ	bailarina
ğŸ’ƒğŸ»	bailarina, bailarina: tono de piel claro, tono de piel claro
ğŸ’ƒğŸ¼	bailarina, bailarina: tono de piel claro medio, tono de piel claro medio
ğŸ’ƒğŸ½	bailarina, bailarina: tono de piel medio, tono de piel medio
ğŸ’ƒğŸ¾	bailarina, bailarina: tono de piel oscuro medio, tono de piel oscuro medio
ğŸ’ƒğŸ¿	bailarina, bailarina: tono de piel oscuro, tono de piel oscuro
ğŸ•º	bailarÃ­n
ğŸ•ºğŸ»	bailarÃ­n, bailarÃ­n: tono de piel claro, tono de piel claro
ğŸ•ºğŸ¼	bailarÃ­n, bailarÃ­n: tono de piel claro medio, tono de piel claro medio
ğŸ•ºğŸ½	bailarÃ­n, bailarÃ­n: tono de piel medio, tono de piel medio
ğŸ•ºğŸ¾	bailarÃ­n, bailarÃ­n: tono de piel oscuro medio, tono de piel oscuro medio
ğŸ•ºğŸ¿	bailarÃ­n, bailarÃ­n: tono de piel oscuro, tono de piel oscuro
ğŸ•´ğŸ»	hombre, hombre trajeado levitando, hombre trajeado levitando: tono de piel claro, levitar, negocios, tono de piel claro, traje
ğŸ•´ğŸ¼	hombre, hombre trajeado levitando, hombre trajeado levitando: tono de piel claro medio, levitar, negocios, tono de piel claro medio, traje
ğŸ•´ğŸ½	hombre, hombre trajeado levitando, hombre trajeado levitando: tono de piel medio, levitar, negocios, tono de piel medio, traje
ğŸ•´ğŸ¾	hombre, hombre trajeado levitando, hombre trajeado levitando: tono de piel oscuro medio, levitar, negocios, tono de piel oscuro medio, traje
ğŸ•´ğŸ¿	hombre, hombre trajeado levitando, hombre trajeado levitando: tono de piel oscuro, levitar, negocios, tono de piel oscuro, traje
ğŸ‘¯	conejita, conejo, mujer, mujeres de fiesta, orejas
ğŸ§–	persona en sauna
ğŸ§–ğŸ»	persona en sauna, persona en sauna: tono de piel claro, tono de piel claro
ğŸ§–ğŸ¼	persona en sauna, persona en sauna: tono de piel claro medio, tono de piel claro medio
ğŸ§–ğŸ½	persona en sauna, persona en sauna: tono de piel medio, tono de piel medio
ğŸ§–ğŸ¾	persona en sauna, persona en sauna: tono de piel oscuro medio, tono de piel oscuro medio
ğŸ§–ğŸ¿	persona en sauna, persona en sauna: tono de piel oscuro, tono de piel oscuro
ğŸ§–â€â™‚	hombre en sauna
ğŸ§–ğŸ»â€â™‚	hombre en sauna, hombre en sauna: tono de piel claro, tono de piel claro
ğŸ§–ğŸ¼â€â™‚	hombre en sauna, hombre en sauna: tono de piel claro medio, tono de piel claro medio
ğŸ§–ğŸ½â€â™‚	hombre en sauna, hombre en sauna: tono de piel medio, tono de piel medio
ğŸ§–ğŸ¾â€â™‚	hombre en sauna, hombre en sauna: tono de piel oscuro medio, tono de piel oscuro medio
ğŸ§–ğŸ¿â€â™‚	hombre en sauna, hombre en sauna: tono de piel oscuro, tono de piel oscuro
ğŸ§–â€â™€	mujer en sauna
ğŸ§–ğŸ»â€â™€	mujer en sauna, mujer en sauna: tono de piel claro, tono de piel claro
ğŸ§–ğŸ¼â€â™€	mujer en sauna, mujer en sauna: tono de piel claro medio, tono de piel claro medio
ğŸ§–ğŸ½â€â™€	mujer en sauna, mujer en sauna: tono de piel medio, tono de piel medio
ğŸ§–ğŸ¾â€â™€	mujer en sauna, mujer en sauna: tono de piel oscuro medio, tono de piel oscuro medio
ğŸ§–ğŸ¿â€â™€	mujer en sauna, mujer en sauna: tono de piel oscuro, tono de piel oscuro
ğŸ§—ğŸ»	alpinista, escalador, persona escalando, persona escalando: tono de piel claro, tono de piel claro
ğŸ§—ğŸ¼	alpinista, escalador, persona escalando, persona escalando: tono de piel claro medio, tono de piel claro medio
ğŸ§—ğŸ½	alpinista, escalador, persona escalando, persona escalando: tono de piel medio, tono de piel medio
ğŸ§—ğŸ¾	alpinista, escalador, persona escalando, persona escalando: tono de piel oscuro medio, tono de piel oscuro medio
ğŸ§—ğŸ¿	alpinista, escalador, persona escalando, persona escalando: tono de piel oscuro, tono de piel oscuro
ğŸ§—ğŸ»â€â™‚	alpinista, escalador, hombre escalando, hombre escalando: tono de piel claro, tono de piel claro
ğŸ§—ğŸ¼â€â™‚	alpinista, escalador, hombre escalando, hombre escalando: tono de piel claro medio, tono de piel claro medio
ğŸ§—ğŸ½â€â™‚	alpinista, escalador, hombre escalando, hombre escalando: tono de piel medio, tono de piel medio
ğŸ§—ğŸ¾â€â™‚	alpinista, escalador, hombre escalando, hombre escalando: tono de piel oscuro medio, tono de piel oscuro medio
ğŸ§—ğŸ¿â€â™‚	alpinista, escalador, hombre escalando, hombre escalando: tono de piel oscuro, tono de piel oscuro
ğŸ§—ğŸ»â€â™€	alpinista, escaladora, mujer escalando, mujer escalando: tono de piel claro, tono de piel claro
ğŸ§—ğŸ¼â€â™€	alpinista, escaladora, mujer escalando, mujer escalando: tono de piel claro medio, tono de piel claro medio
ğŸ§—ğŸ½â€â™€	alpinista, escaladora, mujer escalando, mujer escalando: tono de piel medio, tono de piel medio
ğŸ§—ğŸ¾â€â™€	alpinista, escaladora, mujer escalando, mujer escalando: tono de piel oscuro medio, tono de piel oscuro medio
ğŸ§—ğŸ¿â€â™€	alpinista, escaladora, mujer escalando, mujer escalando: tono de piel oscuro, tono de piel oscuro
ğŸ‡ğŸ»	caballo, caballo de carreras, carrera de caballos, carrera de caballos: tono de piel claro, carreras, jinete, tono de piel claro
ğŸ‡ğŸ¼	caballo, caballo de carreras, carrera de caballos, carrera de caballos: tono de piel claro medio, carreras, jinete, tono de piel claro medio
ğŸ‡ğŸ½	caballo, caballo de carreras, carrera de caballos, carrera de caballos: tono de piel medio, carreras, jinete, tono de piel medio
ğŸ‡ğŸ¾	caballo, caballo de carreras, carrera de caballos, carrera de caballos: tono de piel oscuro medio, carreras, jinete, tono de piel oscuro medio
ğŸ‡ğŸ¿	caballo, caballo de carreras, carrera de caballos, carrera de caballos: tono de piel oscuro, carreras, jinete, tono de piel oscuro
â›·ï¸	deporte, esquiar, esquÃ­, nieve
ğŸ‚ğŸ»	deporte, practicante de snowboard, practicante de snowboard: tono de piel claro, snowboard, tono de piel claro
ğŸ‚ğŸ¼	deporte, practicante de snowboard, practicante de snowboard: tono de piel claro medio, snowboard, tono de piel claro medio
ğŸ‚ğŸ½	deporte, practicante de snowboard, practicante de snowboard: tono de piel medio, snowboard, tono de piel medio
ğŸ‚ğŸ¾	deporte, practicante de snowboard, practicante de snowboard: tono de piel oscuro medio, snowboard, tono de piel oscuro medio
ğŸ‚ğŸ¿	deporte, practicante de snowboard, practicante de snowboard: tono de piel oscuro, snowboard, tono de piel oscuro
ğŸŒï¸	persona jugando al golf
ğŸŒğŸ»	persona jugando al golf, persona jugando al golf: tono de piel claro, tono de piel claro
ğŸŒğŸ¼	persona jugando al golf, persona jugando al golf: tono de piel claro medio, tono de piel claro medio
ğŸŒğŸ½	persona jugando al golf, persona jugando al golf: tono de piel medio, tono de piel medio
ğŸŒğŸ¾	persona jugando al golf, persona jugando al golf: tono de piel oscuro medio, tono de piel oscuro medio
ğŸŒğŸ¿	persona jugando al golf, persona jugando al golf: tono de piel oscuro, tono de piel oscuro
ğŸŒğŸ»â€â™‚	golf, hombre, hombre jugando al golf, hombre jugando al golf: tono de piel claro, jugador, tono de piel claro
ğŸŒğŸ¼â€â™‚	golf, hombre, hombre jugando al golf, hombre jugando al golf: tono de piel claro medio, jugador, tono de piel claro medio
ğŸŒğŸ½â€â™‚	golf, hombre, hombre jugando al golf, hombre jugando al golf: tono de piel medio, jugador, tono de piel medio
ğŸŒğŸ¾â€â™‚	golf, hombre, hombre jugando al golf, hombre jugando al golf: tono de piel oscuro medio, jugador, tono de piel oscuro medio
ğŸŒğŸ¿â€â™‚	golf, hombre, hombre jugando al golf, hombre jugando al golf: tono de piel oscuro, jugador, tono de piel oscuro
ğŸŒğŸ»â€â™€	golf, jugadora, mujer, mujer jugando al golf, mujer jugando al golf: tono de piel claro, tono de piel claro
ğŸŒğŸ¼â€â™€	golf, jugadora, mujer, mujer jugando al golf, mujer jugando al golf: tono de piel claro medio, tono de piel claro medio
ğŸŒğŸ½â€â™€	golf, jugadora, mujer, mujer jugando al golf, mujer jugando al golf: tono de piel medio, tono de piel medio
ğŸŒğŸ¾â€â™€	golf, jugadora, mujer, mujer jugando al golf, mujer jugando al golf: tono de piel oscuro medio, tono de piel oscuro medio
ğŸŒğŸ¿â€â™€	golf, jugadora, mujer, mujer jugando al golf, mujer jugando al golf: tono de piel oscuro, tono de piel oscuro
ğŸ„ï¸	persona haciendo surf
ğŸ„ğŸ»	persona haciendo surf, persona haciendo surf: tono de piel claro, tono de piel claro
ğŸ„ğŸ¼	persona haciendo surf, persona haciendo surf: tono de piel claro medio, tono de piel claro medio
ğŸ„ğŸ½	persona haciendo surf, persona haciendo surf: tono de piel medio, tono de piel medio
ğŸ„ğŸ¾	persona haciendo surf, persona haciendo surf: tono de piel oscuro medio, tono de piel oscuro medio
ğŸ„ğŸ¿	persona haciendo surf, persona haciendo surf: tono de piel oscuro, tono de piel oscuro
ğŸ„ğŸ»â€â™‚	hombre, hombre haciendo surf, hombre haciendo surf: tono de piel claro, surf, surfero, surfista, tono de piel claro
ğŸ„ğŸ¼â€â™‚	hombre, hombre haciendo surf, hombre haciendo surf: tono de piel claro medio, surf, surfero, surfista, tono de piel claro medio
ğŸ„ğŸ½â€â™‚	hombre, hombre haciendo surf, hombre haciendo surf: tono de piel medio, surf, surfero, surfista, tono de piel medio
ğŸ„ğŸ¾â€â™‚	hombre, hombre haciendo surf, hombre haciendo surf: tono de piel oscuro medio, surf, surfero, surfista, tono de piel oscuro medio
ğŸ„ğŸ¿â€â™‚	hombre, hombre haciendo surf, hombre haciendo surf: tono de piel oscuro, surf, surfero, surfista, tono de piel oscuro
ğŸ„ğŸ»â€â™€	mujer, mujer haciendo surf, mujer haciendo surf: tono de piel claro, surf, surfera, surfista, tono de piel claro
ğŸ„ğŸ¼â€â™€	mujer, mujer haciendo surf, mujer haciendo surf: tono de piel claro medio, surf, surfera, surfista, tono de piel claro medio
ğŸ„ğŸ½â€â™€	mujer, mujer haciendo surf, mujer haciendo surf: tono de piel medio, surf, surfera, surfista, tono de piel medio
ğŸ„ğŸ¾â€â™€	mujer, mujer haciendo surf, mujer haciendo surf: tono de piel oscuro medio, surf, surfera, surfista, tono de piel oscuro medio
ğŸ„ğŸ¿â€â™€	mujer, mujer haciendo surf, mujer haciendo surf: tono de piel oscuro, surf, surfera, surfista, tono de piel oscuro
ğŸš£ğŸ»	barca, bote, persona remando en un bote, persona remando en un bote: tono de piel claro, remo, tono de piel claro
ğŸš£ğŸ¼	barca, bote, persona remando en un bote, persona remando en un bote: tono de piel claro medio, remo, tono de piel claro medio
ğŸš£ğŸ½	barca, bote, persona remando en un bote, persona remando en un bote: tono de piel medio, remo, tono de piel medio
ğŸš£ğŸ¾	barca, bote, persona remando en un bote, persona remando en un bote: tono de piel oscuro medio, remo, tono de piel oscuro medio
ğŸš£ğŸ¿	barca, bote, persona remando en un bote, persona remando en un bote: tono de piel oscuro, remo, tono de piel oscuro
ğŸš£â€â™‚	hombre remando
ğŸš£ğŸ»â€â™‚	hombre remando, hombre remando: tono de piel claro, tono de piel claro
ğŸš£ğŸ¼â€â™‚	hombre remando, hombre remando: tono de piel claro medio, tono de piel claro medio
ğŸš£ğŸ½â€â™‚	hombre remando, hombre remando: tono de piel medio, tono de piel medio
ğŸš£ğŸ¾â€â™‚	hombre remando, hombre remando: tono de piel oscuro medio, tono de piel oscuro medio
ğŸš£ğŸ¿â€â™‚	hombre remando, hombre remando: tono de piel oscuro, tono de piel oscuro
ğŸš£â€â™€	mujer remando
ğŸš£ğŸ»â€â™€	mujer remando, mujer remando: tono de piel claro, tono de piel claro
ğŸš£ğŸ¼â€â™€	mujer remando, mujer remando: tono de piel claro medio, tono de piel claro medio
ğŸš£ğŸ½â€â™€	mujer remando, mujer remando: tono de piel medio, tono de piel medio
ğŸš£ğŸ¾â€â™€	mujer remando, mujer remando: tono de piel oscuro medio, tono de piel oscuro medio
ğŸš£ğŸ¿â€â™€	mujer remando, mujer remando: tono de piel oscuro, tono de piel oscuro
ğŸŠğŸ»	deporte, nadar, nataciÃ³n, persona nadando, persona nadando: tono de piel claro, tono de piel claro
ğŸŠğŸ¼	deporte, nadar, nataciÃ³n, persona nadando, persona nadando: tono de piel claro medio, tono de piel claro medio
ğŸŠğŸ½	deporte, nadar, nataciÃ³n, persona nadando, persona nadando: tono de piel medio, tono de piel medio
ğŸŠğŸ¾	deporte, nadar, nataciÃ³n, persona nadando, persona nadando: tono de piel oscuro medio, tono de piel oscuro medio
ğŸŠğŸ¿	deporte, nadar, nataciÃ³n, persona nadando, persona nadando: tono de piel oscuro, tono de piel oscuro
ğŸŠâ€â™‚	hombre, hombre nadando, nadar, nataciÃ³n
ğŸŠğŸ»â€â™‚	hombre, hombre nadando, hombre nadando: tono de piel claro, nadar, nataciÃ³n, tono de piel claro
ğŸŠğŸ¼â€â™‚	hombre, hombre nadando, hombre nadando: tono de piel claro medio, nadar, nataciÃ³n, tono de piel claro medio
ğŸŠğŸ½â€â™‚	hombre, hombre nadando, hombre nadando: tono de piel medio, nadar, nataciÃ³n, tono de piel medio
ğŸŠğŸ¾â€â™‚	hombre, hombre nadando, hombre nadando: tono de piel oscuro medio, nadar, nataciÃ³n, tono de piel oscuro medio
ğŸŠğŸ¿â€â™‚	hombre, hombre nadando, hombre nadando: tono de piel oscuro, nadar, nataciÃ³n, tono de piel oscuro
ğŸŠâ€â™€	mujer, mujer nadando, nadar, nataciÃ³n
ğŸŠğŸ»â€â™€	mujer, mujer nadando, mujer nadando: tono de piel claro, nadar, nataciÃ³n, tono de piel claro
ğŸŠğŸ¼â€â™€	mujer, mujer nadando, mujer nadando: tono de piel claro medio, nadar, nataciÃ³n, tono de piel claro medio
ğŸŠğŸ½â€â™€	mujer, mujer nadando, mujer nadando: tono de piel medio, nadar, nataciÃ³n, tono de piel medio
ğŸŠğŸ¾â€â™€	mujer, mujer nadando, mujer nadando: tono de piel oscuro medio, nadar, nataciÃ³n, tono de piel oscuro medio
ğŸŠğŸ¿â€â™€	mujer, mujer nadando, mujer nadando: tono de piel oscuro, nadar, nataciÃ³n, tono de piel oscuro
â›¹ï¸	persona botando un balÃ³n
â›¹ğŸ»	persona botando un balÃ³n, persona botando un balÃ³n: tono de piel claro, tono de piel claro
â›¹ğŸ¼	persona botando un balÃ³n, persona botando un balÃ³n: tono de piel claro medio, tono de piel claro medio
â›¹ğŸ½	persona botando un balÃ³n, persona botando un balÃ³n: tono de piel medio, tono de piel medio
â›¹ğŸ¾	persona botando un balÃ³n, persona botando un balÃ³n: tono de piel oscuro medio, tono de piel oscuro medio
â›¹ğŸ¿	persona botando un balÃ³n, persona botando un balÃ³n: tono de piel oscuro, tono de piel oscuro
â›¹ğŸ»â€â™‚	balÃ³n, botar, hombre, hombre botando un balÃ³n, hombre botando un balÃ³n: tono de piel claro, pelota, tono de piel claro
â›¹ğŸ¼â€â™‚	balÃ³n, botar, hombre, hombre botando un balÃ³n, hombre botando un balÃ³n: tono de piel claro medio, pelota, tono de piel claro medio
â›¹ğŸ½â€â™‚	balÃ³n, botar, hombre, hombre botando un balÃ³n, hombre botando un balÃ³n: tono de piel medio, pelota, tono de piel medio
â›¹ğŸ¾â€â™‚	balÃ³n, botar, hombre, hombre botando un balÃ³n, hombre botando un balÃ³n: tono de piel oscuro medio, pelota, tono de piel oscuro medio
â›¹ğŸ¿â€â™‚	balÃ³n, botar, hombre, hombre botando un balÃ³n, hombre botando un balÃ³n: tono de piel oscuro, pelota, tono de piel oscuro
â›¹ğŸ»â€â™€	balÃ³n, botar, mujer, mujer botando un balÃ³n, mujer botando un balÃ³n: tono de piel claro, pelota, tono de piel claro
â›¹ğŸ¼â€â™€	balÃ³n, botar, mujer, mujer botando un balÃ³n, mujer botando un balÃ³n: tono de piel claro medio, pelota, tono de piel claro medio
â›¹ğŸ½â€â™€	balÃ³n, botar, mujer, mujer botando un balÃ³n, mujer botando un balÃ³n: tono de piel medio, pelota, tono de piel medio
â›¹ğŸ¾â€â™€	balÃ³n, botar, mujer, mujer botando un balÃ³n, mujer botando un balÃ³n: tono de piel oscuro medio, pelota, tono de piel oscuro medio
â›¹ğŸ¿â€â™€	balÃ³n, botar, mujer, mujer botando un balÃ³n, mujer botando un balÃ³n: tono de piel oscuro, pelota, tono de piel oscuro
ğŸ‹ï¸	fisicoculturismo, gimnasio, gym, halterofilia, pesas
ğŸ‹ğŸ»	fisicoculturismo, gimnasio, gym, halterofilia, persona levantando pesas: tono de piel claro, pesas, tono de piel claro
ğŸ‹ğŸ¼	fisicoculturismo, gimnasio, gym, halterofilia, persona levantando pesas: tono de piel claro medio, pesas, tono de piel claro medio
ğŸ‹ğŸ½	fisicoculturismo, gimnasio, gym, halterofilia, persona levantando pesas: tono de piel medio, pesas, tono de piel medio
ğŸ‹ğŸ¾	fisicoculturismo, gimnasio, gym, halterofilia, persona levantando pesas: tono de piel oscuro medio, pesas, tono de piel oscuro medio
ğŸ‹ğŸ¿	fisicoculturismo, gimnasio, gym, halterofilia, persona levantando pesas: tono de piel oscuro, pesas, tono de piel oscuro
ğŸ‹ğŸ»â€â™‚	halterofilia, hombre, hombre levantando pesas, hombre levantando pesas: tono de piel claro, levantador de pesas, pesas, tono de piel claro
ğŸ‹ğŸ¼â€â™‚	halterofilia, hombre, hombre levantando pesas, hombre levantando pesas: tono de piel claro medio, levantador de pesas, pesas, tono de piel claro medio
ğŸ‹ğŸ½â€â™‚	halterofilia, hombre, hombre levantando pesas, hombre levantando pesas: tono de piel medio, levantador de pesas, pesas, tono de piel medio
ğŸ‹ğŸ¾â€â™‚	halterofilia, hombre, hombre levantando pesas, hombre levantando pesas: tono de piel oscuro medio, levantador de pesas, pesas, tono de piel oscuro medio
ğŸ‹ğŸ¿â€â™‚	halterofilia, hombre, hombre levantando pesas, hombre levantando pesas: tono de piel oscuro, levantador de pesas, pesas, tono de piel oscuro
ğŸ‹ğŸ»â€â™€	halterofilia, levantadora de pesas, mujer, mujer levantando pesas, mujer levantando pesas: tono de piel claro, pesas, tono de piel claro
ğŸ‹ğŸ¼â€â™€	halterofilia, levantadora de pesas, mujer, mujer levantando pesas, mujer levantando pesas: tono de piel claro medio, pesas, tono de piel claro medio
ğŸ‹ğŸ½â€â™€	halterofilia, levantadora de pesas, mujer, mujer levantando pesas, mujer levantando pesas: tono de piel medio, pesas, tono de piel medio
ğŸ‹ğŸ¾â€â™€	halterofilia, levantadora de pesas, mujer, mujer levantando pesas, mujer levantando pesas: tono de piel oscuro medio, pesas, tono de piel oscuro medio
ğŸ‹ğŸ¿â€â™€	halterofilia, levantadora de pesas, mujer, mujer levantando pesas, mujer levantando pesas: tono de piel oscuro, pesas, tono de piel oscuro
ğŸš´ğŸ»	bicicleta, ciclismo, ciclista, persona en bicicleta, persona en bicicleta: tono de piel claro, tono de piel claro
ğŸš´ğŸ¼	bicicleta, ciclismo, ciclista, persona en bicicleta, persona en bicicleta: tono de piel claro medio, tono de piel claro medio
ğŸš´ğŸ½	bicicleta, ciclismo, ciclista, persona en bicicleta, persona en bicicleta: tono de piel medio, tono de piel medio
ğŸš´ğŸ¾	bicicleta, ciclismo, ciclista, persona en bicicleta, persona en bicicleta: tono de piel oscuro medio, tono de piel oscuro medio
ğŸš´ğŸ¿	bicicleta, ciclismo, ciclista, persona en bicicleta, persona en bicicleta: tono de piel oscuro, tono de piel oscuro
ğŸš´ğŸ»â€â™‚	bicicleta, ciclismo, ciclista, hombre, hombre en bicicleta, hombre en bicicleta: tono de piel claro, tono de piel claro
ğŸš´ğŸ¼â€â™‚	bicicleta, ciclismo, ciclista, hombre, hombre en bicicleta, hombre en bicicleta: tono de piel claro medio, tono de piel claro medio
ğŸš´ğŸ½â€â™‚	bicicleta, ciclismo, ciclista, hombre, hombre en bicicleta, hombre en bicicleta: tono de piel medio, tono de piel medio
ğŸš´ğŸ¾â€â™‚	bicicleta, ciclismo, ciclista, hombre, hombre en bicicleta, hombre en bicicleta: tono de piel oscuro medio, tono de piel oscuro medio
ğŸš´ğŸ¿â€â™‚	bicicleta, ciclismo, ciclista, hombre, hombre en bicicleta, hombre en bicicleta: tono de piel oscuro, tono de piel oscuro
ğŸš´ğŸ»â€â™€	bicicleta, ciclismo, ciclista, mujer, mujer en bicicleta, mujer en bicicleta: tono de piel claro, tono de piel claro
ğŸš´ğŸ¼â€â™€	bicicleta, ciclismo, ciclista, mujer, mujer en bicicleta, mujer en bicicleta: tono de piel claro medio, tono de piel claro medio
ğŸš´ğŸ½â€â™€	bicicleta, ciclismo, ciclista, mujer, mujer en bicicleta, mujer en bicicleta: tono de piel medio, tono de piel medio
ğŸš´ğŸ¾â€â™€	bicicleta, ciclismo, ciclista, mujer, mujer en bicicleta, mujer en bicicleta: tono de piel oscuro medio, tono de piel oscuro medio
ğŸš´ğŸ¿â€â™€	bicicleta, ciclismo, ciclista, mujer, mujer en bicicleta, mujer en bicicleta: tono de piel oscuro, tono de piel oscuro
ğŸšµ	bicicleta, ciclismo de montaÃ±a, ciclista, montaÃ±a
ğŸšµğŸ»	bicicleta, ciclismo de montaÃ±a, ciclista, montaÃ±a, persona en bicicleta de montaÃ±a: tono de piel claro, tono de piel claro
ğŸšµğŸ¼	bicicleta, ciclismo de montaÃ±a, ciclista, montaÃ±a, persona en bicicleta de montaÃ±a: tono de piel claro medio, tono de piel claro medio
ğŸšµğŸ½	bicicleta, ciclismo de montaÃ±a, ciclista, montaÃ±a, persona en bicicleta de montaÃ±a: tono de piel medio, tono de piel medio
ğŸšµğŸ¾	bicicleta, ciclismo de montaÃ±a, ciclista, montaÃ±a, persona en bicicleta de montaÃ±a: tono de piel oscuro medio, tono de piel oscuro medio
ğŸšµğŸ¿	bicicleta, ciclismo de montaÃ±a, ciclista, montaÃ±a, persona en bicicleta de montaÃ±a: tono de piel oscuro, tono de piel oscuro
ğŸšµğŸ»â€â™‚	bicicleta, ciclista, hombre en bicicleta de montaÃ±a, hombre en bicicleta de montaÃ±a: tono de piel claro, montaÃ±a, mountain bike, tono de piel claro
ğŸšµğŸ¼â€â™‚	bicicleta, ciclista, hombre en bicicleta de montaÃ±a, hombre en bicicleta de montaÃ±a: tono de piel claro medio, montaÃ±a, mountain bike, tono de piel claro medio
ğŸšµğŸ½â€â™‚	bicicleta, ciclista, hombre en bicicleta de montaÃ±a, hombre en bicicleta de montaÃ±a: tono de piel medio, montaÃ±a, mountain bike, tono de piel medio
ğŸšµğŸ¾â€â™‚	bicicleta, ciclista, hombre en bicicleta de montaÃ±a, hombre en bicicleta de montaÃ±a: tono de piel oscuro medio, montaÃ±a, mountain bike, tono de piel oscuro medio
ğŸšµğŸ¿â€â™‚	bicicleta, ciclista, hombre en bicicleta de montaÃ±a, hombre en bicicleta de montaÃ±a: tono de piel oscuro, montaÃ±a, mountain bike, tono de piel oscuro
ğŸšµğŸ»â€â™€	bicicleta, ciclista, montaÃ±a, mountain bike, mujer en bicicleta de montaÃ±a, mujer en bicicleta de montaÃ±a: tono de piel claro, tono de piel claro
ğŸšµğŸ¼â€â™€	bicicleta, ciclista, montaÃ±a, mountain bike, mujer en bicicleta de montaÃ±a, mujer en bicicleta de montaÃ±a: tono de piel claro medio, tono de piel claro medio
ğŸšµğŸ½â€â™€	bicicleta, ciclista, montaÃ±a, mountain bike, mujer en bicicleta de montaÃ±a, mujer en bicicleta de montaÃ±a: tono de piel medio, tono de piel medio
ğŸšµğŸ¾â€â™€	bicicleta, ciclista, montaÃ±a, mountain bike, mujer en bicicleta de montaÃ±a, mujer en bicicleta de montaÃ±a: tono de piel oscuro medio, tono de piel oscuro medio
ğŸšµğŸ¿â€â™€	bicicleta, ciclista, montaÃ±a, mountain bike, mujer en bicicleta de montaÃ±a, mujer en bicicleta de montaÃ±a: tono de piel oscuro, tono de piel oscuro
ğŸ¤¸	persona haciendo una vuelta de carro
ğŸ¤¸ğŸ»	persona haciendo una vuelta de carro, persona haciendo una vuelta de carro: tono de piel claro, tono de piel claro
ğŸ¤¸ğŸ¼	persona haciendo una vuelta de carro, persona haciendo una vuelta de carro: tono de piel claro medio, tono de piel claro medio
ğŸ¤¸ğŸ½	persona haciendo una vuelta de carro, persona haciendo una vuelta de carro: tono de piel medio, tono de piel medio
ğŸ¤¸ğŸ¾	persona haciendo una vuelta de carro, persona haciendo una vuelta de carro: tono de piel oscuro medio, tono de piel oscuro medio
ğŸ¤¸ğŸ¿	persona haciendo una vuelta de carro, persona haciendo una vuelta de carro: tono de piel oscuro, tono de piel oscuro
ğŸ¤¸â€â™‚	hombre haciendo una vuelta de carro
ğŸ¤¸ğŸ»â€â™‚	hombre haciendo una vuelta de carro, hombre haciendo una vuelta de carro: tono de piel claro, tono de piel claro
ğŸ¤¸ğŸ¼â€â™‚	hombre haciendo una vuelta de carro, hombre haciendo una vuelta de carro: tono de piel claro medio, tono de piel claro medio
ğŸ¤¸ğŸ½â€â™‚	hombre haciendo una vuelta de carro, hombre haciendo una vuelta de carro: tono de piel medio, tono de piel medio
ğŸ¤¸ğŸ¾â€â™‚	hombre haciendo una vuelta de carro, hombre haciendo una vuelta de carro: tono de piel oscuro medio, tono de piel oscuro medio
ğŸ¤¸ğŸ¿â€â™‚	hombre haciendo una vuelta de carro, hombre haciendo una vuelta de carro: tono de piel oscuro, tono de piel oscuro
ğŸ¤¸â€â™€	mujer haciendo una vuelta de carro
ğŸ¤¸ğŸ»â€â™€	mujer haciendo una vuelta de carro, mujer haciendo una vuelta de carro: tono de piel claro, tono de piel claro
ğŸ¤¸ğŸ¼â€â™€	mujer haciendo una vuelta de carro, mujer haciendo una vuelta de carro: tono de piel claro medio, tono de piel claro medio
ğŸ¤¸ğŸ½â€â™€	mujer haciendo una vuelta de carro, mujer haciendo una vuelta de carro: tono de piel medio, tono de piel medio
ğŸ¤¸ğŸ¾â€â™€	mujer haciendo una vuelta de carro, mujer haciendo una vuelta de carro: tono de piel oscuro medio, tono de piel oscuro medio
ğŸ¤¸ğŸ¿â€â™€	mujer haciendo una vuelta de carro, mujer haciendo una vuelta de carro: tono de piel oscuro, tono de piel oscuro
ğŸ¤½	deporte acuÃ¡tico, deportista, persona, waterpolo
ğŸ¤½ğŸ»	deporte acuÃ¡tico, deportista, persona, persona jugando al waterpolo: tono de piel claro, tono de piel claro, waterpolo
ğŸ¤½ğŸ¼	deporte acuÃ¡tico, deportista, persona, persona jugando al waterpolo: tono de piel claro medio, tono de piel claro medio, waterpolo
ğŸ¤½ğŸ½	deporte acuÃ¡tico, deportista, persona, persona jugando al waterpolo: tono de piel medio, tono de piel medio, waterpolo
ğŸ¤½ğŸ¾	deporte acuÃ¡tico, deportista, persona, persona jugando al waterpolo: tono de piel oscuro medio, tono de piel oscuro medio, waterpolo
ğŸ¤½ğŸ¿	deporte acuÃ¡tico, deportista, persona, persona jugando al waterpolo: tono de piel oscuro, tono de piel oscuro, waterpolo
ğŸ¤½ğŸ»â€â™‚	agua, deporte, hombre jugando al waterpolo, hombre jugando al waterpolo: tono de piel claro, tono de piel claro, waterpolista, waterpolo
ğŸ¤½ğŸ¼â€â™‚	agua, deporte, hombre jugando al waterpolo, hombre jugando al waterpolo: tono de piel claro medio, tono de piel claro medio, waterpolista, waterpolo
ğŸ¤½ğŸ½â€â™‚	agua, deporte, hombre jugando al waterpolo, hombre jugando al waterpolo: tono de piel medio, tono de piel medio, waterpolista, waterpolo
ğŸ¤½ğŸ¾â€â™‚	agua, deporte, hombre jugando al waterpolo, hombre jugando al waterpolo: tono de piel oscuro medio, tono de piel oscuro medio, waterpolista, waterpolo
ğŸ¤½ğŸ¿â€â™‚	agua, deporte, hombre jugando al waterpolo, hombre jugando al waterpolo: tono de piel oscuro, tono de piel oscuro, waterpolista, waterpolo
ğŸ¤½ğŸ»â€â™€	agua, deporte, mujer jugando al waterpolo, mujer jugando al waterpolo: tono de piel claro, tono de piel claro, waterpolista, waterpolo
ğŸ¤½ğŸ¼â€â™€	agua, deporte, mujer jugando al waterpolo, mujer jugando al waterpolo: tono de piel claro medio, tono de piel claro medio, waterpolista, waterpolo
ğŸ¤½ğŸ½â€â™€	agua, deporte, mujer jugando al waterpolo, mujer jugando al waterpolo: tono de piel medio, tono de piel medio, waterpolista, waterpolo
ğŸ¤½ğŸ¾â€â™€	agua, deporte, mujer jugando al waterpolo, mujer jugando al waterpolo: tono de piel oscuro medio, tono de piel oscuro medio, waterpolista, waterpolo
ğŸ¤½ğŸ¿â€â™€	agua, deporte, mujer jugando al waterpolo, mujer jugando al waterpolo: tono de piel oscuro, tono de piel oscuro, waterpolista, waterpolo
ğŸ¤¾ğŸ»	balonmanista, balonmano, deporte, persona, persona jugando al balonmano, persona jugando al balonmano: tono de piel claro, tono de piel claro
ğŸ¤¾ğŸ¼	balonmanista, balonmano, deporte, persona, persona jugando al balonmano, persona jugando al balonmano: tono de piel claro medio, tono de piel claro medio
ğŸ¤¾ğŸ½	balonmanista, balonmano, deporte, persona, persona jugando al balonmano, persona jugando al balonmano: tono de piel medio, tono de piel medio
ğŸ¤¾ğŸ¾	balonmanista, balonmano, deporte, persona, persona jugando al balonmano, persona jugando al balonmano: tono de piel oscuro medio, tono de piel oscuro medio
ğŸ¤¾ğŸ¿	balonmanista, balonmano, deporte, persona, persona jugando al balonmano, persona jugando al balonmano: tono de piel oscuro, tono de piel oscuro
ğŸ¤¾ğŸ»â€â™‚	balonmanista, balonmano, deporte, hombre, hombre jugando al balonmano, hombre jugando al balonmano: tono de piel claro, tono de piel claro
ğŸ¤¾ğŸ¼â€â™‚	balonmanista, balonmano, deporte, hombre, hombre jugando al balonmano, hombre jugando al balonmano: tono de piel claro medio, tono de piel claro medio
ğŸ¤¾ğŸ½â€â™‚	balonmanista, balonmano, deporte, hombre, hombre jugando al balonmano, hombre jugando al balonmano: tono de piel medio, tono de piel medio
ğŸ¤¾ğŸ¾â€â™‚	balonmanista, balonmano, deporte, hombre, hombre jugando al balonmano, hombre jugando al balonmano: tono de piel oscuro medio, tono de piel oscuro medio
ğŸ¤¾ğŸ¿â€â™‚	balonmanista, balonmano, deporte, hombre, hombre jugando al balonmano, hombre jugando al balonmano: tono de piel oscuro, tono de piel oscuro
ğŸ¤¾ğŸ»â€â™€	balonmanista, balonmano, deporte, mujer, mujer jugando al balonmano, mujer jugando al balonmano: tono de piel claro, tono de piel claro
ğŸ¤¾ğŸ¼â€â™€	balonmanista, balonmano, deporte, mujer, mujer jugando al balonmano, mujer jugando al balonmano: tono de piel claro medio, tono de piel claro medio
ğŸ¤¾ğŸ½â€â™€	balonmanista, balonmano, deporte, mujer, mujer jugando al balonmano, mujer jugando al balonmano: tono de piel medio, tono de piel medio
ğŸ¤¾ğŸ¾â€â™€	balonmanista, balonmano, deporte, mujer, mujer jugando al balonmano, mujer jugando al balonmano: tono de piel oscuro medio, tono de piel oscuro medio
ğŸ¤¾ğŸ¿â€â™€	balonmanista, balonmano, deporte, mujer, mujer jugando al balonmano, mujer jugando al balonmano: tono de piel oscuro, tono de piel oscuro
ğŸ¤¹	malabarista
ğŸ¤¹ğŸ»	malabarista, malabarista: tono de piel claro, tono de piel claro
ğŸ¤¹ğŸ¼	malabarista, malabarista: tono de piel claro medio, tono de piel claro medio
ğŸ¤¹ğŸ½	malabarista, malabarista: tono de piel medio, tono de piel medio
ğŸ¤¹ğŸ¾	malabarista, malabarista: tono de piel oscuro medio, tono de piel oscuro medio
ğŸ¤¹ğŸ¿	malabarista, malabarista: tono de piel oscuro, tono de piel oscuro
ğŸ¤¹ğŸ»â€â™‚	hombre, hombre haciendo malabares, hombre haciendo malabares: tono de piel claro, malabares, malabarismo, malabarista, tono de piel claro
ğŸ¤¹ğŸ¼â€â™‚	hombre, hombre haciendo malabares, hombre haciendo malabares: tono de piel claro medio, malabares, malabarismo, malabarista, tono de piel claro medio
ğŸ¤¹ğŸ½â€â™‚	hombre, hombre haciendo malabares, hombre haciendo malabares: tono de piel medio, malabares, malabarismo, malabarista, tono de piel medio
ğŸ¤¹ğŸ¾â€â™‚	hombre, hombre haciendo malabares, hombre haciendo malabares: tono de piel oscuro medio, malabares, malabarismo, malabarista, tono de piel oscuro medio
ğŸ¤¹ğŸ¿â€â™‚	hombre, hombre haciendo malabares, hombre haciendo malabares: tono de piel oscuro, malabares, malabarismo, malabarista, tono de piel oscuro
ğŸ¤¹ğŸ»â€â™€	malabares, malabarismo, malabarista, mujer, mujer haciendo malabares, mujer haciendo malabares: tono de piel claro, tono de piel claro
ğŸ¤¹ğŸ¼â€â™€	malabares, malabarismo, malabarista, mujer, mujer haciendo malabares, mujer haciendo malabares: tono de piel claro medio, tono de piel claro medio
ğŸ¤¹ğŸ½â€â™€	malabares, malabarismo, malabarista, mujer, mujer haciendo malabares, mujer haciendo malabares: tono de piel medio, tono de piel medio
ğŸ¤¹ğŸ¾â€â™€	malabares, malabarismo, malabarista, mujer, mujer haciendo malabares, mujer haciendo malabares: tono de piel oscuro medio, tono de piel oscuro medio
ğŸ¤¹ğŸ¿â€â™€	malabares, malabarismo, malabarista, mujer, mujer haciendo malabares, mujer haciendo malabares: tono de piel oscuro, tono de piel oscuro
ğŸ§˜ğŸ»	meditaciÃ³n, persona en posiciÃ³n de loto, persona en posiciÃ³n de loto: tono de piel claro, tono de piel claro, yoga
ğŸ§˜ğŸ¼	meditaciÃ³n, persona en posiciÃ³n de loto, persona en posiciÃ³n de loto: tono de piel claro medio, tono de piel claro medio, yoga
ğŸ§˜ğŸ½	meditaciÃ³n, persona en posiciÃ³n de loto, persona en posiciÃ³n de loto: tono de piel medio, tono de piel medio, yoga
ğŸ§˜ğŸ¾	meditaciÃ³n, persona en posiciÃ³n de loto, persona en posiciÃ³n de loto: tono de piel oscuro medio, tono de piel oscuro medio, yoga
ğŸ§˜ğŸ¿	meditaciÃ³n, persona en posiciÃ³n de loto, persona en posiciÃ³n de loto: tono de piel oscuro, tono de piel oscuro, yoga
ğŸ§˜ğŸ»â€â™‚	hombre en posiciÃ³n de loto, hombre en posiciÃ³n de loto: tono de piel claro, meditaciÃ³n, tono de piel claro, yoga
ğŸ§˜ğŸ¼â€â™‚	hombre en posiciÃ³n de loto, hombre en posiciÃ³n de loto: tono de piel claro medio, meditaciÃ³n, tono de piel claro medio, yoga
ğŸ§˜ğŸ½â€â™‚	hombre en posiciÃ³n de loto, hombre en posiciÃ³n de loto: tono de piel medio, meditaciÃ³n, tono de piel medio, yoga
ğŸ§˜ğŸ¾â€â™‚	hombre en posiciÃ³n de loto, hombre en posiciÃ³n de loto: tono de piel oscuro medio, meditaciÃ³n, tono de piel oscuro medio, yoga
ğŸ§˜ğŸ¿â€â™‚	hombre en posiciÃ³n de loto, hombre en posiciÃ³n de loto: tono de piel oscuro, meditaciÃ³n, tono de piel oscuro, yoga
ğŸ§˜ğŸ»â€â™€	meditaciÃ³n, mujer en posiciÃ³n de loto, mujer en posiciÃ³n de loto: tono de piel claro, tono de piel claro, yoga
ğŸ§˜ğŸ¼â€â™€	meditaciÃ³n, mujer en posiciÃ³n de loto, mujer en posiciÃ³n de loto: tono de piel claro medio, tono de piel claro medio, yoga
ğŸ§˜ğŸ½â€â™€	meditaciÃ³n, mujer en posiciÃ³n de loto, mujer en posiciÃ³n de loto: tono de piel medio, tono de piel medio, yoga
ğŸ§˜ğŸ¾â€â™€	meditaciÃ³n, mujer en posiciÃ³n de loto, mujer en posiciÃ³n de loto: tono de piel oscuro medio, tono de piel oscuro medio, yoga
ğŸ§˜ğŸ¿â€â™€	meditaciÃ³n, mujer en posiciÃ³n de loto, mujer en posiciÃ³n de loto: tono de piel oscuro, tono de piel oscuro, yoga
ğŸ›€	persona en tina
ğŸ›€ğŸ»	persona en tina, persona en tina: tono de piel claro, tono de piel claro
ğŸ›€ğŸ¼	persona en tina, persona en tina: tono de piel claro medio, tono de piel claro medio
ğŸ›€ğŸ½	persona en tina, persona en tina: tono de piel medio, tono de piel medio
ğŸ›€ğŸ¾	persona en tina, persona en tina: tono de piel oscuro medio, tono de piel oscuro medio
ğŸ›€ğŸ¿	persona en tina, persona en tina: tono de piel oscuro, tono de piel oscuro
ğŸ›ŒğŸ»	dormir, hotel, persona en la cama, persona en la cama: tono de piel claro, tono de piel claro
ğŸ›ŒğŸ¼	dormir, hotel, persona en la cama, persona en la cama: tono de piel claro medio, tono de piel claro medio
ğŸ›ŒğŸ½	dormir, hotel, persona en la cama, persona en la cama: tono de piel medio, tono de piel medio
ğŸ›ŒğŸ¾	dormir, hotel, persona en la cama, persona en la cama: tono de piel oscuro medio, tono de piel oscuro medio
ğŸ›ŒğŸ¿	dormir, hotel, persona en la cama, persona en la cama: tono de piel oscuro, tono de piel oscuro
ğŸ§‘ğŸ»â€ğŸ¤â€ğŸ§‘ğŸ»	dos personas dÃ¡ndose la mano, dos personas dÃ¡ndose la mano: tono de piel claro, tono de piel claro
ğŸ§‘ğŸ¼â€ğŸ¤â€ğŸ§‘ğŸ»	dos personas dÃ¡ndose la mano, dos personas dÃ¡ndose la mano: tono de piel claro medio y tono de piel claro, tono de piel claro, tono de piel claro medio
ğŸ§‘ğŸ¼â€ğŸ¤â€ğŸ§‘ğŸ¼	dos personas dÃ¡ndose la mano, dos personas dÃ¡ndose la mano: tono de piel claro medio, tono de piel claro medio
ğŸ§‘ğŸ½â€ğŸ¤â€ğŸ§‘ğŸ»	dos personas dÃ¡ndose la mano, dos personas dÃ¡ndose la mano: tono de piel medio y tono de piel claro, tono de piel claro, tono de piel medio
ğŸ§‘ğŸ½â€ğŸ¤â€ğŸ§‘ğŸ¼	dos personas dÃ¡ndose la mano, dos personas dÃ¡ndose la mano: tono de piel medio y tono de piel claro medio, tono de piel claro medio, tono de piel medio
ğŸ§‘ğŸ½â€ğŸ¤â€ğŸ§‘ğŸ½	dos personas dÃ¡ndose la mano, dos personas dÃ¡ndose la mano: tono de piel medio, tono de piel medio
ğŸ§‘ğŸ¾â€ğŸ¤â€ğŸ§‘ğŸ»	dos personas dÃ¡ndose la mano, dos personas dÃ¡ndose la mano: tono de piel oscuro medio y tono de piel claro, tono de piel claro, tono de piel oscuro medio
ğŸ§‘ğŸ¾â€ğŸ¤â€ğŸ§‘ğŸ¼	dos personas dÃ¡ndose la mano, dos personas dÃ¡ndose la mano: tono de piel oscuro medio y tono de piel claro medio, tono de piel claro medio, tono de piel oscuro medio
ğŸ§‘ğŸ¾â€ğŸ¤â€ğŸ§‘ğŸ½	dos personas dÃ¡ndose la mano, dos personas dÃ¡ndose la mano: tono de piel oscuro medio y tono de piel medio, tono de piel medio, tono de piel oscuro medio
ğŸ§‘ğŸ¾â€ğŸ¤â€ğŸ§‘ğŸ¾	dos personas dÃ¡ndose la mano, dos personas dÃ¡ndose la mano: tono de piel oscuro medio, tono de piel oscuro medio
ğŸ§‘ğŸ¿â€ğŸ¤â€ğŸ§‘ğŸ»	dos personas dÃ¡ndose la mano, dos personas dÃ¡ndose la mano: tono de piel oscuro y tono de piel claro, tono de piel claro, tono de piel oscuro
ğŸ§‘ğŸ¿â€ğŸ¤â€ğŸ§‘ğŸ¼	dos personas dÃ¡ndose la mano, dos personas dÃ¡ndose la mano: tono de piel oscuro y tono de piel claro medio, tono de piel claro medio, tono de piel oscuro
ğŸ§‘ğŸ¿â€ğŸ¤â€ğŸ§‘ğŸ½	dos personas dÃ¡ndose la mano, dos personas dÃ¡ndose la mano: tono de piel oscuro y tono de piel medio, tono de piel medio, tono de piel oscuro
ğŸ§‘ğŸ¿â€ğŸ¤â€ğŸ§‘ğŸ¾	dos personas dÃ¡ndose la mano, dos personas dÃ¡ndose la mano: tono de piel oscuro y tono de piel oscuro medio, tono de piel oscuro, tono de piel oscuro medio
ğŸ§‘ğŸ¿â€ğŸ¤â€ğŸ§‘ğŸ¿	dos personas dÃ¡ndose la mano, dos personas dÃ¡ndose la mano: tono de piel oscuro, tono de piel oscuro
ğŸ‘­	amor, gemelas, mujeres, pareja
ğŸ‘­ğŸ»	amor, gemelas, mujeres, mujeres de la mano: tono de piel claro, pareja, tono de piel claro
ğŸ‘©ğŸ¼â€ğŸ¤â€ğŸ‘©ğŸ»	amor, gemelas, mujeres, mujeres de la mano: tono de piel claro medio y tono de piel claro, pareja, tono de piel claro, tono de piel claro medio
ğŸ‘­ğŸ¼	amor, gemelas, mujeres, mujeres de la mano: tono de piel claro medio, pareja, tono de piel claro medio
ğŸ‘©ğŸ½â€ğŸ¤â€ğŸ‘©ğŸ»	amor, gemelas, mujeres, mujeres de la mano: tono de piel medio y tono de piel claro, pareja, tono de piel claro, tono de piel medio
ğŸ‘©ğŸ½â€ğŸ¤â€ğŸ‘©ğŸ¼	amor, gemelas, mujeres, mujeres de la mano: tono de piel medio y tono de piel claro medio, pareja, tono de piel claro medio, tono de piel medio
ğŸ‘­ğŸ½	amor, gemelas, mujeres, mujeres de la mano: tono de piel medio, pareja, tono de piel medio
ğŸ‘©ğŸ¾â€ğŸ¤â€ğŸ‘©ğŸ»	amor, gemelas, mujeres, mujeres de la mano: tono de piel oscuro medio y tono de piel claro, pareja, tono de piel claro, tono de piel oscuro medio
ğŸ‘©ğŸ¾â€ğŸ¤â€ğŸ‘©ğŸ¼	amor, gemelas, mujeres, mujeres de la mano: tono de piel oscuro medio y tono de piel claro medio, pareja, tono de piel claro medio, tono de piel oscuro medio
ğŸ‘©ğŸ¾â€ğŸ¤â€ğŸ‘©ğŸ½	amor, gemelas, mujeres, mujeres de la mano: tono de piel oscuro medio y tono de piel medio, pareja, tono de piel medio, tono de piel oscuro medio
ğŸ‘­ğŸ¾	amor, gemelas, mujeres, mujeres de la mano: tono de piel oscuro medio, pareja, tono de piel oscuro medio
ğŸ‘©ğŸ¿â€ğŸ¤â€ğŸ‘©ğŸ»	amor, gemelas, mujeres, mujeres de la mano: tono de piel oscuro y tono de piel claro, pareja, tono de piel claro, tono de piel oscuro
ğŸ‘©ğŸ¿â€ğŸ¤â€ğŸ‘©ğŸ¼	amor, gemelas, mujeres, mujeres de la mano: tono de piel oscuro y tono de piel claro medio, pareja, tono de piel claro medio, tono de piel oscuro
ğŸ‘©ğŸ¿â€ğŸ¤â€ğŸ‘©ğŸ½	amor, gemelas, mujeres, mujeres de la mano: tono de piel oscuro y tono de piel medio, pareja, tono de piel medio, tono de piel oscuro
ğŸ‘©ğŸ¿â€ğŸ¤â€ğŸ‘©ğŸ¾	amor, gemelas, mujeres, mujeres de la mano: tono de piel oscuro y tono de piel oscuro medio, pareja, tono de piel oscuro, tono de piel oscuro medio
ğŸ‘­ğŸ¿	amor, gemelas, mujeres, mujeres de la mano: tono de piel oscuro, pareja, tono de piel oscuro
ğŸ‘«ğŸ»	hombre, hombre y mujer de la mano, mujer, mujer y hombre de la mano, mujer y hombre de la mano: tono de piel claro, novios, pareja, tono de piel claro
ğŸ‘©ğŸ»â€ğŸ¤â€ğŸ‘¨ğŸ¼	hombre, hombre y mujer de la mano, mujer, mujer y hombre de la mano, mujer y hombre de la mano: tono de piel claro y tono de piel claro medio, novios, pareja, tono de piel claro, tono de piel claro medio
ğŸ‘©ğŸ»â€ğŸ¤â€ğŸ‘¨ğŸ½	hombre, hombre y mujer de la mano, mujer, mujer y hombre de la mano, mujer y hombre de la mano: tono de piel claro y tono de piel medio, novios, pareja, tono de piel claro, tono de piel medio
ğŸ‘©ğŸ»â€ğŸ¤â€ğŸ‘¨ğŸ¾	hombre, hombre y mujer de la mano, mujer, mujer y hombre de la mano, mujer y hombre de la mano: tono de piel claro y tono de piel oscuro medio, novios, pareja, tono de piel claro, tono de piel oscuro medio
ğŸ‘©ğŸ»â€ğŸ¤â€ğŸ‘¨ğŸ¿	hombre, hombre y mujer de la mano, mujer, mujer y hombre de la mano, mujer y hombre de la mano: tono de piel claro y tono de piel oscuro, novios, pareja, tono de piel claro, tono de piel oscuro
ğŸ‘©ğŸ¼â€ğŸ¤â€ğŸ‘¨ğŸ»	hombre, hombre y mujer de la mano, mujer, mujer y hombre de la mano, mujer y hombre de la mano: tono de piel claro medio y tono de piel claro, novios, pareja, tono de piel claro, tono de piel claro medio
ğŸ‘«ğŸ¼	hombre, hombre y mujer de la mano, mujer, mujer y hombre de la mano, mujer y hombre de la mano: tono de piel claro medio, novios, pareja, tono de piel claro medio
ğŸ‘©ğŸ¼â€ğŸ¤â€ğŸ‘¨ğŸ½	hombre, hombre y mujer de la mano, mujer, mujer y hombre de la mano, mujer y hombre de la mano: tono de piel claro medio y tono de piel medio, novios, pareja, tono de piel claro medio, tono de piel medio
ğŸ‘©ğŸ¼â€ğŸ¤â€ğŸ‘¨ğŸ¾	hombre, hombre y mujer de la mano, mujer, mujer y hombre de la mano, mujer y hombre de la mano: tono de piel claro medio y tono de piel oscuro medio, novios, pareja, tono de piel claro medio, tono de piel oscuro medio
ğŸ‘©ğŸ¼â€ğŸ¤â€ğŸ‘¨ğŸ¿	hombre, hombre y mujer de la mano, mujer, mujer y hombre de la mano, mujer y hombre de la mano: tono de piel claro medio y tono de piel oscuro, novios, pareja, tono de piel claro medio, tono de piel oscuro
ğŸ‘©ğŸ½â€ğŸ¤â€ğŸ‘¨ğŸ»	hombre, hombre y mujer de la mano, mujer, mujer y hombre de la mano, mujer y hombre de la mano: tono de piel medio y tono de piel claro, novios, pareja, tono de piel claro, tono de piel medio
ğŸ‘©ğŸ½â€ğŸ¤â€ğŸ‘¨ğŸ¼	hombre, hombre y mujer de la mano, mujer, mujer y hombre de la mano, mujer y hombre de la mano: tono de piel medio y tono de piel claro medio, novios, pareja, tono de piel claro medio, tono de piel medio
ğŸ‘«ğŸ½	hombre, hombre y mujer de la mano, mujer, mujer y hombre de la mano, mujer y hombre de la mano: tono de piel medio, novios, pareja, tono de piel medio
ğŸ‘©ğŸ½â€ğŸ¤â€ğŸ‘¨ğŸ¾	hombre, hombre y mujer de la mano, mujer, mujer y hombre de la mano, mujer y hombre de la mano: tono de piel medio y tono de piel oscuro medio, novios, pareja, tono de piel medio, tono de piel oscuro medio
ğŸ‘©ğŸ½â€ğŸ¤â€ğŸ‘¨ğŸ¿	hombre, hombre y mujer de la mano, mujer, mujer y hombre de la mano, mujer y hombre de la mano: tono de piel medio y tono de piel oscuro, novios, pareja, tono de piel medio, tono de piel oscuro
ğŸ‘©ğŸ¾â€ğŸ¤â€ğŸ‘¨ğŸ»	hombre, hombre y mujer de la mano, mujer, mujer y hombre de la mano, mujer y hombre de la mano: tono de piel oscuro medio y tono de piel claro, novios, pareja, tono de piel claro, tono de piel oscuro medio
ğŸ‘©ğŸ¾â€ğŸ¤â€ğŸ‘¨ğŸ¼	hombre, hombre y mujer de la mano, mujer, mujer y hombre de la mano, mujer y hombre de la mano: tono de piel oscuro medio y tono de piel claro medio, novios, pareja, tono de piel claro medio, tono de piel oscuro medio
ğŸ‘©ğŸ¾â€ğŸ¤â€ğŸ‘¨ğŸ½	hombre, hombre y mujer de la mano, mujer, mujer y hombre de la mano, mujer y hombre de la mano: tono de piel oscuro medio y tono de piel medio, novios, pareja, tono de piel medio, tono de piel oscuro medio
ğŸ‘«ğŸ¾	hombre, hombre y mujer de la mano, mujer, mujer y hombre de la mano, mujer y hombre de la mano: tono de piel oscuro medio, novios, pareja, tono de piel oscuro medio
ğŸ‘©ğŸ¾â€ğŸ¤â€ğŸ‘¨ğŸ¿	hombre, hombre y mujer de la mano, mujer, mujer y hombre de la mano, mujer y hombre de la mano: tono de piel oscuro medio y tono de piel oscuro, novios, pareja, tono de piel oscuro, tono de piel oscuro medio
ğŸ‘©ğŸ¿â€ğŸ¤â€ğŸ‘¨ğŸ»	hombre, hombre y mujer de la mano, mujer, mujer y hombre de la mano, mujer y hombre de la mano: tono de piel oscuro y tono de piel claro, novios, pareja, tono de piel claro, tono de piel oscuro
ğŸ‘©ğŸ¿â€ğŸ¤â€ğŸ‘¨ğŸ¼	hombre, hombre y mujer de la mano, mujer, mujer y hombre de la mano, mujer y hombre de la mano: tono de piel oscuro y tono de piel claro medio, novios, pareja, tono de piel claro medio, tono de piel oscuro
ğŸ‘©ğŸ¿â€ğŸ¤â€ğŸ‘¨ğŸ½	hombre, hombre y mujer de la mano, mujer, mujer y hombre de la mano, mujer y hombre de la mano: tono de piel oscuro y tono de piel medio, novios, pareja, tono de piel medio, tono de piel oscuro
ğŸ‘©ğŸ¿â€ğŸ¤â€ğŸ‘¨ğŸ¾	hombre, hombre y mujer de la mano, mujer, mujer y hombre de la mano, mujer y hombre de la mano: tono de piel oscuro y tono de piel oscuro medio, novios, pareja, tono de piel oscuro, tono de piel oscuro medio
ğŸ‘«ğŸ¿	hombre, hombre y mujer de la mano, mujer, mujer y hombre de la mano, mujer y hombre de la mano: tono de piel oscuro, novios, pareja, tono de piel oscuro
ğŸ‘¬	amor, gemelos, hombres, pareja
ğŸ‘¬ğŸ»	amor, gemelos, hombres, hombres de la mano: tono de piel claro, pareja, tono de piel claro
ğŸ‘¨ğŸ¼â€ğŸ¤â€ğŸ‘¨ğŸ»	amor, gemelos, hombres, hombres de la mano: tono de piel claro medio y tono de piel claro, pareja, tono de piel claro, tono de piel claro medio
ğŸ‘¬ğŸ¼	amor, gemelos, hombres, hombres de la mano: tono de piel claro medio, pareja, tono de piel claro medio
ğŸ‘¨ğŸ½â€ğŸ¤â€ğŸ‘¨ğŸ»	amor, gemelos, hombres, hombres de la mano: tono de piel medio y tono de piel claro, pareja, tono de piel claro, tono de piel medio
ğŸ‘¨ğŸ½â€ğŸ¤â€ğŸ‘¨ğŸ¼	amor, gemelos, hombres, hombres de la mano: tono de piel medio y tono de piel claro medio, pareja, tono de piel claro medio, tono de piel medio
ğŸ‘¬ğŸ½	amor, gemelos, hombres, hombres de la mano: tono de piel medio, pareja, tono de piel medio
ğŸ‘¨ğŸ¾â€ğŸ¤â€ğŸ‘¨ğŸ»	amor, gemelos, hombres, hombres de la mano: tono de piel oscuro medio y tono de piel claro, pareja, tono de piel claro, tono de piel oscuro medio
ğŸ‘¨ğŸ¾â€ğŸ¤â€ğŸ‘¨ğŸ¼	amor, gemelos, hombres, hombres de la mano: tono de piel oscuro medio y tono de piel claro medio, pareja, tono de piel claro medio, tono de piel oscuro medio
ğŸ‘¨ğŸ¾â€ğŸ¤â€ğŸ‘¨ğŸ½	amor, gemelos, hombres, hombres de la mano: tono de piel oscuro medio y tono de piel medio, pareja, tono de piel medio, tono de piel oscuro medio
ğŸ‘¬ğŸ¾	amor, gemelos, hombres, hombres de la mano: tono de piel oscuro medio, pareja, tono de piel oscuro medio
ğŸ‘¨ğŸ¿â€ğŸ¤â€ğŸ‘¨ğŸ»	amor, gemelos, hombres, hombres de la mano: tono de piel oscuro y tono de piel claro, pareja, tono de piel claro, tono de piel oscuro
ğŸ‘¨ğŸ¿â€ğŸ¤â€ğŸ‘¨ğŸ¼	amor, gemelos, hombres, hombres de la mano: tono de piel oscuro y tono de piel claro medio, pareja, tono de piel claro medio, tono de piel oscuro
ğŸ‘¨ğŸ¿â€ğŸ¤â€ğŸ‘¨ğŸ½	amor, gemelos, hombres, hombres de la mano: tono de piel oscuro y tono de piel medio, pareja, tono de piel medio, tono de piel oscuro
ğŸ‘¨ğŸ¿â€ğŸ¤â€ğŸ‘¨ğŸ¾	amor, gemelos, hombres, hombres de la mano: tono de piel oscuro y tono de piel oscuro medio, pareja, tono de piel oscuro, tono de piel oscuro medio
ğŸ‘¬ğŸ¿	amor, gemelos, hombres, hombres de la mano: tono de piel oscuro, pareja, tono de piel oscuro
ğŸ’	beso
ğŸ‘©â€â¤â€ğŸ’‹â€ğŸ‘¨	beso, beso: mujer y hombre, hombre, mujer
ğŸ‘¨â€â¤â€ğŸ’‹â€ğŸ‘¨	beso, beso: hombre y hombre, hombre
ğŸ‘©â€â¤â€ğŸ’‹â€ğŸ‘©	beso, beso: mujer y mujer, mujer
ğŸ’‘	hombre y mujer enamorados
ğŸ‘©â€â¤â€ğŸ‘¨	hombre, hombre y mujer enamorados, hombre y mujer enamorados: mujer y hombre, mujer
ğŸ‘¨â€â¤â€ğŸ‘¨	hombre, hombre y mujer enamorados, hombre y mujer enamorados: hombre y hombre
ğŸ‘©â€â¤â€ğŸ‘©	hombre y mujer enamorados, hombre y mujer enamorados: mujer y mujer, mujer
ğŸ‘ªï¸	familia, hija, hijo, madre, padre
ğŸ‘¨â€ğŸ‘©â€ğŸ‘¦	familia, hija, hijo, hombre, madre, mujer, niÃ±o, padre
ğŸ‘¨â€ğŸ‘©â€ğŸ‘§	familia, hija, hijo, hombre, madre, mujer, niÃ±a, padre
ğŸ‘¨â€ğŸ‘©â€ğŸ‘§â€ğŸ‘¦	familia, hija, hijo, hombre, madre, mujer, niÃ±a, niÃ±o, padre
ğŸ‘¨â€ğŸ‘©â€ğŸ‘¦â€ğŸ‘¦	familia, hija, hijo, hombre, madre, mujer, niÃ±o, padre
ğŸ‘¨â€ğŸ‘©â€ğŸ‘§â€ğŸ‘§	familia, hija, hijo, hombre, madre, mujer, niÃ±a, padre
ğŸ‘¨â€ğŸ‘¨â€ğŸ‘¦	familia, hija, hijo, hombre, madre, niÃ±o, padre
ğŸ‘¨â€ğŸ‘¨â€ğŸ‘§	familia, hija, hijo, hombre, madre, niÃ±a, padre
ğŸ‘¨â€ğŸ‘¨â€ğŸ‘§â€ğŸ‘¦	familia, hija, hijo, hombre, madre, niÃ±a, niÃ±o, padre
ğŸ‘¨â€ğŸ‘¨â€ğŸ‘¦â€ğŸ‘¦	familia, hija, hijo, hombre, madre, niÃ±o, padre
ğŸ‘¨â€ğŸ‘¨â€ğŸ‘§â€ğŸ‘§	familia, hija, hijo, hombre, madre, niÃ±a, padre
ğŸ‘©â€ğŸ‘©â€ğŸ‘¦	familia, hija, hijo, madre, mujer, niÃ±o, padre
ğŸ‘©â€ğŸ‘©â€ğŸ‘§	familia, hija, hijo, madre, mujer, niÃ±a, padre
ğŸ‘©â€ğŸ‘©â€ğŸ‘§â€ğŸ‘¦	familia, hija, hijo, madre, mujer, niÃ±a, niÃ±o, padre
ğŸ‘©â€ğŸ‘©â€ğŸ‘¦â€ğŸ‘¦	familia, hija, hijo, madre, mujer, niÃ±o, padre
ğŸ‘©â€ğŸ‘©â€ğŸ‘§â€ğŸ‘§	familia, hija, hijo, madre, mujer, niÃ±a, padre
ğŸ‘¨â€ğŸ‘¦	familia, hija, hijo, hombre, madre, niÃ±o, padre
ğŸ‘¨â€ğŸ‘¦â€ğŸ‘¦	familia, hija, hijo, hombre, madre, niÃ±o, padre
ğŸ‘¨â€ğŸ‘§	familia, hija, hijo, hombre, madre, niÃ±a, padre
ğŸ‘¨â€ğŸ‘§â€ğŸ‘¦	familia, hija, hijo, hombre, madre, niÃ±a, niÃ±o, padre
ğŸ‘¨â€ğŸ‘§â€ğŸ‘§	familia, hija, hijo, hombre, madre, niÃ±a, padre
ğŸ‘©â€ğŸ‘¦	familia, hija, hijo, madre, mujer, niÃ±o, padre
ğŸ‘©â€ğŸ‘¦â€ğŸ‘¦	familia, hija, hijo, madre, mujer, niÃ±o, padre
ğŸ‘©â€ğŸ‘§	familia, hija, hijo, madre, mujer, niÃ±a, padre
ğŸ‘©â€ğŸ‘§â€ğŸ‘¦	familia, hija, hijo, madre, mujer, niÃ±a, niÃ±o, padre
ğŸ‘©â€ğŸ‘§â€ğŸ‘§	familia, hija, hijo, madre, mujer, niÃ±a, padre
ğŸ‘£	cuerpo, huellas de pies, pie, pisada
ğŸ¦°	pelirrojo
ğŸ¦±	afro, pelo enrulado, rizos, rulos, tirabuzÃ³n
ğŸ¦³	anciano, cabello, canas, gris, pelo, pelo canoso
ğŸ¦²	calvo, quimioterapia, rapado, sin cabello, sin pelo
ğŸ¦	cara, gorila
ğŸ¶	cara, cara de perro, perro
ğŸ•ï¸	animal, canino, mascota, perro
ğŸ©	animal, perro, perro de aguas, poodle
ğŸ¦	astucia, curiosidad, mapache
ğŸˆï¸	animal, felino, gato, minino
ğŸ…	animal, felino, tigre
ğŸ†	animal, felino, leopardo
ğŸ	animal, caballo, ecuestre, equino, galopar
ğŸ„	animal, vaca, vacuno
ğŸ·	animal, cara, cerdo, porcino, puerco
ğŸ–	animal, cerdo, marrano, porcino, puerco
ğŸ—	animal, jabalÃ­
ğŸ½	cara, cerdo, chancho, hocico, hocico de cerdo
ğŸ	animal, aries, carnero
ğŸ‘	animal, oveja, ovejero, ovino
ğŸ	animal, cabra, caprino
ğŸª	animal, camÃ©lido, dromedario, joroba
ğŸ«	animal, camello, camÃ©lido, joroba
ğŸ¦™	alpaca, camÃ©lido, guanaco, lana, llama, vicuÃ±a
ğŸ˜	animal, elefante
ğŸ¦›	animal, hipopÃ³tamo
ğŸ	animal, ratÃ³n
ğŸ€	animal, rata
ğŸ°	cara, cara de conejo, conejo
ğŸ‡	animal, conejo
ğŸ¿ï¸	ardilla
ğŸ¦”	erizo
ğŸ¦¨	zorrillo
ğŸ¦˜	Australia, canguro, marsupial, saltar
ğŸ¦¡	tejÃ³n, tejÃ³n de la miel
ğŸ”	gallina
ğŸ“	animal, ave, gallo
ğŸ¦ï¸	animal, ave, periquito, periquito australiano
ğŸ§	animal, ave, pingÃ¼ino
ğŸ•Šï¸	animal, ave, paloma, paz
ğŸ¦¢	animal, ave, cisne, patito feo
ğŸ¦š	ave, orgullo, ostentaciÃ³n, pavo, pavo real
ğŸ¦œ	animal, ave, cotorro, hablar, loro, perico
ğŸŠ	animal, cocodrilo, lagarto, reptil
ğŸ¢	animal, reptil, tortuga
ğŸ	animal, reptil, serpiente, vÃ­bora
ğŸ²	animal, cara de dragÃ³n, cuento, dragÃ³n, fantasÃ­a
ğŸ‰	animal, cuento, dragÃ³n, fantasÃ­a
ğŸ‹	animal, ballena
ğŸ¬	animal, delfÃ­n
ğŸŸï¸	animal, pez
ğŸ™	animal, pulpo, tentÃ¡culos
ğŸš	caracol marino
ğŸŒ	animal, babosa, baboso, caracol, insecto
ğŸ¦‹	animal, bonita, insecto, mariposa
ğŸœ	animal, hormiga, insecto
ğŸ	abeja, animal, insecto
ğŸ¦—	animal, grillo, insecto, saltamontes
ğŸ•¸ï¸	araÃ±a, telaraÃ±a
ğŸ¦‚	animal, escorpiÃ³n, insecto, venenoso
ğŸ¦Ÿ	enfermedad, fiebre, insecto, malaria, mosquito, virus
ğŸ¦ 	ameba, amiba, bacteria, microbio, virus
ğŸŒ¹	amor, flor, planta, rosa
ğŸŒ»	flor, girasol, planta
ğŸŒ¼	flor, florecer
ğŸŒ·	flor, tulipÃ¡n
ğŸŒ´	cocos, palmera, Ã¡rbol
ğŸ€	cuatro, hojas, suerte, trÃ©bol
ğŸ	arce, hoja, hoja de arce, maple
ğŸˆ	fruta, melÃ³n, planta
ğŸ‰	fruta, planta, sandÃ­a
ğŸŠ	cÃ­trico, fruta, mandarina
ğŸŒ	plÃ¡tano
ğŸ	piÃ±a
ğŸ¥­	fruta, mango, Ã¡rbol
ğŸ“	fresa
ğŸ¥	fruta, kiwi, planta
ğŸ…	jitomate, planta, vegetal, verdura
ğŸ¥‘	aguacate
ğŸŒ¶ï¸	chile picante
ğŸ¥¬	col, kale, lechuga, repollo chino, verdura de hoja
ğŸ¥œ	cacahuate
ğŸŒ°	castaÃ±a, comida, fruto seco, planta
ğŸ	barra de pan, comida, pan
ğŸ¥	comida, cuernito, medialuna, pan
ğŸ¥–	baguette, comida, pan francÃ©s
ğŸ¥¯	bagel, panaderÃ­a, untar
ğŸ§‡	waffle
ğŸ–	carne, comida, hueso
ğŸ—	comida, pata, pata de pollo, pollo
ğŸ”	comida, hamburguesa
ğŸŸ	comida, papas fritas
ğŸŒ­	perro caliente
ğŸ¥ª	sÃ¡ndwich
ğŸŒ®	comida, comida mexicana, tacos, taquitos
ğŸŒ¯	burrito, comida, comida mexicana
ğŸ§†	albÃ³ndigas, bolas de garbanzo
ğŸ³	cocina, huevo, sartÃ©n
ğŸ²	comida, estofado, guisado, guiso, olla
ğŸ¥£	tazÃ³n con cuchara
ğŸœ	tazÃ³n de fideos
ğŸ	comida, comida italiana, espaguetis, pastas
ğŸ 	asada, batata, comida, planta, tubÃ©rculo
ğŸ¢	brocheta de mariscos, brochetas, brochettes, comida, mariscos
ğŸ¤	camarones, camarones fritos, comida, japonesa, tempura
ğŸ¥®	festival, otoÃ±o, pastel de luna, yuebing
ğŸ¡	brocheta, comida, dango, dulce, japonesa
ğŸ¥Ÿ	empanada
ğŸ¥¡	caja para llevar, comida para llevar, recipiente para llevar
ğŸ¦€	animal, cangrejo, crustÃ¡ceo, cÃ¡ncer, mariscos
ğŸ¦	bisque, langosta, mariscos, pinzas
ğŸ¦	camarÃ³n, comida, langostino, mariscos
ğŸ¦‘	calamar, comida, mariscos
ğŸ¦ª	ostiÃ³n
ğŸ¦	helado en barquillo
ğŸ§	dulce, frÃ­o, helado, hielo, hielo molido
ğŸª	dulce, galleta, postre
ğŸ‚	pastel de cumpleaÃ±os
ğŸ°	rebanada de pastel
ğŸ§	cupcake, madalena, madgalena, pastelito
ğŸ¥§	pay
ğŸ«	chocolate, dulce, postre
ğŸ¾	botella, celebrar, champaÃ±a, champÃ¡n, festejar
ğŸ¹	bar, bebida, cÃ³ctel, trago, tropical
ğŸ»	bebida, brindis, brindis con cerveza, celebrar, cerveza
ğŸ§Š	hielo
ğŸ½ï¸	cubiertos, cuchillo, plato, restaurante, tenedor
ğŸŒ	Europa, globo, globo terrÃ¡queo Europa/Ãfrica, Ãfrica
ğŸŒ	Asia, Australia, globo, globo terrÃ¡queo Asia/OceanÃ­a
ğŸŒ	globo, meridianos, mundo, paralelos, terrÃ¡queo
ğŸ§­	brÃºjula, direcciÃ³n, magnetismo, navegaciÃ³n, orientaciÃ³n, rumbo
ğŸœï¸	arena, desierto, seco, sequÃ­a
ğŸï¸	isla, isla desierta
ğŸï¸	atracciÃ³n, naturaleza, parque, vacaciones
ğŸŸï¸	deporte, estadio, eventos
ğŸ§±	cemento, ladrillo, ladrillos, mezcla, pared
ğŸ¨	alojamiento, edificio, hotel, turismo
ğŸª	24/7, edificio, siempre abierto, tienda
ğŸ«	colegio, edificio, escuela
ğŸ¬	tienda departamental
ğŸ’’	boda religiosa
ğŸ—½	Estados Unidos, Estatua de la Libertad, NYC, Nueva York
â›ªï¸	cristianismo, edificio, iglesia, religiÃ³n
ğŸ•Œ	edificio, islam, mezquita, musulmÃ¡n, religiÃ³n
ğŸ•	edificio, judaÃ­smo, religiÃ³n, sinagoga, templo
ğŸ•‹	El Cubo, edificio, islam, musulmÃ¡n, religiÃ³n
â›ºï¸	casa de campaÃ±a
ğŸŒ‡	amanecer, atardecer, edificios, puesta, puesta de sol sobre edificios
â™¨ï¸	aguas, caliente, fuentes termales, termales, termas
ğŸ¡	rueda de la fortuna
ğŸ¢	feria, montaÃ±a rusa, parque, parque de atracciones, rusa
ğŸ’ˆ	peluquerÃ­a
ğŸª	carpa, circo, entretenimiento, espectÃ¡culo artÃ­stico, show de circo
ğŸš‚	locomotora
ğŸš„	bala, ferrocarril, rÃ¡pido, tren, velocidad
ğŸš…	bala, ferrocarril, rÃ¡pido, tren, velocidad
ğŸšŠ	transporte, tranvÃ­a, tren ligero
ğŸš	ferrocarril, montaÃ±a, transporte, tren, viajar
ğŸšŒ	bus, camiÃ³n, colectivo, ruta, transporte
ğŸšï¸	autobÃºs se aproxima
ğŸš‘ï¸	ambulancia, hospital, transporte, urgencia
ğŸš“	auto, auto de policÃ­a, patrulla, policÃ­a, transporte
ğŸš”ï¸	patrulla se aproxima
ğŸš•	taxi, transporte
ğŸš™	vehÃ­culo utilitario deportivo
ğŸš›	trailer
ğŸšœ	campo, tractor, vehÃ­culo, vehÃ­culo de trabajo
ğŸï¸	auto de carreras
ğŸ›µ	motoneta
ğŸš²ï¸	bici, bicicleta, transporte
ğŸ›´	patÃ­n del diablo
ğŸ›¹	patineta, skateboard, tabla
ğŸ›¢ï¸	barril de petrÃ³leo
â›½ï¸	dispensador, estaciÃ³n de gasolina, gasolina, nafta, surtidor
ğŸš¨	sirena de patrulla
ğŸ›‘	seÃ±al de alto
â›µï¸	bote, deporte acuÃ¡tico, mar, transporte, velero
ğŸ›¶	bote, canoa, deporte acuÃ¡tico, remo, transporte
ğŸš¤	bote, deporte acuÃ¡tico, lancha, transporte
ğŸ›³ï¸	barco, barco de pasajeros, pasajeros, transporte
â›´ï¸	bote, ferry, transbordador, transporte, trasbordador
ğŸš¢	crucero, transporte
âœˆï¸	aire, transporte, viajar, viaje, volar
ğŸ›©ï¸	aire, aviÃ³n, transporte, viajar, viaje
ğŸ›«	aviÃ³n, despegar, despegue, partida, salida
ğŸ’º	asiento
ğŸš€	cohete, espacial, espacio
ğŸ›¸	platillo volador
ğŸ§³	equipaje, maleta, valija, viaje
âŒ›ï¸	arena, reloj, se acabÃ³ el tiempo, tiempo agotado
â±ï¸	cronÃ³metro, mediciÃ³n del tiempo, reloj, segundos, tiempo
â²ï¸	mediciÃ³n del tiempo, reloj, segundos, temporizador, tiempo
ğŸŒ‘	espacio, fase lunar, luna, negra, nuev
ğŸŒ’	creciente, espacio, luna, nueva, visible
ğŸŒ“	creciente, cuarto, espacio, fase lunar, luna
ğŸŒ”	creciente, espacio, fase lunar, gibosa, luna
ğŸŒ•ï¸	espacio, fase lunar, llena, luna
ğŸŒ–	espacio, fase lunar, gibosa, luna, menguante
ğŸŒ—	cuarto, espacio, fase lunar, luna, menguante
ğŸŒ˜	creciente, fase lunar, luna, menguante
ğŸŒ™	cruasÃ¡n, cuarto creciente, fase lunar, luna creciente
â›…ï¸	nubes, nublado, parcialmente nublado, sol, tiempo
â˜ƒï¸	invierno, muÃ±eco, muÃ±eco de nieve nevado, nieve
ğŸ„	Navidad, celebraciÃ³n, Ã¡rbol
âœ¨	*, bengala, chispas, estrellas, estrellas centelleantes
ğŸˆ	celebraciÃ³n, fiesta, globo
ğŸ	koinobori
ğŸ	campanilla, fuurin, viento
ğŸ‘	ceremonia de contemplaciÃ³n de la luna
ğŸ§§	buena suerte, dinero, regalo, sobre rojo
ğŸ	celebraciÃ³n, moÃ±o, obsequio, presente, regalo
ğŸŸï¸	boleto de entrada
ğŸ«	boleto, entretenimiento, evento, ticket, ticket de admisiÃ³n
ğŸ–ï¸	celebraciÃ³n, grado, medalla, militar
ğŸ†ï¸	copa, ganador, premio, trofeo, victoria
ğŸ¥	antebrazo, guante, pelota, sÃ³ftbol
ğŸ€	bÃ¡squet, bÃ¡squetbol, deporte, pelota, pelota de bÃ¡squet
ğŸ	pelota de voleibol
ğŸˆ	americano, balÃ³n, deporte, fÃºtbol, pelota de fÃºtbol americano
ğŸ¥	frisbee, ultimate
ğŸ¥	gol, lacrosse, palo, pelota
ğŸ“	mesa, paleta, pelota, ping, pong
ğŸ¥‹	artes marciales, judo, karate, taekwondo, uniforme
ğŸ£	caÃ±a, ocio, pesca, pescado, pescar
ğŸ½	camiseta, camiseta para correr, correr, mangas, musculosa
ğŸ¯	dardo, dardo en el centro, dardo en la diana, diana, objetivo
ğŸª€	yoyo
ğŸª	juguete, papalote, planear, viento, volar
ğŸ§¿	cuenta, hechizo, mal de ojo, nazar, talismÃ¡n
ğŸ®ï¸	control, joystick, juego, mando, video juegos
ğŸ•¹ï¸	control, juego, juego de video, video, videojuego
ğŸ°	apuestas, casino, juego, mÃ¡quina, tragamonedas
ğŸ²	dado, juego de azar
ğŸ§¸	felpa, juguete, oso, oso de peluche, relleno
â™Ÿï¸	ajedrez, peÃ³n (ajedrez)
ğŸ¨	arte, artista, paleta, paleta de pinturas, pintor
ğŸ§µ	aguja, bobina, carrete, cordel, coser, hilo
ğŸ§¶	crochÃ©, ovillo, pelota, tejer
ğŸ‘“ï¸	anteojos, lentes, ropa, vestimenta
ğŸ•¶ï¸	lentes de sol, lentes oscuros, sol
ğŸ¥½	goggles, lentes de nataciÃ³n, lentes de protecciÃ³n, lentes para nadar, soldar
ğŸ¥¼	bata de laboratorio, cientÃ­fico, experimento, mÃ©dico
ğŸ‘•	camiseta, playera, ropa, vestimenta
ğŸ‘–	jeans, pantalones de mezclilla, ropa, vaquero, vestimenta
ğŸ§£	bufanda, cuello, vestimenta
ğŸ§¤	guantes, mano, vestimenta
ğŸ§¥	abrigo, chamarra, vestimenta
ğŸ§¦	calcetines, pies, ropa, vestimenta
ğŸ‘—	ropa, vestido, vestimenta
ğŸ¥»	India, prenda, ropa, vestido
ğŸ©±	traje de baÃ±o
ğŸ©²	calzoncillos, ropa interior, slip, traje de baÃ±o
ğŸ©³	shorts
ğŸ‘™	alberca, nadar, piscina, ropa, traje de baÃ±o
ğŸ‘œ	bolso
ğŸ‘	bolso de mano, cartera, ropa, sobre, vestimenta
ğŸ’	escuela, estudiar, maletÃ­n, mochila escolar
ğŸ‘Ÿ	ropa, tenis, vestimenta, zapato deportivo
ğŸ¥¾	acampar, bota, botas de excursiÃ³n, excursiÃ³n, senderismo
ğŸ¥¿	bailarina, calzado de piso, zapato de piso, zapato plano
ğŸ‘ 	mujer, ropa, vestimenta, zapatilla, zapato
ğŸ©°	bailar, ballet, danza
ğŸ‘‘	realeza, reina, rey
ğŸ©	caballero, copa, galera, sombrero, sombrero de copa
ğŸ“ï¸	birrete, celebraciÃ³n, graduaciÃ³n, graduado
â›‘ï¸	ayuda, casco, casco con una cruz blanca, casco de rescatista
ğŸ’	compromiso, joya, romance
ğŸ”‡	bocina selenciada, bocina silenciada, silencio, sin volumen
ğŸ”ˆï¸	bocina a volumen bajo
ğŸ”‰	bocina a volumen medio
ğŸ”Š	bocina a volumen alto
ğŸ“¢	altavoz
ğŸ”•	campana, campana tachada, silencio
ğŸ¼	partitura
ğŸµ	corchea, mÃºsica, nota, nota musical
ğŸ¶	corcheas, mÃºsica, notas, notas musicales
ğŸ§ï¸	audÃ­fonos
ğŸ“»ï¸	comunicaciÃ³n, estaciÃ³n de radio, mÃºsica, noticias, radio
ğŸ¸	guitarra, instrumento, mÃºsica
ğŸº	instrumento, mÃºsica, trompeta
ğŸ»	instrumento, mÃºsica, violÃ­n
ğŸ¥	baquetas, mÃºsica, palitos, tambor
ğŸ“²	flecha apuntado a telÃ©fono celular
â˜ï¸	telÃ©fono fijo
ğŸ“Ÿï¸	bÃ­per
ğŸ’½	disco duro
ğŸ¥	cÃ¡mara de video
ğŸ“ºï¸	televisiÃ³n
ğŸ“¼	videocasete
ğŸ’¡	foco
ğŸ®	farol, farol de papel japonÃ©s, izakaya, linterna, papel
ğŸ““	cuaderno, negro
ğŸ“ƒ	pÃ¡gina doblada
ğŸ§¾	contabilidad, contadurÃ­a, evidencia
ğŸ’¹	grÃ¡fico, mercado, mercado en alza, tendencia, yen
âœ‰ï¸	carta, comunicaciÃ³n, correo, sobre
ğŸ“§	comunicaciÃ³n, correo, electrÃ³nico, email
ğŸ“¨	carta, correo electrÃ³nico, mensaje, recibido, sobre
ğŸ“©	carta, comunicaciÃ³n, correo electrÃ³nico, enviado, mensaje
ğŸ“¤ï¸	bandeja, comunicaciÃ³n, correo, enviados, salida
ğŸ“¥ï¸	comunicaciÃ³n, correo, entrada, entrante, recibidos
âœ’ï¸	pluma de lapicera
ğŸ–Šï¸	bolÃ­grafo, escribir, lapicera, pluma
ğŸ–ï¸	colorear, crayola, crayÃ³n, dibujar, pintar
ğŸ“	comunicaciÃ³n, memo, memorÃ¡ndum, nota, recordatorio
ğŸ’¼	bolso de hombre, maletÃ­n, portafolio
ğŸ“ˆ	alza, ascendente, grÃ¡fico, tabla, tendencia ascendente
ğŸ“‰	baja, descendente, grÃ¡fico, tabla, tendencia descendente
ğŸ—‘ï¸	papelera
ğŸ›¡ï¸	escudo, protecciÃ³n
ğŸ—œï¸	abrazadera
ğŸ¦¯	accesibilidad, ceguera, invidente
ğŸ§°	cofre, herramienta, mecÃ¡nico
ğŸ§«	bacteria, biologÃ­a, biÃ³logo, laboratorio, microbio, placa de Petri
ğŸ§¬	ADN, biÃ³logo, evoluciÃ³n, gen, genÃ©tica, vida
ğŸ”­	instrumento, microscopio, observatorio
ğŸ©¹	curita
ğŸ©º	corazÃ³n, doctor, fonendoscopio, latido, medicina
ğŸ›ï¸	dormir, habitaciÃ³n, hotel, recÃ¡mara
ğŸš½	baÃ±o, escusado, inodoro, retrete
ğŸš¿	regadera
ğŸ›	tina
ğŸª’	navaja de afeitar
ğŸ§´	botella de lociÃ³n, champÃº, humectante, lociÃ³n, protector solar
ğŸ§·	broche, broche de seguridad, paÃ±al
ğŸ§¹	barrer, bruja, escoba, limpiar
ğŸ§º	campesino, canasta, lavar la ropa, picnic
ğŸ§»	papel higiÃ©nico, rollo de papel, toallas de papel
ğŸ§¼	barra, barra de jabÃ³n, baÃ±arse, jabÃ³n, lavar
ğŸ§½	absorber, esponja, limpiar, poroso
ğŸ§¯	apagar, extinguir, extintor, fuego, matafuegos
ğŸ›’	carriito, carrito de compras, carro, compras, supermercado
ğŸ—¿	estatua de Isla de Pascua
ğŸ§	cartel de cajero automÃ¡tico
â™¿ï¸	seÃ±al de acceso para silla de ruedas
ğŸš¹ï¸	seÃ±al del baÃ±o de los hombres
ğŸšºï¸	seÃ±al del baÃ±o de las mujeres
ğŸš¼ï¸	bebÃ©, cambiador, seÃ±al
ğŸ›ƒ	aduana
ğŸš«	no, pasar, prohibido, seÃ±al, seÃ±al de prohibiciÃ³n
â¬†ï¸	cardinal, direcciÃ³n, flecha, flecha hacia el norte, norte
â†—ï¸	derecha, direcciÃ³n, flecha, flecha hacia el noreste, noreste
â¡ï¸	derecha, direcciÃ³n, este, flecha, flecha hacia el este
â†˜ï¸	flecha hacia el sureste
â¬‡ï¸	cardinal, direcciÃ³n, flecha, flecha hacia el sur, punto
â†™ï¸	flecha hacia el suroeste
â¬…ï¸	direcciÃ³n, flecha, flecha hacia el oeste, izquierda, oeste
â†–ï¸	arriba, direcciÃ³n, flecha, flecha hacia el noroeste, noroeste
â†©ï¸	flecha de retorno al oeste por la derecha
â†ªï¸	flecha de retorno al este por la izquierda
â¤´ï¸	flecha de retorno al norte por la izquierda
â¤µï¸	flecha de retorno al sur por la derecha
âœ¡ï¸	David, judaÃ­smo, judÃ­o, religiÃ³n
â˜¸ï¸	rueda del dharma
ğŸ”¯	David, estrella de David, estrella de seis puntas, hexagrama
â­	avanzar, avanzar a la pista siguiente, botÃ³n, mÃºsica, siguiente
âï¸	botÃ³n, botÃ³n expulsar, mÃºsica
ğŸ¦	botÃ³n, cine, cÃ¡mara, filmar, grabar
ğŸ”…	reducir brillo
ğŸ”†	aumentar brillo
â™¾ï¸	eterno, ilimitado, infinito, universal
â™»ï¸	reciclado, reciclaje, reciclar, sÃ­mbolo
ğŸ”±	barco, emblema, navegaciÃ³n, neptuno, tridente
ğŸ“›	gafete
ğŸ”°	bandera, hoja, japonÃ©s, principiante, sÃ­mbolo japonÃ©s de principiante
âœ…	botÃ³n, marca, selecciÃ³n, verificaciÃ³n, âœ“
â˜‘ï¸	casilla, marca, selecciÃ³n, verificaciÃ³n, âœ“
âœ”ï¸	marca, marca de verificaciÃ³n, selecciÃ³n, verificaciÃ³n, âœ“
âœ–ï¸	signo de multiplicaciÃ³n
âŒ	cancelar, cruz, marca de cruz, marca de tachado, tachar, Ã—
â•	+, mÃ¡s, signo, signo de suma, suma
â–	-, menos, resta, signo, signo de resta, âˆ’
â—	divisiÃ³n, signo, signo de divisiÃ³n, Ã·
â‡ï¸	chispa
Â©ï¸	autor, copyright, derechos, signo de derechos autor, sÃ­mbolo de derechos de autor
Â®ï¸	marca, registrada, signo de marca registrada, sÃ­mbolo de marca registrada
â„¢ï¸	marca registrada
#âƒ£	tecla, tecla: #
*âƒ£	tecla, tecla: *
0âƒ£	tecla, tecla: 0
1âƒ£	tecla, tecla: 1
2âƒ£	tecla, tecla: 2
3âƒ£	tecla, tecla: 3
4âƒ£	tecla, tecla: 4
5âƒ£	tecla, tecla: 5
6âƒ£	tecla, tecla: 6
7âƒ£	tecla, tecla: 7
8âƒ£	tecla, tecla: 8
9âƒ£	tecla, tecla: 9
ğŸ”Ÿ	tecla, tecla: 10
ğŸˆ·	"cantidad mensual" en japonÃ©s, ideograma, japonÃ©s, mensual
ğŸŸ¤	cÃ­rculo cafÃ©
ğŸŸ«	cuadrado cafÃ©
ğŸ”³	borde, botÃ³n, cuadrado, cuadrado negro con borde blanco, marco
ğŸ”²	borde, botÃ³n, cuadrado, cuadrado blanco con borde negro, marco
ğŸ	bandera, bandera de llegada, carrera, deporte, meta
ğŸš©	banderÃ­n triangular
ğŸ³â€ğŸŒˆ	arcoÃ­ris, bandera, bandera del arcoÃ­ris, bandera gay
ğŸ´â€â˜ 	Jolly Roger, bandera pirata, botÃ­n, calavera, pirata
ğŸ‡§ğŸ‡¦	bandera: Bosnia y Herzegovina
ğŸ‡¨ğŸ‡®	bandera: CÃ´te dâ€™Ivoire
ğŸ‡¬ğŸ‡¬	bandera: Guernsey
ğŸ‡¸ğŸ‡¦	bandera: Arabia Saudita
ğŸ‡¸ğŸ‡¿	bandera: Eswatini
ğŸ‡¹ğŸ‡¦	bandera: TristÃ¡n de AcuÃ±a
ğŸ‡¹ğŸ‡±	bandera: Timor-Leste
ğŸ‡ºğŸ‡²	bandera: Islas menores alejadas de EE. UU.
ğŸ‡ºğŸ‡³	bandera: UN
ğŸ‡»ğŸ‡®	bandera: Islas VÃ­rgenes de EE. UU.
