ğŸ˜€	grand sourire, large sourire, visage, visage avec large sourire
ğŸ˜ƒ	bouche ouverte, sourire, visage, visage souriant les yeux grands ouverts
ğŸ˜„	bouche ouverte, sourire, visage, visage avec large sourire et yeux rieurs, Å“il
ğŸ˜	grand sourire, large sourire, sourire, visage, visage radieux et yeux rieurs, Å“il
ğŸ˜†	bouche ouverte, rire, satisfait, sourire, visage, visage avec large sourire, les yeux fermÃ©s
ğŸ˜…	un visage en sueur avec large sourire
ğŸ¤£	rire, rire Ã  se rouler par terre, se rouler par terre, visage
ğŸ˜‚	joie, larme, rire, visage, visage pleurant de joie
ğŸ™‚	visage avec un lÃ©ger sourire
ğŸ™ƒ	renversÃ©, visage, visage Ã  lâ€™envers, Ã  lâ€™envers
ğŸ˜‰	clin dâ€™Å“il, visage, visage clignant dâ€™un Å“il
ğŸ˜Š	rougir, sourire, visage, visage souriant les yeux plissÃ©s, Å“il
ğŸ˜‡	ange, aurÃ©ole, innocent, visage, visage qui sourit avec une aurÃ©ole
ğŸ˜	amour, sourire, visage, visage souriant aux yeux en forme de cÅ“ur, Å“il
ğŸ¤©	grand sourire, large sourire, visage, visage aux yeux en forme dâ€™Ã©toiles, yeux, Ã©toile
ğŸ˜˜	baiser, visage, visage envoyant un baiser
ğŸ˜—	baiser, visage, visage donnant un baiser
â˜ºï¸	visage souriant
ğŸ˜š	baiser, visage, visage faisant un baiser les yeux fermÃ©s, yeux fermÃ©s
ğŸ˜™	baiser, sourire, visage, visage donnant un baiser avec les yeux plissÃ©s, Å“il
ğŸ˜‹	dÃ©licieux, menoum, miam, savourant, sourire, visage, visage savourant
ğŸ˜›	langue, langue sortie, tire la langue, visage
ğŸ˜œ	clin dâ€™Å“il, langue, tire la langue, visage
ğŸ¤ª	amusant, farfelu, idiot, niaiseux, visage
ğŸ˜	dÃ©goÃ»t, horrible, langue, visage, yeux plissÃ©s
ğŸ¤‘	argent, bouche, dollar, visage, yeux
ğŸ¤—	cÃ¢lin, visage, visage heureux et cÃ¢lin
ğŸ¤­	Oups, main sur la bouche, visage
ğŸ¤«	chut, doigt sur la bouche, silence, visage
ğŸ¤	bouche, bouche cousue, fermeture Ã  glissiÃ¨re, visage
ğŸ˜ï¸	visage neutre
ğŸ˜¶	visage sans bouche
ğŸ˜	malin, sourire, visage, visage au sourire malin
ğŸ˜’	visage dÃ©sabusÃ©
ğŸ™„	roule des yeux, visage, visage qui roule des yeux, yeux
ğŸ¤¥	mensonge, menteur, pinocchio, visage
ğŸ˜Œ	soulagement, soulagÃ©, visage
ğŸ˜ª	endormi, sommeil, visage
ğŸ¤¤	visage qui bave
ğŸ˜´	endormi, sommeil, visage, zzz
ğŸ˜·	docteur, froid, malade, masque, mÃ©dical, visage
ğŸ¤’	indisposÃ©, malade, thermomÃ¨tre, visage
ğŸ¤•	bandage, blessure, blessÃ©, visage, visage bandÃ©
ğŸ¤¢	nausÃ©e, visage, visage Ã©cÅ“urÃ©, Ã©cÅ“urÃ©
ğŸ¥µ	canicule, chaud, fiÃ¨vre, rouge, sueur, visage
ğŸ¥¶	bleu, froid, gelure, gelÃ©, glacial, visage
ğŸ¥´	visage abruti
ğŸ˜µ	croches, tournis, visage, yeux, Ã©tourdi
ğŸ¥³	chapeau, cÃ©lÃ©bration, fÃªte, sifflet, visage
ğŸ˜	cool, intelligent, soleil, visage, visage souriant avec des lunettes de soleil
ğŸ¤“	geek, lunettes, nerd, niaiseux, tronche, visage, visage de tronche
ğŸ§	monocle, sÃ©rieux, visage
ğŸ˜®	bouche ouverte, compassion, impressionnÃ©, visage, visage Ã©patÃ©
ğŸ˜¯	sans voix, stupÃ©fait, surpris, visage, Ã©bahi
ğŸ˜²	choquÃ©, stupÃ©fait, surpris, visage, Ã©tonnÃ©
ğŸ¥º	implorant, pitiÃ©, supplication, visage, yeux de chiot
ğŸ˜¦	bouche, bÃ©ante, ouverte, renfrognÃ©, visage
ğŸ˜°	anxieux, bleu, froide, sueur, visage, visage inquiet et en sueur
ğŸ˜¥	visage triste mais soulagÃ©
ğŸ˜¢	larmes, pleure, triste, visage, visage en pleure
ğŸ˜­	chaudes larmes, pleure, sanglot, triste, visage
ğŸ˜±	cri, munch, peur, terreur, visage
ğŸ˜“	froide, sueur, triste, visage, visage triste et en sueur
ğŸ˜¤	fumÃ©e, triomphe, victoire, visage, Ã©nervÃ©
ğŸ˜¡	boudeur, furieux, rouge, visage, Ã©nervÃ©
ğŸ˜ 	en colÃ¨re, furieux, visage
ğŸ¤¬	bipÃ©, blasphÃ¨me, censurÃ©, sacre, visage
ğŸ‘¿	cornes, diable, diablotin, dÃ©mon, en colÃ¨re, visage, visage en colÃ¨re avec des cornes
ğŸ’€	crÃ¢ne, fantastique, monstre, mort, visage
ğŸ’©	caca, crotte, marde, merde, visage
ğŸ‘¹	crÃ©ature, fantastique, monstre, ogre, visage
ğŸ‘º	crÃ©ature, fantastique, gobelin, monstre, visage
ğŸ‘½ï¸	alien, crÃ©ature, extraterrestre, fantastique, ovni, visage
ğŸ‘¾	alien, crÃ©ature, extraterrestre, monstre, ovni, visage
ğŸ¤–	monstre, robot, visage
ğŸ˜º	bouche, chat, ouverte, sourire, visage
ğŸ˜¸	chat, sourire, visage, yeux rieurs
ğŸ˜¹	chat, joie, larmes, sourire, visage
ğŸ˜»	amoureux, chat, sourire, visage, yeux en forme de cÅ“urs
ğŸ˜¼	chat, en coin, ironique, sourire, visage
ğŸ˜½	baiser, bec, bisou, chat, visage
ğŸ™€	chat, inquiet, surpris, visage, Ã©tonnÃ©
ğŸ˜¿	chat, larmes, pleure, triste, visage
ğŸ˜¾	chat, colÃ¨re, furieux, visage
ğŸ™ˆ	aveugle, rien de mal, singe, visage, yeux couverts
ğŸ™‰	oreilles couvertes, rien de mal, singe, sourd, visage
ğŸ™Š	bouche couverte, muet, rien de mal, singe, visage
ğŸ’Œ	amour, cÅ“ur, lettre
ğŸ’˜	cupidon, cÅ“ur, flÃ¨che
ğŸ’	cÅ“ur, ruban, saint valentin, st valentin
ğŸ’–	cÅ“ur, enthousiaste, Ã©tincelant
ğŸ’—	cÅ“ur, grandissant, nerveux, pouls, pulsations
ğŸ’“	battant, battement, cÅ“ur, pulsations
ğŸ’	cÅ“urs qui tournent
ğŸ’•	deux cÅ“urs
ğŸ’Ÿ	cÅ“ur, dÃ©coration
â£ï¸	cÅ“ur, exclamation, point
ğŸ’”	brisÃ©, cÅ“ur
â¤ï¸	cÅ“ur, rouge
ğŸ§¡	cÅ“ur, orange
ğŸ’›	cÅ“ur, jaune
ğŸ’š	cÅ“ur, vert
ğŸ’™	bleu, cÅ“ur
ğŸ’œ	cÅ“ur, violet
ğŸ¤	cÅ“ur brun
ğŸ’¯	cent, cent points, marque, score
ğŸ’¢	bande dessinÃ©e, colÃ¨re, furieux, symbole
ğŸ’¥	bande dessinÃ©e, collision, explosion
ğŸ’«	bande dessinÃ©e, tournis, Ã©tourdissement
ğŸ’¦	bande dessinÃ©e, goutte, sueur, Ã©claboussure
ğŸ’¨	bande dessinÃ©e, dÃ©camper, filer, fuir, se sauver, sâ€™enfuir
ğŸ’£ï¸	bande dessinÃ©e, bombe
ğŸ’¬	bande dessinÃ©e, bulle, dialogue, parole
ğŸ‘â€ğŸ—¨	bulle, parole, tÃ©moin, Å“il, Å“il dans une bulle de parole
ğŸ—¨ï¸	bande dessinÃ©e, bulle, bulle de parole Ã  gauche, dialogue, parole, Ã  gauche
ğŸ—¯ï¸	bande dessinÃ©e, bulle, bulle de colÃ¨re Ã  droite, dialogue, parole, Ã  droite
ğŸ’­	bande dessinÃ©e, bulle, pensÃ©e
ğŸ’¤	dormir, endormi, ronfler, zzz
ğŸ‘‹	coucou, main, signe
ğŸ‘‹ğŸ»	coucou, main, peau claire, signe, signe de la mainÂ : peau claire
ğŸ‘‹ğŸ¼	coucou, main, peau modÃ©rÃ©ment claire, signe, signe de la mainÂ : peau modÃ©rÃ©ment claire
ğŸ‘‹ğŸ½	coucou, main, peau lÃ©gÃ¨rement mate, signe, signe de la mainÂ : peau lÃ©gÃ¨rement mate
ğŸ‘‹ğŸ¾	coucou, main, peau modÃ©rÃ©ment foncÃ©e, signe, signe de la mainÂ : peau modÃ©rÃ©ment foncÃ©e
ğŸ‘‹ğŸ¿	coucou, main, peau foncÃ©e, signe, signe de la mainÂ : peau foncÃ©e
ğŸ¤š	dos de main, levÃ©e, main
ğŸ¤šğŸ»	dos de main, dos de main levÃ©eÂ : peau claire, levÃ©e, main, peau claire
ğŸ¤šğŸ¼	dos de main, dos de main levÃ©eÂ : peau modÃ©rÃ©ment claire, levÃ©e, main, peau modÃ©rÃ©ment claire
ğŸ¤šğŸ½	dos de main, dos de main levÃ©eÂ : peau lÃ©gÃ¨rement mate, levÃ©e, main, peau lÃ©gÃ¨rement mate
ğŸ¤šğŸ¾	dos de main, dos de main levÃ©eÂ : peau modÃ©rÃ©ment foncÃ©e, levÃ©e, main, peau modÃ©rÃ©ment foncÃ©e
ğŸ¤šğŸ¿	dos de main, dos de main levÃ©eÂ : peau foncÃ©e, levÃ©e, main, peau foncÃ©e
ğŸ–ï¸	doigts Ã©cartÃ©s, main, main aux doigts Ã©cartÃ©s
ğŸ–ğŸ»	doigts Ã©cartÃ©s, main, main aux doigts Ã©cartÃ©s, main aux doigts Ã©cartÃ©sÂ : peau claire, peau claire
ğŸ–ğŸ¼	doigts Ã©cartÃ©s, main, main aux doigts Ã©cartÃ©s, main aux doigts Ã©cartÃ©sÂ : peau modÃ©rÃ©ment claire, peau modÃ©rÃ©ment claire
ğŸ–ğŸ½	doigts Ã©cartÃ©s, main, main aux doigts Ã©cartÃ©s, main aux doigts Ã©cartÃ©sÂ : peau lÃ©gÃ¨rement mate, peau lÃ©gÃ¨rement mate
ğŸ–ğŸ¾	doigts Ã©cartÃ©s, main, main aux doigts Ã©cartÃ©s, main aux doigts Ã©cartÃ©sÂ : peau modÃ©rÃ©ment foncÃ©e, peau modÃ©rÃ©ment foncÃ©e
ğŸ–ğŸ¿	doigts Ã©cartÃ©s, main, main aux doigts Ã©cartÃ©s, main aux doigts Ã©cartÃ©sÂ : peau foncÃ©e, peau foncÃ©e
âœ‹	levÃ©e, main
âœ‹ğŸ»	levÃ©e, main, main levÃ©eÂ : peau claire, peau claire
âœ‹ğŸ¼	levÃ©e, main, main levÃ©eÂ : peau modÃ©rÃ©ment claire, peau modÃ©rÃ©ment claire
âœ‹ğŸ½	levÃ©e, main, main levÃ©eÂ : peau lÃ©gÃ¨rement mate, peau lÃ©gÃ¨rement mate
âœ‹ğŸ¾	levÃ©e, main, main levÃ©eÂ : peau modÃ©rÃ©ment foncÃ©e, peau modÃ©rÃ©ment foncÃ©e
âœ‹ğŸ¿	levÃ©e, main, main levÃ©eÂ : peau foncÃ©e, peau foncÃ©e
ğŸ––	main, salut, spock, vulcain
ğŸ––ğŸ»	main, peau claire, salut, salut vulcainÂ : peau claire, spock, vulcain
ğŸ––ğŸ¼	main, peau modÃ©rÃ©ment claire, salut, salut vulcainÂ : peau modÃ©rÃ©ment claire, spock, vulcain
ğŸ––ğŸ½	main, peau lÃ©gÃ¨rement mate, salut, salut vulcainÂ : peau lÃ©gÃ¨rement mate, spock, vulcain
ğŸ––ğŸ¾	main, peau modÃ©rÃ©ment foncÃ©e, salut, salut vulcainÂ : peau modÃ©rÃ©ment foncÃ©e, spock, vulcain
ğŸ––ğŸ¿	main, peau foncÃ©e, salut, salut vulcainÂ : peau foncÃ©e, spock, vulcain
ğŸ‘Œ	OK, main
ğŸ‘ŒğŸ»	OK, main, okÂ : peau claire, peau claire
ğŸ‘ŒğŸ¼	OK, main, okÂ : peau modÃ©rÃ©ment claire, peau modÃ©rÃ©ment claire
ğŸ‘ŒğŸ½	OK, main, okÂ : peau lÃ©gÃ¨rement mate, peau lÃ©gÃ¨rement mate
ğŸ‘ŒğŸ¾	OK, main, okÂ : peau modÃ©rÃ©ment foncÃ©e, peau modÃ©rÃ©ment foncÃ©e
ğŸ‘ŒğŸ¿	OK, main, okÂ : peau foncÃ©e, peau foncÃ©e
ğŸ¤ğŸ»	pouce et index rapprochÃ©sÂ : peau claire
ğŸ¤ğŸ¼	peau modÃ©rÃ©ment claire, petite quantitÃ©, petite somme, peu, pouce et index rapprochÃ©s, pouce et index rapprochÃ©sÂ : peau modÃ©rÃ©ment claire, un peu
ğŸ¤ğŸ½	pouce et index rapprochÃ©sÂ : peau lÃ©gÃ¨rement mate
ğŸ¤ğŸ¾	peau modÃ©rÃ©ment foncÃ©e, petite quantitÃ©, petite somme, peu, pouce et index rapprochÃ©s, pouce et index rapprochÃ©sÂ : peau modÃ©rÃ©ment foncÃ©e, un peu
ğŸ¤ğŸ¿	pouce et index rapprochÃ©sÂ : peau foncÃ©e
âœŒï¸	V de la victoire, ciseaux, victoire
âœŒğŸ»	V de la victoire, V de la victoireÂ : peau claire, ciseaux, peau claire, victoire
âœŒğŸ¼	V de la victoire, V de la victoireÂ : peau modÃ©rÃ©ment claire, ciseaux, peau modÃ©rÃ©ment claire, victoire
âœŒğŸ½	V de la victoire, V de la victoireÂ : peau lÃ©gÃ¨rement mate, ciseaux, peau lÃ©gÃ¨rement mate, victoire
âœŒğŸ¾	V de la victoire, V de la victoireÂ : peau modÃ©rÃ©ment foncÃ©e, ciseaux, peau modÃ©rÃ©ment foncÃ©e, victoire
âœŒğŸ¿	V de la victoire, V de la victoireÂ : peau foncÃ©e, ciseaux, peau foncÃ©e, victoire
ğŸ¤	chance, croisÃ©s, doigts, main
ğŸ¤ğŸ»	chance, croisÃ©s, doigts, doigts croisÃ©sÂ : peau claire, main, peau claire
ğŸ¤ğŸ¼	chance, croisÃ©s, doigts, doigts croisÃ©sÂ : peau modÃ©rÃ©ment claire, main, peau modÃ©rÃ©ment claire
ğŸ¤ğŸ½	chance, croisÃ©s, doigts, doigts croisÃ©sÂ : peau lÃ©gÃ¨rement mate, main, peau lÃ©gÃ¨rement mate
ğŸ¤ğŸ¾	chance, croisÃ©s, doigts, doigts croisÃ©sÂ : peau modÃ©rÃ©ment foncÃ©e, main, peau modÃ©rÃ©ment foncÃ©e
ğŸ¤ğŸ¿	chance, croisÃ©s, doigts, doigts croisÃ©sÂ : peau foncÃ©e, main, peau foncÃ©e
ğŸ¤Ÿ	amour, je tâ€™aime, main, signe
ğŸ¤ŸğŸ»	amour, je tâ€™aime, main, peau claire, signe, signe je tâ€™aimeÂ : peau claire
ğŸ¤ŸğŸ¼	amour, je tâ€™aime, main, peau modÃ©rÃ©ment claire, signe, signe je tâ€™aimeÂ : peau modÃ©rÃ©ment claire
ğŸ¤ŸğŸ½	amour, je tâ€™aime, main, peau lÃ©gÃ¨rement mate, signe, signe je tâ€™aimeÂ : peau lÃ©gÃ¨rement mate
ğŸ¤ŸğŸ¾	amour, je tâ€™aime, main, peau modÃ©rÃ©ment foncÃ©e, signe, signe je tâ€™aimeÂ : peau modÃ©rÃ©ment foncÃ©e
ğŸ¤ŸğŸ¿	amour, je tâ€™aime, main, peau foncÃ©e, signe, signe je tâ€™aimeÂ : peau foncÃ©e
ğŸ¤˜	cornes, doigts, main, rock
ğŸ¤˜ğŸ»	cornes, cornes avec les doigtsÂ : peau claire, doigts, main, peau claire, rock
ğŸ¤˜ğŸ¼	cornes, cornes avec les doigtsÂ : peau modÃ©rÃ©ment claire, doigts, main, peau modÃ©rÃ©ment claire, rock
ğŸ¤˜ğŸ½	cornes, cornes avec les doigtsÂ : peau lÃ©gÃ¨rement mate, doigts, main, peau lÃ©gÃ¨rement mate, rock
ğŸ¤˜ğŸ¾	cornes, cornes avec les doigtsÂ : peau modÃ©rÃ©ment foncÃ©e, doigts, main, peau modÃ©rÃ©ment foncÃ©e, rock
ğŸ¤˜ğŸ¿	cornes, cornes avec les doigtsÂ : peau foncÃ©e, doigts, main, peau foncÃ©e, rock
ğŸ¤™	appel, appelle-moi, main, signe, tÃ©lÃ©phone
ğŸ¤™ğŸ»	appel, appelle-moi, appelle-moiÂ : peau claire, main, peau claire, signe, tÃ©lÃ©phone
ğŸ¤™ğŸ¼	appel, appelle-moi, appelle-moiÂ : peau modÃ©rÃ©ment claire, main, peau modÃ©rÃ©ment claire, signe, tÃ©lÃ©phone
ğŸ¤™ğŸ½	appel, appelle-moi, appelle-moiÂ : peau lÃ©gÃ¨rement mate, main, peau lÃ©gÃ¨rement mate, signe, tÃ©lÃ©phone
ğŸ¤™ğŸ¾	appel, appelle-moi, appelle-moiÂ : peau modÃ©rÃ©ment foncÃ©e, main, peau modÃ©rÃ©ment foncÃ©e, signe, tÃ©lÃ©phone
ğŸ¤™ğŸ¿	appel, appelle-moi, appelle-moiÂ : peau foncÃ©e, main, peau foncÃ©e, signe, tÃ©lÃ©phone
ğŸ‘ˆï¸	dos de la main avec index pointant vers la gauche, gauche, index, main
ğŸ‘ˆğŸ»	dos de la main avec index pointant vers la gauche, dos de la main avec index pointant vers la gaucheÂ : peau claire, gauche, index, main, peau claire
ğŸ‘ˆğŸ¼	dos de la main avec index pointant vers la gauche, dos de la main avec index pointant vers la gaucheÂ : peau modÃ©rÃ©ment claire, gauche, index, main, peau modÃ©rÃ©ment claire
ğŸ‘ˆğŸ½	dos de la main avec index pointant vers la gauche, dos de la main avec index pointant vers la gaucheÂ : peau lÃ©gÃ¨rement mate, gauche, index, main, peau lÃ©gÃ¨rement mate
ğŸ‘ˆğŸ¾	dos de la main avec index pointant vers la gauche, dos de la main avec index pointant vers la gaucheÂ : peau modÃ©rÃ©ment foncÃ©e, gauche, index, main, peau modÃ©rÃ©ment foncÃ©e
ğŸ‘ˆğŸ¿	dos de la main avec index pointant vers la gauche, dos de la main avec index pointant vers la gaucheÂ : peau foncÃ©e, gauche, index, main, peau foncÃ©e
ğŸ‘‰ï¸	dos de la main avec index pointant vers la droite, droite, index, main
ğŸ‘‰ğŸ»	dos de la main avec index pointant vers la droite, dos de la main avec index pointant vers la droiteÂ : peau claire, droite, index, main, peau claire
ğŸ‘‰ğŸ¼	dos de la main avec index pointant vers la droite, dos de la main avec index pointant vers la droiteÂ : peau modÃ©rÃ©ment claire, droite, index, main, peau modÃ©rÃ©ment claire
ğŸ‘‰ğŸ½	dos de la main avec index pointant vers la droite, dos de la main avec index pointant vers la droiteÂ : peau lÃ©gÃ¨rement mate, droite, index, main, peau lÃ©gÃ¨rement mate
ğŸ‘‰ğŸ¾	dos de la main avec index pointant vers la droite, dos de la main avec index pointant vers la droiteÂ : peau modÃ©rÃ©ment foncÃ©e, droite, index, main, peau modÃ©rÃ©ment foncÃ©e
ğŸ‘‰ğŸ¿	dos de la main avec index pointant vers la droite, dos de la main avec index pointant vers la droiteÂ : peau foncÃ©e, droite, index, main, peau foncÃ©e
ğŸ‘†ï¸	dos de la main avec index pointant vers le haut, haut, index, main
ğŸ‘†ğŸ»	dos de la main avec index pointant vers le haut, dos de la main avec index pointant vers le hautÂ : peau claire, haut, index, main, peau claire
ğŸ‘†ğŸ¼	dos de la main avec index pointant vers le haut, dos de la main avec index pointant vers le hautÂ : peau modÃ©rÃ©ment claire, haut, index, main, peau modÃ©rÃ©ment claire
ğŸ‘†ğŸ½	dos de la main avec index pointant vers le haut, dos de la main avec index pointant vers le hautÂ : peau lÃ©gÃ¨rement mate, haut, index, main, peau lÃ©gÃ¨rement mate
ğŸ‘†ğŸ¾	dos de la main avec index pointant vers le haut, dos de la main avec index pointant vers le hautÂ : peau modÃ©rÃ©ment foncÃ©e, haut, index, main, peau modÃ©rÃ©ment foncÃ©e
ğŸ‘†ğŸ¿	dos de la main avec index pointant vers le haut, dos de la main avec index pointant vers le hautÂ : peau foncÃ©e, haut, index, main, peau foncÃ©e
ğŸ–•	doigt dâ€™honneur, main, majeur
ğŸ–•ğŸ»	doigt dâ€™honneur, doigt dâ€™honneurÂ : peau claire, main, majeur, peau claire
ğŸ–•ğŸ¼	doigt dâ€™honneur, doigt dâ€™honneurÂ : peau modÃ©rÃ©ment claire, main, majeur, peau modÃ©rÃ©ment claire
ğŸ–•ğŸ½	doigt dâ€™honneur, doigt dâ€™honneurÂ : peau lÃ©gÃ¨rement mate, main, majeur, peau lÃ©gÃ¨rement mate
ğŸ–•ğŸ¾	doigt dâ€™honneur, doigt dâ€™honneurÂ : peau modÃ©rÃ©ment foncÃ©e, main, majeur, peau modÃ©rÃ©ment foncÃ©e
ğŸ–•ğŸ¿	doigt dâ€™honneur, doigt dâ€™honneurÂ : peau foncÃ©e, main, majeur, peau foncÃ©e
ğŸ‘‡ï¸	bas, dos de la main avec index pointant vers le bas, index, main
ğŸ‘‡ğŸ»	bas, dos de la main avec index pointant vers le bas, dos de la main avec index pointant vers le basÂ : peau claire, index, main, peau claire
ğŸ‘‡ğŸ¼	bas, dos de la main avec index pointant vers le bas, dos de la main avec index pointant vers le basÂ : peau modÃ©rÃ©ment claire, index, main, peau modÃ©rÃ©ment claire
ğŸ‘‡ğŸ½	bas, dos de la main avec index pointant vers le bas, dos de la main avec index pointant vers le basÂ : peau lÃ©gÃ¨rement mate, index, main, peau lÃ©gÃ¨rement mate
ğŸ‘‡ğŸ¾	bas, dos de la main avec index pointant vers le bas, dos de la main avec index pointant vers le basÂ : peau modÃ©rÃ©ment foncÃ©e, index, main, peau modÃ©rÃ©ment foncÃ©e
ğŸ‘‡ğŸ¿	bas, dos de la main avec index pointant vers le bas, dos de la main avec index pointant vers le basÂ : peau foncÃ©e, index, main, peau foncÃ©e
â˜ï¸	index pointant vers le haut
â˜ğŸ»	index pointant vers le haut, index pointant vers le hautÂ : peau claire, peau claire
â˜ğŸ¼	index pointant vers le haut, index pointant vers le hautÂ : peau modÃ©rÃ©ment claire, peau modÃ©rÃ©ment claire
â˜ğŸ½	index pointant vers le haut, index pointant vers le hautÂ : peau lÃ©gÃ¨rement mate, peau lÃ©gÃ¨rement mate
â˜ğŸ¾	index pointant vers le haut, index pointant vers le hautÂ : peau modÃ©rÃ©ment foncÃ©e, peau modÃ©rÃ©ment foncÃ©e
â˜ğŸ¿	index pointant vers le haut, index pointant vers le hautÂ : peau foncÃ©e, peau foncÃ©e
ğŸ‘ï¸	OK, gÃ©nial, oui, pouce vers le haut, super
ğŸ‘ğŸ»	OK, gÃ©nial, oui, peau claire, pouce vers le haut, pouce vers le hautÂ : peau claire, super
ğŸ‘ğŸ¼	OK, gÃ©nial, oui, peau modÃ©rÃ©ment claire, pouce vers le haut, pouce vers le hautÂ : peau modÃ©rÃ©ment claire, super
ğŸ‘ğŸ½	OK, gÃ©nial, oui, peau lÃ©gÃ¨rement mate, pouce vers le haut, pouce vers le hautÂ : peau lÃ©gÃ¨rement mate, super
ğŸ‘ğŸ¾	OK, gÃ©nial, oui, peau modÃ©rÃ©ment foncÃ©e, pouce vers le haut, pouce vers le hautÂ : peau modÃ©rÃ©ment foncÃ©e, super
ğŸ‘ğŸ¿	OK, gÃ©nial, oui, peau foncÃ©e, pouce vers le haut, pouce vers le hautÂ : peau foncÃ©e, super
ğŸ‘ï¸	non, nul, nÃ©gatif, pouce vers le bas
ğŸ‘ğŸ»	non, nul, nÃ©gatif, peau claire, pouce vers le bas, pouce vers le basÂ : peau claire
ğŸ‘ğŸ¼	non, nul, nÃ©gatif, peau modÃ©rÃ©ment claire, pouce vers le bas, pouce vers le basÂ : peau modÃ©rÃ©ment claire
ğŸ‘ğŸ½	non, nul, nÃ©gatif, peau lÃ©gÃ¨rement mate, pouce vers le bas, pouce vers le basÂ : peau lÃ©gÃ¨rement mate
ğŸ‘ğŸ¾	non, nul, nÃ©gatif, peau modÃ©rÃ©ment foncÃ©e, pouce vers le bas, pouce vers le basÂ : peau modÃ©rÃ©ment foncÃ©e
ğŸ‘ğŸ¿	non, nul, nÃ©gatif, peau foncÃ©e, pouce vers le bas, pouce vers le basÂ : peau foncÃ©e
âœŠ	levÃ©, main, pierre, poing
âœŠğŸ»	levÃ©, main, peau claire, pierre, poing, poing levÃ©Â : peau claire
âœŠğŸ¼	levÃ©, main, peau modÃ©rÃ©ment claire, pierre, poing, poing levÃ©Â : peau modÃ©rÃ©ment claire
âœŠğŸ½	levÃ©, main, peau lÃ©gÃ¨rement mate, pierre, poing, poing levÃ©Â : peau lÃ©gÃ¨rement mate
âœŠğŸ¾	levÃ©, main, peau modÃ©rÃ©ment foncÃ©e, pierre, poing, poing levÃ©Â : peau modÃ©rÃ©ment foncÃ©e
âœŠğŸ¿	levÃ©, main, peau foncÃ©e, pierre, poing, poing levÃ©Â : peau foncÃ©e
ğŸ‘ŠğŸ»	poing de faceÂ : peau claire
ğŸ‘ŠğŸ¼	coup de poing, main, peau modÃ©rÃ©ment claire, poing, poing de face, poing de faceÂ : peau modÃ©rÃ©ment claire
ğŸ‘ŠğŸ½	poing de faceÂ : peau lÃ©gÃ¨rement mate
ğŸ‘ŠğŸ¾	coup de poing, main, peau modÃ©rÃ©ment foncÃ©e, poing, poing de face, poing de faceÂ : peau modÃ©rÃ©ment foncÃ©e
ğŸ‘ŠğŸ¿	poing de faceÂ : peau foncÃ©e
ğŸ¤›	gauche, poing
ğŸ¤›ğŸ»	gauche, peau claire, poing, poing Ã  gaucheÂ : peau claire
ğŸ¤›ğŸ¼	gauche, peau modÃ©rÃ©ment claire, poing, poing Ã  gaucheÂ : peau modÃ©rÃ©ment claire
ğŸ¤›ğŸ½	gauche, peau lÃ©gÃ¨rement mate, poing, poing Ã  gaucheÂ : peau lÃ©gÃ¨rement mate
ğŸ¤›ğŸ¾	gauche, peau modÃ©rÃ©ment foncÃ©e, poing, poing Ã  gaucheÂ : peau modÃ©rÃ©ment foncÃ©e
ğŸ¤›ğŸ¿	gauche, peau foncÃ©e, poing, poing Ã  gaucheÂ : peau foncÃ©e
ğŸ¤œ	droite, poing
ğŸ¤œğŸ»	droite, peau claire, poing, poing Ã  droiteÂ : peau claire
ğŸ¤œğŸ¼	droite, peau modÃ©rÃ©ment claire, poing, poing Ã  droiteÂ : peau modÃ©rÃ©ment claire
ğŸ¤œğŸ½	droite, peau lÃ©gÃ¨rement mate, poing, poing Ã  droiteÂ : peau lÃ©gÃ¨rement mate
ğŸ¤œğŸ¾	droite, peau modÃ©rÃ©ment foncÃ©e, poing, poing Ã  droiteÂ : peau modÃ©rÃ©ment foncÃ©e
ğŸ¤œğŸ¿	droite, peau foncÃ©e, poing, poing Ã  droiteÂ : peau foncÃ©e
ğŸ‘	applaudissements, bravo, main
ğŸ‘ğŸ»	applaudissements, applaudissementsÂ : peau claire, bravo, main, peau claire
ğŸ‘ğŸ¼	applaudissements, applaudissementsÂ : peau modÃ©rÃ©ment claire, bravo, main, peau modÃ©rÃ©ment claire
ğŸ‘ğŸ½	applaudissements, applaudissementsÂ : peau lÃ©gÃ¨rement mate, bravo, main, peau lÃ©gÃ¨rement mate
ğŸ‘ğŸ¾	applaudissements, applaudissementsÂ : peau modÃ©rÃ©ment foncÃ©e, bravo, main, peau modÃ©rÃ©ment foncÃ©e
ğŸ‘ğŸ¿	applaudissements, applaudissementsÂ : peau foncÃ©e, bravo, main, peau foncÃ©e
ğŸ™Œ	air, cÃ©lÃ©bration, geste, hourra, levÃ©es, mains
ğŸ™ŒğŸ»	air, cÃ©lÃ©bration, geste, hourra, levÃ©es, mains, mains levÃ©esÂ : peau claire, peau claire
ğŸ™ŒğŸ¼	air, cÃ©lÃ©bration, geste, hourra, levÃ©es, mains, mains levÃ©esÂ : peau modÃ©rÃ©ment claire, peau modÃ©rÃ©ment claire
ğŸ™ŒğŸ½	air, cÃ©lÃ©bration, geste, hourra, levÃ©es, mains, mains levÃ©esÂ : peau lÃ©gÃ¨rement mate, peau lÃ©gÃ¨rement mate
ğŸ™ŒğŸ¾	air, cÃ©lÃ©bration, geste, hourra, levÃ©es, mains, mains levÃ©esÂ : peau modÃ©rÃ©ment foncÃ©e, peau modÃ©rÃ©ment foncÃ©e
ğŸ™ŒğŸ¿	air, cÃ©lÃ©bration, geste, hourra, levÃ©es, mains, mains levÃ©esÂ : peau foncÃ©e, peau foncÃ©e
ğŸ‘	main, ouvertes
ğŸ‘ğŸ»	main, mains ouvertesÂ : peau claire, ouvertes, peau claire
ğŸ‘ğŸ¼	main, mains ouvertesÂ : peau modÃ©rÃ©ment claire, ouvertes, peau modÃ©rÃ©ment claire
ğŸ‘ğŸ½	main, mains ouvertesÂ : peau lÃ©gÃ¨rement mate, ouvertes, peau lÃ©gÃ¨rement mate
ğŸ‘ğŸ¾	main, mains ouvertesÂ : peau modÃ©rÃ©ment foncÃ©e, ouvertes, peau modÃ©rÃ©ment foncÃ©e
ğŸ‘ğŸ¿	main, mains ouvertesÂ : peau foncÃ©e, ouvertes, peau foncÃ©e
ğŸ¤²	moins jointes, paume contre paume, priÃ¨re
ğŸ¤²ğŸ»	moins jointes, paume contre paume, paume contre paume doigts vers le hautÂ : peau claire, peau claire, priÃ¨re
ğŸ¤²ğŸ¼	moins jointes, paume contre paume, paume contre paume doigts vers le hautÂ : peau modÃ©rÃ©ment claire, peau modÃ©rÃ©ment claire, priÃ¨re
ğŸ¤²ğŸ½	moins jointes, paume contre paume, paume contre paume doigts vers le hautÂ : peau lÃ©gÃ¨rement mate, peau lÃ©gÃ¨rement mate, priÃ¨re
ğŸ¤²ğŸ¾	moins jointes, paume contre paume, paume contre paume doigts vers le hautÂ : peau modÃ©rÃ©ment foncÃ©e, peau modÃ©rÃ©ment foncÃ©e, priÃ¨re
ğŸ¤²ğŸ¿	moins jointes, paume contre paume, paume contre paume doigts vers le hautÂ : peau foncÃ©e, peau foncÃ©e, priÃ¨re
ğŸ¤	accord, main, poignÃ©e, poignÃ©e de main, prÃ©sentation, rencontre
ğŸ™	mains, merci, moins jointes, priÃ¨re, svp
ğŸ™ğŸ»	mains, mains en priÃ¨reÂ : peau claire, merci, moins jointes, peau claire, priÃ¨re, svp
ğŸ™ğŸ¼	mains, mains en priÃ¨reÂ : peau modÃ©rÃ©ment claire, merci, moins jointes, peau modÃ©rÃ©ment claire, priÃ¨re, svp
ğŸ™ğŸ½	mains, mains en priÃ¨reÂ : peau lÃ©gÃ¨rement mate, merci, moins jointes, peau lÃ©gÃ¨rement mate, priÃ¨re, svp
ğŸ™ğŸ¾	mains, mains en priÃ¨reÂ : peau modÃ©rÃ©ment foncÃ©e, merci, moins jointes, peau modÃ©rÃ©ment foncÃ©e, priÃ¨re, svp
ğŸ™ğŸ¿	mains, mains en priÃ¨reÂ : peau foncÃ©e, merci, moins jointes, peau foncÃ©e, priÃ¨re, svp
âœï¸	main, Ã©crire
âœğŸ»	main, main qui Ã©critÂ : peau claire, peau claire, Ã©crire
âœğŸ¼	main, main qui Ã©critÂ : peau modÃ©rÃ©ment claire, peau modÃ©rÃ©ment claire, Ã©crire
âœğŸ½	main, main qui Ã©critÂ : peau lÃ©gÃ¨rement mate, peau lÃ©gÃ¨rement mate, Ã©crire
âœğŸ¾	main, main qui Ã©critÂ : peau modÃ©rÃ©ment foncÃ©e, peau modÃ©rÃ©ment foncÃ©e, Ã©crire
âœğŸ¿	main, main qui Ã©critÂ : peau foncÃ©e, peau foncÃ©e, Ã©crire
ğŸ’…	manucure, maquillage, ongle, vernis
ğŸ’…ğŸ»	manucure, maquillage, ongle, peau claire, vernis, vernis Ã  onglesÂ : peau claire
ğŸ’…ğŸ¼	manucure, maquillage, ongle, peau modÃ©rÃ©ment claire, vernis, vernis Ã  onglesÂ : peau modÃ©rÃ©ment claire
ğŸ’…ğŸ½	manucure, maquillage, ongle, peau lÃ©gÃ¨rement mate, vernis, vernis Ã  onglesÂ : peau lÃ©gÃ¨rement mate
ğŸ’…ğŸ¾	manucure, maquillage, ongle, peau modÃ©rÃ©ment foncÃ©e, vernis, vernis Ã  onglesÂ : peau modÃ©rÃ©ment foncÃ©e
ğŸ’…ğŸ¿	manucure, maquillage, ongle, peau foncÃ©e, vernis, vernis Ã  onglesÂ : peau foncÃ©e
ğŸ¤³	appareil photo, autophoto, selfie, tÃ©lÃ©phone
ğŸ¤³ğŸ»	appareil photo, autophoto, autophotoÂ : peau claire, peau claire, selfie, tÃ©lÃ©phone
ğŸ¤³ğŸ¼	appareil photo, autophoto, autophotoÂ : peau modÃ©rÃ©ment claire, peau modÃ©rÃ©ment claire, selfie, tÃ©lÃ©phone
ğŸ¤³ğŸ½	appareil photo, autophoto, autophotoÂ : peau lÃ©gÃ¨rement mate, peau lÃ©gÃ¨rement mate, selfie, tÃ©lÃ©phone
ğŸ¤³ğŸ¾	appareil photo, autophoto, autophotoÂ : peau modÃ©rÃ©ment foncÃ©e, peau modÃ©rÃ©ment foncÃ©e, selfie, tÃ©lÃ©phone
ğŸ¤³ğŸ¿	appareil photo, autophoto, autophotoÂ : peau foncÃ©e, peau foncÃ©e, selfie, tÃ©lÃ©phone
ğŸ’ªğŸ»	biceps contractÃ©Â : peau claire
ğŸ’ªğŸ¼	biceps, biceps contractÃ©Â : peau modÃ©rÃ©ment claire, contractÃ©, corps, muscle, peau modÃ©rÃ©ment claire
ğŸ’ªğŸ½	biceps contractÃ©Â : peau lÃ©gÃ¨rement mate
ğŸ’ªğŸ¾	biceps, biceps contractÃ©Â : peau modÃ©rÃ©ment foncÃ©e, contractÃ©, corps, muscle, peau modÃ©rÃ©ment foncÃ©e
ğŸ’ªğŸ¿	biceps contractÃ©Â : peau foncÃ©e
ğŸ¦¾	accessibilitÃ©, bras, prothÃ¨se
ğŸ¦¿	accessibilitÃ©, jambe, prothÃ¨se
ğŸ¦µğŸ»	jambeÂ : peau claire
ğŸ¦µğŸ¼	coup de pied, jambe, jambeÂ : peau modÃ©rÃ©ment claire, membre, peau modÃ©rÃ©ment claire
ğŸ¦µğŸ½	jambeÂ : peau lÃ©gÃ¨rement mate
ğŸ¦µğŸ¾	coup de pied, jambe, jambeÂ : peau modÃ©rÃ©ment foncÃ©e, membre, peau modÃ©rÃ©ment foncÃ©e
ğŸ¦µğŸ¿	jambeÂ : peau foncÃ©e
ğŸ¦¶ğŸ»	piedÂ : peau claire
ğŸ¦¶ğŸ¼	coup de pied, pas lourd, peau modÃ©rÃ©ment claire, pied, piedÂ : peau modÃ©rÃ©ment claire
ğŸ¦¶ğŸ½	piedÂ : peau lÃ©gÃ¨rement mate
ğŸ¦¶ğŸ¾	coup de pied, pas lourd, peau modÃ©rÃ©ment foncÃ©e, pied, piedÂ : peau modÃ©rÃ©ment foncÃ©e
ğŸ¦¶ğŸ¿	piedÂ : peau foncÃ©e
ğŸ‘‚ğŸ»	oreilleÂ : peau claire
ğŸ‘‚ğŸ¼	corps, oreille, oreilleÂ : peau modÃ©rÃ©ment claire, peau modÃ©rÃ©ment claire
ğŸ‘‚ğŸ½	oreilleÂ : peau lÃ©gÃ¨rement mate
ğŸ‘‚ğŸ¾	corps, oreille, oreilleÂ : peau modÃ©rÃ©ment foncÃ©e, peau modÃ©rÃ©ment foncÃ©e
ğŸ‘‚ğŸ¿	oreilleÂ : peau foncÃ©e
ğŸ¦»ğŸ»	oreille appareillÃ©eÂ : peau claire
ğŸ¦»ğŸ¼	accessibilitÃ©, malentendant, oreille appareillÃ©e, oreille appareillÃ©eÂ : peau modÃ©rÃ©ment claire, peau modÃ©rÃ©ment claire, prothÃ¨se auditive
ğŸ¦»ğŸ½	oreille appareillÃ©eÂ : peau lÃ©gÃ¨rement mate
ğŸ¦»ğŸ¾	accessibilitÃ©, malentendant, oreille appareillÃ©e, oreille appareillÃ©eÂ : peau modÃ©rÃ©ment foncÃ©e, peau modÃ©rÃ©ment foncÃ©e, prothÃ¨se auditive
ğŸ¦»ğŸ¿	oreille appareillÃ©eÂ : peau foncÃ©e
ğŸ‘ƒğŸ»	nezÂ : peau claire
ğŸ‘ƒğŸ¼	corps, nez, nezÂ : peau modÃ©rÃ©ment claire, peau modÃ©rÃ©ment claire
ğŸ‘ƒğŸ½	nezÂ : peau lÃ©gÃ¨rement mate
ğŸ‘ƒğŸ¾	corps, nez, nezÂ : peau modÃ©rÃ©ment foncÃ©e, peau modÃ©rÃ©ment foncÃ©e
ğŸ‘ƒğŸ¿	nezÂ : peau foncÃ©e
ğŸ‘¶	bÃ©bÃ©, petit
ğŸ‘¶ğŸ»	bÃ©bÃ©, bÃ©bÃ©Â : peau claire, peau claire, petit
ğŸ‘¶ğŸ¼	bÃ©bÃ©, bÃ©bÃ©Â : peau modÃ©rÃ©ment claire, peau modÃ©rÃ©ment claire, petit
ğŸ‘¶ğŸ½	bÃ©bÃ©, bÃ©bÃ©Â : peau lÃ©gÃ¨rement mate, peau lÃ©gÃ¨rement mate, petit
ğŸ‘¶ğŸ¾	bÃ©bÃ©, bÃ©bÃ©Â : peau modÃ©rÃ©ment foncÃ©e, peau modÃ©rÃ©ment foncÃ©e, petit
ğŸ‘¶ğŸ¿	bÃ©bÃ©, bÃ©bÃ©Â : peau foncÃ©e, peau foncÃ©e, petit
ğŸ§’	enfant, genre non dÃ©fini, jeune
ğŸ§’ğŸ»	enfant, enfantÂ : peau claire, genre non dÃ©fini, jeune, peau claire
ğŸ§’ğŸ¼	enfant, enfantÂ : peau modÃ©rÃ©ment claire, genre non dÃ©fini, jeune, peau modÃ©rÃ©ment claire
ğŸ§’ğŸ½	enfant, enfantÂ : peau lÃ©gÃ¨rement mate, genre non dÃ©fini, jeune, peau lÃ©gÃ¨rement mate
ğŸ§’ğŸ¾	enfant, enfantÂ : peau modÃ©rÃ©ment foncÃ©e, genre non dÃ©fini, jeune, peau modÃ©rÃ©ment foncÃ©e
ğŸ§’ğŸ¿	enfant, enfantÂ : peau foncÃ©e, genre non dÃ©fini, jeune, peau foncÃ©e
ğŸ‘¦ğŸ»	garÃ§onÂ : peau claire
ğŸ‘¦ğŸ¼	garÃ§on, garÃ§onÂ : peau modÃ©rÃ©ment claire, jeune, peau modÃ©rÃ©ment claire
ğŸ‘¦ğŸ½	garÃ§onÂ : peau lÃ©gÃ¨rement mate
ğŸ‘¦ğŸ¾	garÃ§on, garÃ§onÂ : peau modÃ©rÃ©ment foncÃ©e, jeune, peau modÃ©rÃ©ment foncÃ©e
ğŸ‘¦ğŸ¿	garÃ§onÂ : peau foncÃ©e
ğŸ‘§ğŸ»	filleÂ : peau claire
ğŸ‘§ğŸ¼	fille, filleÂ : peau modÃ©rÃ©ment claire, jeune, peau modÃ©rÃ©ment claire, vierge, zodiaque
ğŸ‘§ğŸ½	filleÂ : peau lÃ©gÃ¨rement mate
ğŸ‘§ğŸ¾	fille, filleÂ : peau modÃ©rÃ©ment foncÃ©e, jeune, peau modÃ©rÃ©ment foncÃ©e, vierge, zodiaque
ğŸ‘§ğŸ¿	filleÂ : peau foncÃ©e
ğŸ§‘	adulte, genre non dÃ©fini, personne
ğŸ§‘ğŸ»	adulte, adulteÂ : peau claire, genre non dÃ©fini, peau claire, personne
ğŸ§‘ğŸ¼	adulte, adulteÂ : peau modÃ©rÃ©ment claire, genre non dÃ©fini, peau modÃ©rÃ©ment claire, personne
ğŸ§‘ğŸ½	adulte, adulteÂ : peau lÃ©gÃ¨rement mate, genre non dÃ©fini, peau lÃ©gÃ¨rement mate, personne
ğŸ§‘ğŸ¾	adulte, adulteÂ : peau modÃ©rÃ©ment foncÃ©e, genre non dÃ©fini, peau modÃ©rÃ©ment foncÃ©e, personne
ğŸ§‘ğŸ¿	adulte, adulteÂ : peau foncÃ©e, genre non dÃ©fini, peau foncÃ©e, personne
ğŸ‘±	blond, personne blonde
ğŸ‘±ğŸ»	blond, peau claire, personne blonde, personne blondeÂ : peau claire
ğŸ‘±ğŸ¼	blond, peau modÃ©rÃ©ment claire, personne blonde, personne blondeÂ : peau modÃ©rÃ©ment claire
ğŸ‘±ğŸ½	blond, peau lÃ©gÃ¨rement mate, personne blonde, personne blondeÂ : peau lÃ©gÃ¨rement mate
ğŸ‘±ğŸ¾	blond, peau modÃ©rÃ©ment foncÃ©e, personne blonde, personne blondeÂ : peau modÃ©rÃ©ment foncÃ©e
ğŸ‘±ğŸ¿	blond, peau foncÃ©e, personne blonde, personne blondeÂ : peau foncÃ©e
ğŸ‘¨	adulte, homme
ğŸ‘¨ğŸ»	adulte, homme, hommeÂ : peau claire, peau claire
ğŸ‘¨ğŸ¼	adulte, homme, hommeÂ : peau modÃ©rÃ©ment claire, peau modÃ©rÃ©ment claire
ğŸ‘¨ğŸ½	adulte, homme, hommeÂ : peau lÃ©gÃ¨rement mate, peau lÃ©gÃ¨rement mate
ğŸ‘¨ğŸ¾	adulte, homme, hommeÂ : peau modÃ©rÃ©ment foncÃ©e, peau modÃ©rÃ©ment foncÃ©e
ğŸ‘¨ğŸ¿	adulte, homme, hommeÂ : peau foncÃ©e, peau foncÃ©e
ğŸ§”	barbe, barbu, personne
ğŸ§”ğŸ»	barbe, barbu, homme barbuÂ : peau claire, peau claire, personne
ğŸ§”ğŸ¼	barbe, barbu, homme barbuÂ : peau modÃ©rÃ©ment claire, peau modÃ©rÃ©ment claire, personne
ğŸ§”ğŸ½	barbe, barbu, homme barbuÂ : peau lÃ©gÃ¨rement mate, peau lÃ©gÃ¨rement mate, personne
ğŸ§”ğŸ¾	barbe, barbu, homme barbuÂ : peau modÃ©rÃ©ment foncÃ©e, peau modÃ©rÃ©ment foncÃ©e, personne
ğŸ§”ğŸ¿	barbe, barbu, homme barbuÂ : peau foncÃ©e, peau foncÃ©e, personne
ğŸ‘±â€â™‚	blond, homme
ğŸ‘±ğŸ»â€â™‚	blond, homme, homme blondÂ : peau claire, peau claire
ğŸ‘±ğŸ¼â€â™‚	blond, homme, homme blondÂ : peau modÃ©rÃ©ment claire, peau modÃ©rÃ©ment claire
ğŸ‘±ğŸ½â€â™‚	blond, homme, homme blondÂ : peau lÃ©gÃ¨rement mate, peau lÃ©gÃ¨rement mate
ğŸ‘±ğŸ¾â€â™‚	blond, homme, homme blondÂ : peau modÃ©rÃ©ment foncÃ©e, peau modÃ©rÃ©ment foncÃ©e
ğŸ‘±ğŸ¿â€â™‚	blond, homme, homme blondÂ : peau foncÃ©e, peau foncÃ©e
ğŸ‘¨â€ğŸ¦°	adulte, cheveux roux, homme, hommeÂ : cheveux roux
ğŸ‘¨ğŸ»â€ğŸ¦°	adulte, cheveux roux, homme, hommeÂ : peau claire et cheveux roux, peau claire
ğŸ‘¨ğŸ¼â€ğŸ¦°	adulte, cheveux roux, homme, hommeÂ : peau modÃ©rÃ©ment claire et cheveux roux, peau modÃ©rÃ©ment claire
ğŸ‘¨ğŸ½â€ğŸ¦°	adulte, cheveux roux, homme, hommeÂ : peau lÃ©gÃ¨rement mate et cheveux roux, peau lÃ©gÃ¨rement mate
ğŸ‘¨ğŸ¾â€ğŸ¦°	adulte, cheveux roux, homme, hommeÂ : peau modÃ©rÃ©ment foncÃ©e et cheveux roux, peau modÃ©rÃ©ment foncÃ©e
ğŸ‘¨ğŸ¿â€ğŸ¦°	adulte, cheveux roux, homme, hommeÂ : peau foncÃ©e et cheveux roux, peau foncÃ©e
ğŸ‘¨â€ğŸ¦±	adulte, cheveux bouclÃ©s, homme, hommeÂ : cheveux bouclÃ©s
ğŸ‘¨ğŸ»â€ğŸ¦±	adulte, cheveux bouclÃ©s, homme, hommeÂ : peau claire et cheveux bouclÃ©s, peau claire
ğŸ‘¨ğŸ¼â€ğŸ¦±	adulte, cheveux bouclÃ©s, homme, hommeÂ : peau modÃ©rÃ©ment claire et cheveux bouclÃ©s, peau modÃ©rÃ©ment claire
ğŸ‘¨ğŸ½â€ğŸ¦±	adulte, cheveux bouclÃ©s, homme, hommeÂ : peau lÃ©gÃ¨rement mate et cheveux bouclÃ©s, peau lÃ©gÃ¨rement mate
ğŸ‘¨ğŸ¾â€ğŸ¦±	adulte, cheveux bouclÃ©s, homme, hommeÂ : peau modÃ©rÃ©ment foncÃ©e et cheveux bouclÃ©s, peau modÃ©rÃ©ment foncÃ©e
ğŸ‘¨ğŸ¿â€ğŸ¦±	adulte, cheveux bouclÃ©s, homme, hommeÂ : peau foncÃ©e et cheveux bouclÃ©s, peau foncÃ©e
ğŸ‘¨â€ğŸ¦³	adulte, cheveux blancs, homme, hommeÂ : cheveux blancs
ğŸ‘¨ğŸ»â€ğŸ¦³	adulte, cheveux blancs, homme, hommeÂ : peau claire et cheveux blancs, peau claire
ğŸ‘¨ğŸ¼â€ğŸ¦³	adulte, cheveux blancs, homme, hommeÂ : peau modÃ©rÃ©ment claire et cheveux blancs, peau modÃ©rÃ©ment claire
ğŸ‘¨ğŸ½â€ğŸ¦³	adulte, cheveux blancs, homme, hommeÂ : peau lÃ©gÃ¨rement mate et cheveux blancs, peau lÃ©gÃ¨rement mate
ğŸ‘¨ğŸ¾â€ğŸ¦³	adulte, cheveux blancs, homme, hommeÂ : peau modÃ©rÃ©ment foncÃ©e et cheveux blancs, peau modÃ©rÃ©ment foncÃ©e
ğŸ‘¨ğŸ¿â€ğŸ¦³	adulte, cheveux blancs, homme, hommeÂ : peau foncÃ©e et cheveux blancs, peau foncÃ©e
ğŸ‘¨â€ğŸ¦²	adulte, chauve, homme, hommeÂ : chauve
ğŸ‘¨ğŸ»â€ğŸ¦²	adulte, chauve, homme, hommeÂ : peau claire et chauve, peau claire
ğŸ‘¨ğŸ¼â€ğŸ¦²	adulte, chauve, homme, hommeÂ : peau modÃ©rÃ©ment claire et chauve, peau modÃ©rÃ©ment claire
ğŸ‘¨ğŸ½â€ğŸ¦²	adulte, chauve, homme, hommeÂ : peau lÃ©gÃ¨rement mate et chauve, peau lÃ©gÃ¨rement mate
ğŸ‘¨ğŸ¾â€ğŸ¦²	adulte, chauve, homme, hommeÂ : peau modÃ©rÃ©ment foncÃ©e et chauve, peau modÃ©rÃ©ment foncÃ©e
ğŸ‘¨ğŸ¿â€ğŸ¦²	adulte, chauve, homme, hommeÂ : peau foncÃ©e et chauve, peau foncÃ©e
ğŸ‘©	adulte, femme
ğŸ‘©ğŸ»	adulte, femme, femmeÂ : peau claire, peau claire
ğŸ‘©ğŸ¼	adulte, femme, femmeÂ : peau modÃ©rÃ©ment claire, peau modÃ©rÃ©ment claire
ğŸ‘©ğŸ½	adulte, femme, femmeÂ : peau lÃ©gÃ¨rement mate, peau lÃ©gÃ¨rement mate
ğŸ‘©ğŸ¾	adulte, femme, femmeÂ : peau modÃ©rÃ©ment foncÃ©e, peau modÃ©rÃ©ment foncÃ©e
ğŸ‘©ğŸ¿	adulte, femme, femmeÂ : peau foncÃ©e, peau foncÃ©e
ğŸ‘±â€â™€	blonde, femme
ğŸ‘±ğŸ»â€â™€	blonde, femme, femme blondeÂ : peau claire, peau claire
ğŸ‘±ğŸ¼â€â™€	blonde, femme, femme blondeÂ : peau modÃ©rÃ©ment claire, peau modÃ©rÃ©ment claire
ğŸ‘±ğŸ½â€â™€	blonde, femme, femme blondeÂ : peau lÃ©gÃ¨rement mate, peau lÃ©gÃ¨rement mate
ğŸ‘±ğŸ¾â€â™€	blonde, femme, femme blondeÂ : peau modÃ©rÃ©ment foncÃ©e, peau modÃ©rÃ©ment foncÃ©e
ğŸ‘±ğŸ¿â€â™€	blonde, femme, femme blondeÂ : peau foncÃ©e, peau foncÃ©e
ğŸ‘©â€ğŸ¦°	adulte, cheveux roux, femme, femmeÂ : cheveux roux
ğŸ‘©ğŸ»â€ğŸ¦°	adulte, cheveux roux, femme, femmeÂ : peau claire et cheveux roux, peau claire
ğŸ‘©ğŸ¼â€ğŸ¦°	adulte, cheveux roux, femme, femmeÂ : peau modÃ©rÃ©ment claire et cheveux roux, peau modÃ©rÃ©ment claire
ğŸ‘©ğŸ½â€ğŸ¦°	adulte, cheveux roux, femme, femmeÂ : peau lÃ©gÃ¨rement mate et cheveux roux, peau lÃ©gÃ¨rement mate
ğŸ‘©ğŸ¾â€ğŸ¦°	adulte, cheveux roux, femme, femmeÂ : peau modÃ©rÃ©ment foncÃ©e et cheveux roux, peau modÃ©rÃ©ment foncÃ©e
ğŸ‘©ğŸ¿â€ğŸ¦°	adulte, cheveux roux, femme, femmeÂ : peau foncÃ©e et cheveux roux, peau foncÃ©e
ğŸ‘©â€ğŸ¦±	adulte, cheveux bouclÃ©s, femme, femmeÂ : cheveux bouclÃ©s
ğŸ‘©ğŸ»â€ğŸ¦±	adulte, cheveux bouclÃ©s, femme, femmeÂ : peau claire et cheveux bouclÃ©s, peau claire
ğŸ‘©ğŸ¼â€ğŸ¦±	adulte, cheveux bouclÃ©s, femme, femmeÂ : peau modÃ©rÃ©ment claire et cheveux bouclÃ©s, peau modÃ©rÃ©ment claire
ğŸ‘©ğŸ½â€ğŸ¦±	adulte, cheveux bouclÃ©s, femme, femmeÂ : peau lÃ©gÃ¨rement mate et cheveux bouclÃ©s, peau lÃ©gÃ¨rement mate
ğŸ‘©ğŸ¾â€ğŸ¦±	adulte, cheveux bouclÃ©s, femme, femmeÂ : peau modÃ©rÃ©ment foncÃ©e et cheveux bouclÃ©s, peau modÃ©rÃ©ment foncÃ©e
ğŸ‘©ğŸ¿â€ğŸ¦±	adulte, cheveux bouclÃ©s, femme, femmeÂ : peau foncÃ©e et cheveux bouclÃ©s, peau foncÃ©e
ğŸ‘©â€ğŸ¦³	adulte, cheveux blancs, femme, femmeÂ : cheveux blancs
ğŸ‘©ğŸ»â€ğŸ¦³	adulte, cheveux blancs, femme, femmeÂ : peau claire et cheveux blancs, peau claire
ğŸ‘©ğŸ¼â€ğŸ¦³	adulte, cheveux blancs, femme, femmeÂ : peau modÃ©rÃ©ment claire et cheveux blancs, peau modÃ©rÃ©ment claire
ğŸ‘©ğŸ½â€ğŸ¦³	adulte, cheveux blancs, femme, femmeÂ : peau lÃ©gÃ¨rement mate et cheveux blancs, peau lÃ©gÃ¨rement mate
ğŸ‘©ğŸ¾â€ğŸ¦³	adulte, cheveux blancs, femme, femmeÂ : peau modÃ©rÃ©ment foncÃ©e et cheveux blancs, peau modÃ©rÃ©ment foncÃ©e
ğŸ‘©ğŸ¿â€ğŸ¦³	adulte, cheveux blancs, femme, femmeÂ : peau foncÃ©e et cheveux blancs, peau foncÃ©e
ğŸ‘©â€ğŸ¦²	adulte, chauve, femme, femmeÂ : chauve
ğŸ‘©ğŸ»â€ğŸ¦²	adulte, chauve, femme, femmeÂ : peau claire et chauve, peau claire
ğŸ‘©ğŸ¼â€ğŸ¦²	adulte, chauve, femme, femmeÂ : peau modÃ©rÃ©ment claire et chauve, peau modÃ©rÃ©ment claire
ğŸ‘©ğŸ½â€ğŸ¦²	adulte, chauve, femme, femmeÂ : peau lÃ©gÃ¨rement mate et chauve, peau lÃ©gÃ¨rement mate
ğŸ‘©ğŸ¾â€ğŸ¦²	adulte, chauve, femme, femmeÂ : peau modÃ©rÃ©ment foncÃ©e et chauve, peau modÃ©rÃ©ment foncÃ©e
ğŸ‘©ğŸ¿â€ğŸ¦²	adulte, chauve, femme, femmeÂ : peau foncÃ©e et chauve, peau foncÃ©e
ğŸ§“	adulte, genre non dÃ©fini, personne, Ã¢gÃ©e
ğŸ§“ğŸ»	adulte, genre non dÃ©fini, peau claire, personne, personne Ã¢gÃ©eÂ : peau claire, Ã¢gÃ©e
ğŸ§“ğŸ¼	adulte, genre non dÃ©fini, peau modÃ©rÃ©ment claire, personne, personne Ã¢gÃ©eÂ : peau modÃ©rÃ©ment claire, Ã¢gÃ©e
ğŸ§“ğŸ½	adulte, genre non dÃ©fini, peau lÃ©gÃ¨rement mate, personne, personne Ã¢gÃ©eÂ : peau lÃ©gÃ¨rement mate, Ã¢gÃ©e
ğŸ§“ğŸ¾	adulte, genre non dÃ©fini, peau modÃ©rÃ©ment foncÃ©e, personne, personne Ã¢gÃ©eÂ : peau modÃ©rÃ©ment foncÃ©e, Ã¢gÃ©e
ğŸ§“ğŸ¿	adulte, genre non dÃ©fini, peau foncÃ©e, personne, personne Ã¢gÃ©eÂ : peau foncÃ©e, Ã¢gÃ©e
ğŸ‘´	adulte, homme, Ã¢gÃ©
ğŸ‘´ğŸ»	adulte, homme, homme Ã¢gÃ©Â : peau claire, peau claire, Ã¢gÃ©
ğŸ‘´ğŸ¼	adulte, homme, homme Ã¢gÃ©Â : peau modÃ©rÃ©ment claire, peau modÃ©rÃ©ment claire, Ã¢gÃ©
ğŸ‘´ğŸ½	adulte, homme, homme Ã¢gÃ©Â : peau lÃ©gÃ¨rement mate, peau lÃ©gÃ¨rement mate, Ã¢gÃ©
ğŸ‘´ğŸ¾	adulte, homme, homme Ã¢gÃ©Â : peau modÃ©rÃ©ment foncÃ©e, peau modÃ©rÃ©ment foncÃ©e, Ã¢gÃ©
ğŸ‘´ğŸ¿	adulte, homme, homme Ã¢gÃ©Â : peau foncÃ©e, peau foncÃ©e, Ã¢gÃ©
ğŸ‘µ	adulte, femme, Ã¢gÃ©e
ğŸ‘µğŸ»	adulte, femme, femme Ã¢gÃ©eÂ : peau claire, peau claire, Ã¢gÃ©e
ğŸ‘µğŸ¼	adulte, femme, femme Ã¢gÃ©eÂ : peau modÃ©rÃ©ment claire, peau modÃ©rÃ©ment claire, Ã¢gÃ©e
ğŸ‘µğŸ½	adulte, femme, femme Ã¢gÃ©eÂ : peau lÃ©gÃ¨rement mate, peau lÃ©gÃ¨rement mate, Ã¢gÃ©e
ğŸ‘µğŸ¾	adulte, femme, femme Ã¢gÃ©eÂ : peau modÃ©rÃ©ment foncÃ©e, peau modÃ©rÃ©ment foncÃ©e, Ã¢gÃ©e
ğŸ‘µğŸ¿	adulte, femme, femme Ã¢gÃ©eÂ : peau foncÃ©e, peau foncÃ©e, Ã¢gÃ©e
ğŸ™	froncer, mÃ©contente, personne, personne mÃ©contente, sourcils
ğŸ™ğŸ»	froncer, mÃ©contente, peau claire, personne, personne mÃ©contenteÂ : peau claire, sourcils
ğŸ™ğŸ¼	froncer, mÃ©contente, peau modÃ©rÃ©ment claire, personne, personne mÃ©contenteÂ : peau modÃ©rÃ©ment claire, sourcils
ğŸ™ğŸ½	froncer, mÃ©contente, peau lÃ©gÃ¨rement mate, personne, personne mÃ©contenteÂ : peau lÃ©gÃ¨rement mate, sourcils
ğŸ™ğŸ¾	froncer, mÃ©contente, peau modÃ©rÃ©ment foncÃ©e, personne, personne mÃ©contenteÂ : peau modÃ©rÃ©ment foncÃ©e, sourcils
ğŸ™ğŸ¿	froncer, mÃ©contente, peau foncÃ©e, personne, personne mÃ©contenteÂ : peau foncÃ©e, sourcils
ğŸ™â€â™‚	froncement, geste, homme, sourcils
ğŸ™ğŸ»â€â™‚	froncement, geste, homme, homme fronÃ§ant les sourcilsÂ : peau claire, peau claire, sourcils
ğŸ™ğŸ¼â€â™‚	froncement, geste, homme, homme fronÃ§ant les sourcilsÂ : peau modÃ©rÃ©ment claire, peau modÃ©rÃ©ment claire, sourcils
ğŸ™ğŸ½â€â™‚	froncement, geste, homme, homme fronÃ§ant les sourcilsÂ : peau lÃ©gÃ¨rement mate, peau lÃ©gÃ¨rement mate, sourcils
ğŸ™ğŸ¾â€â™‚	froncement, geste, homme, homme fronÃ§ant les sourcilsÂ : peau modÃ©rÃ©ment foncÃ©e, peau modÃ©rÃ©ment foncÃ©e, sourcils
ğŸ™ğŸ¿â€â™‚	froncement, geste, homme, homme fronÃ§ant les sourcilsÂ : peau foncÃ©e, peau foncÃ©e, sourcils
ğŸ™â€â™€	femme, froncement, geste, sourcils
ğŸ™ğŸ»â€â™€	femme, femme fronÃ§ant les sourcilsÂ : peau claire, froncement, geste, peau claire, sourcils
ğŸ™ğŸ¼â€â™€	femme, femme fronÃ§ant les sourcilsÂ : peau modÃ©rÃ©ment claire, froncement, geste, peau modÃ©rÃ©ment claire, sourcils
ğŸ™ğŸ½â€â™€	femme, femme fronÃ§ant les sourcilsÂ : peau lÃ©gÃ¨rement mate, froncement, geste, peau lÃ©gÃ¨rement mate, sourcils
ğŸ™ğŸ¾â€â™€	femme, femme fronÃ§ant les sourcilsÂ : peau modÃ©rÃ©ment foncÃ©e, froncement, geste, peau modÃ©rÃ©ment foncÃ©e, sourcils
ğŸ™ğŸ¿â€â™€	femme, femme fronÃ§ant les sourcilsÂ : peau foncÃ©e, froncement, geste, peau foncÃ©e, sourcils
ğŸ™	baboune, bouder, geste, moue
ğŸ™ğŸ»	baboune, bouder, geste, moue, peau claire, personne qui boudeÂ : peau claire
ğŸ™ğŸ¼	baboune, bouder, geste, moue, peau modÃ©rÃ©ment claire, personne qui boudeÂ : peau modÃ©rÃ©ment claire
ğŸ™ğŸ½	baboune, bouder, geste, moue, peau lÃ©gÃ¨rement mate, personne qui boudeÂ : peau lÃ©gÃ¨rement mate
ğŸ™ğŸ¾	baboune, bouder, geste, moue, peau modÃ©rÃ©ment foncÃ©e, personne qui boudeÂ : peau modÃ©rÃ©ment foncÃ©e
ğŸ™ğŸ¿	baboune, bouder, geste, moue, peau foncÃ©e, personne qui boudeÂ : peau foncÃ©e
ğŸ™â€â™‚	baboune, boude, geste, homme, moue
ğŸ™ğŸ»â€â™‚	baboune, boude, geste, homme, homme qui boudeÂ : peau claire, moue, peau claire
ğŸ™ğŸ¼â€â™‚	baboune, boude, geste, homme, homme qui boudeÂ : peau modÃ©rÃ©ment claire, moue, peau modÃ©rÃ©ment claire
ğŸ™ğŸ½â€â™‚	baboune, boude, geste, homme, homme qui boudeÂ : peau lÃ©gÃ¨rement mate, moue, peau lÃ©gÃ¨rement mate
ğŸ™ğŸ¾â€â™‚	baboune, boude, geste, homme, homme qui boudeÂ : peau modÃ©rÃ©ment foncÃ©e, moue, peau modÃ©rÃ©ment foncÃ©e
ğŸ™ğŸ¿â€â™‚	baboune, boude, geste, homme, homme qui boudeÂ : peau foncÃ©e, moue, peau foncÃ©e
ğŸ™â€â™€	baboune, boude, femme, geste, moue
ğŸ™ğŸ»â€â™€	baboune, boude, femme, femme qui boudeÂ : peau claire, geste, moue, peau claire
ğŸ™ğŸ¼â€â™€	baboune, boude, femme, femme qui boudeÂ : peau modÃ©rÃ©ment claire, geste, moue, peau modÃ©rÃ©ment claire
ğŸ™ğŸ½â€â™€	baboune, boude, femme, femme qui boudeÂ : peau lÃ©gÃ¨rement mate, geste, moue, peau lÃ©gÃ¨rement mate
ğŸ™ğŸ¾â€â™€	baboune, boude, femme, femme qui boudeÂ : peau modÃ©rÃ©ment foncÃ©e, geste, moue, peau modÃ©rÃ©ment foncÃ©e
ğŸ™ğŸ¿â€â™€	baboune, boude, femme, femme qui boudeÂ : peau foncÃ©e, geste, moue, peau foncÃ©e
ğŸ™…	Geste de nÃ©gation, dÃ©saccord, interdit, main, nÃ©gation
ğŸ™…ğŸ»	Geste de nÃ©gation, Geste de nÃ©gationÂ : peau claire, dÃ©saccord, interdit, main, nÃ©gation, peau claire
ğŸ™…ğŸ¼	Geste de nÃ©gation, Geste de nÃ©gationÂ : peau modÃ©rÃ©ment claire, dÃ©saccord, interdit, main, nÃ©gation, peau modÃ©rÃ©ment claire
ğŸ™…ğŸ½	Geste de nÃ©gation, Geste de nÃ©gationÂ : peau lÃ©gÃ¨rement mate, dÃ©saccord, interdit, main, nÃ©gation, peau lÃ©gÃ¨rement mate
ğŸ™…ğŸ¾	Geste de nÃ©gation, Geste de nÃ©gationÂ : peau modÃ©rÃ©ment foncÃ©e, dÃ©saccord, interdit, main, nÃ©gation, peau modÃ©rÃ©ment foncÃ©e
ğŸ™…ğŸ¿	Geste de nÃ©gation, Geste de nÃ©gationÂ : peau foncÃ©e, dÃ©saccord, interdit, main, nÃ©gation, peau foncÃ©e
ğŸ™…â€â™‚	dÃ©saccord, homme, homme faisant un geste de nÃ©gation, interdit, main, nÃ©gation
ğŸ™…ğŸ»â€â™‚	dÃ©saccord, homme, homme faisant un geste de nÃ©gation, homme faisant un geste de nÃ©gationÂ : peau claire, interdit, main, nÃ©gation, peau claire
ğŸ™…ğŸ¼â€â™‚	dÃ©saccord, homme, homme faisant un geste de nÃ©gation, homme faisant un geste de nÃ©gationÂ : peau modÃ©rÃ©ment claire, interdit, main, nÃ©gation, peau modÃ©rÃ©ment claire
ğŸ™…ğŸ½â€â™‚	dÃ©saccord, homme, homme faisant un geste de nÃ©gation, homme faisant un geste de nÃ©gationÂ : peau lÃ©gÃ¨rement mate, interdit, main, nÃ©gation, peau lÃ©gÃ¨rement mate
ğŸ™…ğŸ¾â€â™‚	dÃ©saccord, homme, homme faisant un geste de nÃ©gation, homme faisant un geste de nÃ©gationÂ : peau modÃ©rÃ©ment foncÃ©e, interdit, main, nÃ©gation, peau modÃ©rÃ©ment foncÃ©e
ğŸ™…ğŸ¿â€â™‚	dÃ©saccord, homme, homme faisant un geste de nÃ©gation, homme faisant un geste de nÃ©gationÂ : peau foncÃ©e, interdit, main, nÃ©gation, peau foncÃ©e
ğŸ™…â€â™€	dÃ©saccord, femme, femme faisant un geste de nÃ©gation, interdit, main, nÃ©gation
ğŸ™…ğŸ»â€â™€	dÃ©saccord, femme, femme faisant un geste de nÃ©gation, femme faisant un geste de nÃ©gationÂ : peau claire, interdit, main, nÃ©gation, peau claire
ğŸ™…ğŸ¼â€â™€	dÃ©saccord, femme, femme faisant un geste de nÃ©gation, femme faisant un geste de nÃ©gationÂ : peau modÃ©rÃ©ment claire, interdit, main, nÃ©gation, peau modÃ©rÃ©ment claire
ğŸ™…ğŸ½â€â™€	dÃ©saccord, femme, femme faisant un geste de nÃ©gation, femme faisant un geste de nÃ©gationÂ : peau lÃ©gÃ¨rement mate, interdit, main, nÃ©gation, peau lÃ©gÃ¨rement mate
ğŸ™…ğŸ¾â€â™€	dÃ©saccord, femme, femme faisant un geste de nÃ©gation, femme faisant un geste de nÃ©gationÂ : peau modÃ©rÃ©ment foncÃ©e, interdit, main, nÃ©gation, peau modÃ©rÃ©ment foncÃ©e
ğŸ™…ğŸ¿â€â™€	dÃ©saccord, femme, femme faisant un geste de nÃ©gation, femme faisant un geste de nÃ©gationÂ : peau foncÃ©e, interdit, main, nÃ©gation, peau foncÃ©e
ğŸ™†	OK, accord, affirmation, geste dâ€™affirmation, main
ğŸ™†ğŸ»	OK, accord, affirmation, geste dâ€™affirmation, geste dâ€™affirmationÂ : peau claire, main, peau claire
ğŸ™†ğŸ¼	OK, accord, affirmation, geste dâ€™affirmation, geste dâ€™affirmationÂ : peau modÃ©rÃ©ment claire, main, peau modÃ©rÃ©ment claire
ğŸ™†ğŸ½	OK, accord, affirmation, geste dâ€™affirmation, geste dâ€™affirmationÂ : peau lÃ©gÃ¨rement mate, main, peau lÃ©gÃ¨rement mate
ğŸ™†ğŸ¾	OK, accord, affirmation, geste dâ€™affirmation, geste dâ€™affirmationÂ : peau modÃ©rÃ©ment foncÃ©e, main, peau modÃ©rÃ©ment foncÃ©e
ğŸ™†ğŸ¿	OK, accord, affirmation, geste dâ€™affirmation, geste dâ€™affirmationÂ : peau foncÃ©e, main, peau foncÃ©e
ğŸ™†â€â™‚	OK, accord, affirmation, homme, homme faisant un geste dâ€™affirmation, main
ğŸ™†ğŸ»â€â™‚	OK, accord, affirmation, homme, homme faisant un geste dâ€™affirmation, homme faisant un geste dâ€™affirmationÂ : peau claire, main, peau claire
ğŸ™†ğŸ¼â€â™‚	OK, accord, affirmation, homme, homme faisant un geste dâ€™affirmation, homme faisant un geste dâ€™affirmationÂ : peau modÃ©rÃ©ment claire, main, peau modÃ©rÃ©ment claire
ğŸ™†ğŸ½â€â™‚	OK, accord, affirmation, homme, homme faisant un geste dâ€™affirmation, homme faisant un geste dâ€™affirmationÂ : peau lÃ©gÃ¨rement mate, main, peau lÃ©gÃ¨rement mate
ğŸ™†ğŸ¾â€â™‚	OK, accord, affirmation, homme, homme faisant un geste dâ€™affirmation, homme faisant un geste dâ€™affirmationÂ : peau modÃ©rÃ©ment foncÃ©e, main, peau modÃ©rÃ©ment foncÃ©e
ğŸ™†ğŸ¿â€â™‚	OK, accord, affirmation, homme, homme faisant un geste dâ€™affirmation, homme faisant un geste dâ€™affirmationÂ : peau foncÃ©e, main, peau foncÃ©e
ğŸ™†â€â™€	OK, accord, affirmation, femme, femme faisant un geste dâ€™affirmation, main
ğŸ™†ğŸ»â€â™€	OK, accord, affirmation, femme, femme faisant un geste dâ€™affirmation, femme faisant un geste dâ€™affirmationÂ : peau claire, main, peau claire
ğŸ™†ğŸ¼â€â™€	OK, accord, affirmation, femme, femme faisant un geste dâ€™affirmation, femme faisant un geste dâ€™affirmationÂ : peau modÃ©rÃ©ment claire, main, peau modÃ©rÃ©ment claire
ğŸ™†ğŸ½â€â™€	OK, accord, affirmation, femme, femme faisant un geste dâ€™affirmation, femme faisant un geste dâ€™affirmationÂ : peau lÃ©gÃ¨rement mate, main, peau lÃ©gÃ¨rement mate
ğŸ™†ğŸ¾â€â™€	OK, accord, affirmation, femme, femme faisant un geste dâ€™affirmation, femme faisant un geste dâ€™affirmationÂ : peau modÃ©rÃ©ment foncÃ©e, main, peau modÃ©rÃ©ment foncÃ©e
ğŸ™†ğŸ¿â€â™€	OK, accord, affirmation, femme, femme faisant un geste dâ€™affirmation, femme faisant un geste dâ€™affirmationÂ : peau foncÃ©e, main, peau foncÃ©e
ğŸ’	aide, assistance, concierge, guichet, information, personne au guichet, rÃ©ception
ğŸ’ğŸ»	aide, assistance, concierge, guichet, information, peau claire, personne au guichet, personne au guichetÂ : peau claire, rÃ©ception
ğŸ’ğŸ¼	aide, assistance, concierge, guichet, information, peau modÃ©rÃ©ment claire, personne au guichet, personne au guichetÂ : peau modÃ©rÃ©ment claire, rÃ©ception
ğŸ’ğŸ½	aide, assistance, concierge, guichet, information, peau lÃ©gÃ¨rement mate, personne au guichet, personne au guichetÂ : peau lÃ©gÃ¨rement mate, rÃ©ception
ğŸ’ğŸ¾	aide, assistance, concierge, guichet, information, peau modÃ©rÃ©ment foncÃ©e, personne au guichet, personne au guichetÂ : peau modÃ©rÃ©ment foncÃ©e, rÃ©ception
ğŸ’ğŸ¿	aide, assistance, concierge, guichet, information, peau foncÃ©e, personne au guichet, personne au guichetÂ : peau foncÃ©e, rÃ©ception
ğŸ’â€â™‚	aide, assistant, concierge, guichetier, homme, information, rÃ©ceptionniste
ğŸ’ğŸ»â€â™‚	aide, assistant, concierge, guichetier, guichetierÂ : peau claire, homme, information, peau claire, rÃ©ceptionniste
ğŸ’ğŸ¼â€â™‚	aide, assistant, concierge, guichetier, guichetierÂ : peau modÃ©rÃ©ment claire, homme, information, peau modÃ©rÃ©ment claire, rÃ©ceptionniste
ğŸ’ğŸ½â€â™‚	aide, assistant, concierge, guichetier, guichetierÂ : peau lÃ©gÃ¨rement mate, homme, information, peau lÃ©gÃ¨rement mate, rÃ©ceptionniste
ğŸ’ğŸ¾â€â™‚	aide, assistant, concierge, guichetier, guichetierÂ : peau modÃ©rÃ©ment foncÃ©e, homme, information, peau modÃ©rÃ©ment foncÃ©e, rÃ©ceptionniste
ğŸ’ğŸ¿â€â™‚	aide, assistant, concierge, guichetier, guichetierÂ : peau foncÃ©e, homme, information, peau foncÃ©e, rÃ©ceptionniste
ğŸ’â€â™€	aide, assistante, concierge, femme, guichetiÃ¨re, information, rÃ©ceptionniste
ğŸ’ğŸ»â€â™€	aide, assistante, concierge, femme, guichetiÃ¨re, guichetiÃ¨reÂ : peau claire, information, peau claire, rÃ©ceptionniste
ğŸ’ğŸ¼â€â™€	aide, assistante, concierge, femme, guichetiÃ¨re, guichetiÃ¨reÂ : peau modÃ©rÃ©ment claire, information, peau modÃ©rÃ©ment claire, rÃ©ceptionniste
ğŸ’ğŸ½â€â™€	aide, assistante, concierge, femme, guichetiÃ¨re, guichetiÃ¨reÂ : peau lÃ©gÃ¨rement mate, information, peau lÃ©gÃ¨rement mate, rÃ©ceptionniste
ğŸ’ğŸ¾â€â™€	aide, assistante, concierge, femme, guichetiÃ¨re, guichetiÃ¨reÂ : peau modÃ©rÃ©ment foncÃ©e, information, peau modÃ©rÃ©ment foncÃ©e, rÃ©ceptionniste
ğŸ’ğŸ¿â€â™€	aide, assistante, concierge, femme, guichetiÃ¨re, guichetiÃ¨reÂ : peau foncÃ©e, information, peau foncÃ©e, rÃ©ceptionniste
ğŸ™‹ğŸ»	personne qui lÃ¨ve la mainÂ : peau claire
ğŸ™‹ğŸ¼	content, geste, levÃ©e, main, peau modÃ©rÃ©ment claire, personne qui lÃ¨ve la main, personne qui lÃ¨ve la mainÂ : peau modÃ©rÃ©ment claire
ğŸ™‹ğŸ½	personne qui lÃ¨ve la mainÂ : peau lÃ©gÃ¨rement mate
ğŸ™‹ğŸ¾	content, geste, levÃ©e, main, peau modÃ©rÃ©ment foncÃ©e, personne qui lÃ¨ve la main, personne qui lÃ¨ve la mainÂ : peau modÃ©rÃ©ment foncÃ©e
ğŸ™‹ğŸ¿	personne qui lÃ¨ve la mainÂ : peau foncÃ©e
ğŸ™‹ğŸ»â€â™‚	homme qui lÃ¨ve la mainÂ : peau claire
ğŸ™‹ğŸ¼â€â™‚	geste, homme, homme qui lÃ¨ve la main, homme qui lÃ¨ve la mainÂ : peau modÃ©rÃ©ment claire, main levÃ©e, peau modÃ©rÃ©ment claire
ğŸ™‹ğŸ½â€â™‚	homme qui lÃ¨ve la mainÂ : peau lÃ©gÃ¨rement mate
ğŸ™‹ğŸ¾â€â™‚	geste, homme, homme qui lÃ¨ve la main, homme qui lÃ¨ve la mainÂ : peau modÃ©rÃ©ment foncÃ©e, main levÃ©e, peau modÃ©rÃ©ment foncÃ©e
ğŸ™‹ğŸ¿â€â™‚	homme qui lÃ¨ve la mainÂ : peau foncÃ©e
ğŸ™‹ğŸ»â€â™€	femme qui lÃ¨ve la mainÂ : peau claire
ğŸ™‹ğŸ¼â€â™€	femme, femme qui lÃ¨ve la main, femme qui lÃ¨ve la mainÂ : peau modÃ©rÃ©ment claire, geste, main levÃ©e, peau modÃ©rÃ©ment claire
ğŸ™‹ğŸ½â€â™€	femme qui lÃ¨ve la mainÂ : peau lÃ©gÃ¨rement mate
ğŸ™‹ğŸ¾â€â™€	femme, femme qui lÃ¨ve la main, femme qui lÃ¨ve la mainÂ : peau modÃ©rÃ©ment foncÃ©e, geste, main levÃ©e, peau modÃ©rÃ©ment foncÃ©e
ğŸ™‹ğŸ¿â€â™€	femme qui lÃ¨ve la mainÂ : peau foncÃ©e
ğŸ§ğŸ»	personne sourdeÂ : peau claire
ğŸ§ğŸ¼	accessibilitÃ©, entendre, malentendant, oreille, peau modÃ©rÃ©ment claire, personne sourde, personne sourdeÂ : peau modÃ©rÃ©ment claire, sourd
ğŸ§ğŸ½	personne sourdeÂ : peau lÃ©gÃ¨rement mate
ğŸ§ğŸ¾	accessibilitÃ©, entendre, malentendant, oreille, peau modÃ©rÃ©ment foncÃ©e, personne sourde, personne sourdeÂ : peau modÃ©rÃ©ment foncÃ©e, sourd
ğŸ§ğŸ¿	personne sourdeÂ : peau foncÃ©e
ğŸ§ğŸ»â€â™‚	homme sourdÂ : peau claire
ğŸ§ğŸ¼â€â™‚	accessibilitÃ©, entendre, homme sourd, homme sourdÂ : peau modÃ©rÃ©ment claire, malentendant, oreille, peau modÃ©rÃ©ment claire, sourd
ğŸ§ğŸ½â€â™‚	homme sourdÂ : peau lÃ©gÃ¨rement mate
ğŸ§ğŸ¾â€â™‚	accessibilitÃ©, entendre, homme sourd, homme sourdÂ : peau modÃ©rÃ©ment foncÃ©e, malentendant, oreille, peau modÃ©rÃ©ment foncÃ©e, sourd
ğŸ§ğŸ¿â€â™‚	homme sourdÂ : peau foncÃ©e
ğŸ§â€â™€	femme, malentendante, sourde
ğŸ§ğŸ»â€â™€	femme, femme sourdeÂ : peau claire, malentendante, peau claire, sourde
ğŸ§ğŸ¼â€â™€	femme, femme sourdeÂ : peau modÃ©rÃ©ment claire, malentendante, peau modÃ©rÃ©ment claire, sourde
ğŸ§ğŸ½â€â™€	femme, femme sourdeÂ : peau lÃ©gÃ¨rement mate, malentendante, peau lÃ©gÃ¨rement mate, sourde
ğŸ§ğŸ¾â€â™€	femme, femme sourdeÂ : peau modÃ©rÃ©ment foncÃ©e, malentendante, peau modÃ©rÃ©ment foncÃ©e, sourde
ğŸ§ğŸ¿â€â™€	femme, femme sourdeÂ : peau foncÃ©e, malentendante, peau foncÃ©e, sourde
ğŸ™‡	personne qui sâ€™incline
ğŸ™‡ğŸ»	peau claire, personne qui sâ€™incline, personne qui sâ€™inclineÂ : peau claire
ğŸ™‡ğŸ¼	peau modÃ©rÃ©ment claire, personne qui sâ€™incline, personne qui sâ€™inclineÂ : peau modÃ©rÃ©ment claire
ğŸ™‡ğŸ½	peau lÃ©gÃ¨rement mate, personne qui sâ€™incline, personne qui sâ€™inclineÂ : peau lÃ©gÃ¨rement mate
ğŸ™‡ğŸ¾	peau modÃ©rÃ©ment foncÃ©e, personne qui sâ€™incline, personne qui sâ€™inclineÂ : peau modÃ©rÃ©ment foncÃ©e
ğŸ™‡ğŸ¿	peau foncÃ©e, personne qui sâ€™incline, personne qui sâ€™inclineÂ : peau foncÃ©e
ğŸ™‡â€â™‚	courbette, dÃ©solÃ©, excuses, homme, homme qui sâ€™incline, inclinÃ©
ğŸ™‡ğŸ»â€â™‚	courbette, dÃ©solÃ©, excuses, homme, homme qui sâ€™incline, homme qui sâ€™inclineÂ : peau claire, inclinÃ©, peau claire
ğŸ™‡ğŸ¼â€â™‚	courbette, dÃ©solÃ©, excuses, homme, homme qui sâ€™incline, homme qui sâ€™inclineÂ : peau modÃ©rÃ©ment claire, inclinÃ©, peau modÃ©rÃ©ment claire
ğŸ™‡ğŸ½â€â™‚	courbette, dÃ©solÃ©, excuses, homme, homme qui sâ€™incline, homme qui sâ€™inclineÂ : peau lÃ©gÃ¨rement mate, inclinÃ©, peau lÃ©gÃ¨rement mate
ğŸ™‡ğŸ¾â€â™‚	courbette, dÃ©solÃ©, excuses, homme, homme qui sâ€™incline, homme qui sâ€™inclineÂ : peau modÃ©rÃ©ment foncÃ©e, inclinÃ©, peau modÃ©rÃ©ment foncÃ©e
ğŸ™‡ğŸ¿â€â™‚	courbette, dÃ©solÃ©, excuses, homme, homme qui sâ€™incline, homme qui sâ€™inclineÂ : peau foncÃ©e, inclinÃ©, peau foncÃ©e
ğŸ™‡â€â™€	courbette, dÃ©solÃ©e, excuses, femme, homme qui sâ€™incline, inclinÃ©e
ğŸ™‡ğŸ»â€â™€	courbette, dÃ©solÃ©e, excuses, femme, femme qui sâ€™inclineÂ : peau claire, homme qui sâ€™incline, inclinÃ©e, peau claire
ğŸ™‡ğŸ¼â€â™€	courbette, dÃ©solÃ©e, excuses, femme, femme qui sâ€™inclineÂ : peau modÃ©rÃ©ment claire, homme qui sâ€™incline, inclinÃ©e, peau modÃ©rÃ©ment claire
ğŸ™‡ğŸ½â€â™€	courbette, dÃ©solÃ©e, excuses, femme, femme qui sâ€™inclineÂ : peau lÃ©gÃ¨rement mate, homme qui sâ€™incline, inclinÃ©e, peau lÃ©gÃ¨rement mate
ğŸ™‡ğŸ¾â€â™€	courbette, dÃ©solÃ©e, excuses, femme, femme qui sâ€™inclineÂ : peau modÃ©rÃ©ment foncÃ©e, homme qui sâ€™incline, inclinÃ©e, peau modÃ©rÃ©ment foncÃ©e
ğŸ™‡ğŸ¿â€â™€	courbette, dÃ©solÃ©e, excuses, femme, femme qui sâ€™inclineÂ : peau foncÃ©e, homme qui sâ€™incline, inclinÃ©e, peau foncÃ©e
ğŸ¤¦	exaspÃ©ration, incroyable, main, personne avec paume de la main sur le visage, visage
ğŸ¤¦ğŸ»	exaspÃ©ration, incroyable, main, peau claire, personne avec paume de la main sur le visage, personne avec paume de la main sur le visageÂ : peau claire, visage
ğŸ¤¦ğŸ¼	exaspÃ©ration, incroyable, main, peau modÃ©rÃ©ment claire, personne avec paume de la main sur le visage, personne avec paume de la main sur le visageÂ : peau modÃ©rÃ©ment claire, visage
ğŸ¤¦ğŸ½	exaspÃ©ration, incroyable, main, peau lÃ©gÃ¨rement mate, personne avec paume de la main sur le visage, personne avec paume de la main sur le visageÂ : peau lÃ©gÃ¨rement mate, visage
ğŸ¤¦ğŸ¾	exaspÃ©ration, incroyable, main, peau modÃ©rÃ©ment foncÃ©e, personne avec paume de la main sur le visage, personne avec paume de la main sur le visageÂ : peau modÃ©rÃ©ment foncÃ©e, visage
ğŸ¤¦ğŸ¿	exaspÃ©ration, incroyable, main, peau foncÃ©e, personne avec paume de la main sur le visage, personne avec paume de la main sur le visageÂ : peau foncÃ©e, visage
ğŸ¤¦â€â™‚	exaspÃ©ration, homme, homme avec paume de la main sur le visage, incroyable, main, visage
ğŸ¤¦ğŸ»â€â™‚	exaspÃ©ration, homme, homme avec paume de la main sur le visage, homme avec paume de la main sur le visageÂ : peau claire, incroyable, main, peau claire, visage
ğŸ¤¦ğŸ¼â€â™‚	exaspÃ©ration, homme, homme avec paume de la main sur le visage, homme avec paume de la main sur le visageÂ : peau modÃ©rÃ©ment claire, incroyable, main, peau modÃ©rÃ©ment claire, visage
ğŸ¤¦ğŸ½â€â™‚	exaspÃ©ration, homme, homme avec paume de la main sur le visage, homme avec paume de la main sur le visageÂ : peau lÃ©gÃ¨rement mate, incroyable, main, peau lÃ©gÃ¨rement mate, visage
ğŸ¤¦ğŸ¾â€â™‚	exaspÃ©ration, homme, homme avec paume de la main sur le visage, homme avec paume de la main sur le visageÂ : peau modÃ©rÃ©ment foncÃ©e, incroyable, main, peau modÃ©rÃ©ment foncÃ©e, visage
ğŸ¤¦ğŸ¿â€â™‚	exaspÃ©ration, homme, homme avec paume de la main sur le visage, homme avec paume de la main sur le visageÂ : peau foncÃ©e, incroyable, main, peau foncÃ©e, visage
ğŸ¤¦â€â™€	exaspÃ©ration, femme, femme avec paume de la main sur le visage, incroyable, main, visage
ğŸ¤¦ğŸ»â€â™€	exaspÃ©ration, femme, femme avec paume de la main sur le visage, femme avec paume de la main sur le visageÂ : peau claire, incroyable, main, peau claire, visage
ğŸ¤¦ğŸ¼â€â™€	exaspÃ©ration, femme, femme avec paume de la main sur le visage, femme avec paume de la main sur le visageÂ : peau modÃ©rÃ©ment claire, incroyable, main, peau modÃ©rÃ©ment claire, visage
ğŸ¤¦ğŸ½â€â™€	exaspÃ©ration, femme, femme avec paume de la main sur le visage, femme avec paume de la main sur le visageÂ : peau lÃ©gÃ¨rement mate, incroyable, main, peau lÃ©gÃ¨rement mate, visage
ğŸ¤¦ğŸ¾â€â™€	exaspÃ©ration, femme, femme avec paume de la main sur le visage, femme avec paume de la main sur le visageÂ : peau modÃ©rÃ©ment foncÃ©e, incroyable, main, peau modÃ©rÃ©ment foncÃ©e, visage
ğŸ¤¦ğŸ¿â€â™€	exaspÃ©ration, femme, femme avec paume de la main sur le visage, femme avec paume de la main sur le visageÂ : peau foncÃ©e, incroyable, main, peau foncÃ©e, visage
ğŸ¤·	personne qui hausse les Ã©paules
ğŸ¤·ğŸ»	peau claire, personne qui hausse les Ã©paules, personne qui hausse les Ã©paulesÂ : peau claire
ğŸ¤·ğŸ¼	peau modÃ©rÃ©ment claire, personne qui hausse les Ã©paules, personne qui hausse les Ã©paulesÂ : peau modÃ©rÃ©ment claire
ğŸ¤·ğŸ½	peau lÃ©gÃ¨rement mate, personne qui hausse les Ã©paules, personne qui hausse les Ã©paulesÂ : peau lÃ©gÃ¨rement mate
ğŸ¤·ğŸ¾	peau modÃ©rÃ©ment foncÃ©e, personne qui hausse les Ã©paules, personne qui hausse les Ã©paulesÂ : peau modÃ©rÃ©ment foncÃ©e
ğŸ¤·ğŸ¿	peau foncÃ©e, personne qui hausse les Ã©paules, personne qui hausse les Ã©paulesÂ : peau foncÃ©e
ğŸ¤·ğŸ»â€â™‚	homme qui hausse les Ã©paulesÂ : peau claire
ğŸ¤·ğŸ¼â€â™‚	haussement, homme, homme qui hausse les Ã©paules, homme qui hausse les Ã©paulesÂ : peau modÃ©rÃ©ment claire, ignorance, indiffÃ©rence, peau modÃ©rÃ©ment claire
ğŸ¤·ğŸ½â€â™‚	homme qui hausse les Ã©paulesÂ : peau lÃ©gÃ¨rement mate
ğŸ¤·ğŸ¾â€â™‚	haussement, homme, homme qui hausse les Ã©paules, homme qui hausse les Ã©paulesÂ : peau modÃ©rÃ©ment foncÃ©e, ignorance, indiffÃ©rence, peau modÃ©rÃ©ment foncÃ©e
ğŸ¤·ğŸ¿â€â™‚	homme qui hausse les Ã©paulesÂ : peau foncÃ©e
ğŸ¤·ğŸ»â€â™€	femme qui hausse les Ã©paulesÂ : peau claire
ğŸ¤·ğŸ¼â€â™€	femme, femme qui hausse les Ã©paules, femme qui hausse les Ã©paulesÂ : peau modÃ©rÃ©ment claire, haussement, ignorance, indiffÃ©rence, peau modÃ©rÃ©ment claire
ğŸ¤·ğŸ½â€â™€	femme qui hausse les Ã©paulesÂ : peau lÃ©gÃ¨rement mate
ğŸ¤·ğŸ¾â€â™€	femme, femme qui hausse les Ã©paules, femme qui hausse les Ã©paulesÂ : peau modÃ©rÃ©ment foncÃ©e, haussement, ignorance, indiffÃ©rence, peau modÃ©rÃ©ment foncÃ©e
ğŸ¤·ğŸ¿â€â™€	femme qui hausse les Ã©paulesÂ : peau foncÃ©e
ğŸ‘¨ğŸ»â€âš•	professionnel de la santÃ©Â : peau claire
ğŸ‘¨ğŸ¼â€âš•	docteur, homme, infirmier, peau modÃ©rÃ©ment claire, professionnel de la santÃ©, professionnel de la santÃ©Â : peau modÃ©rÃ©ment claire, santÃ©
ğŸ‘¨ğŸ½â€âš•	professionnel de la santÃ©Â : peau lÃ©gÃ¨rement mate
ğŸ‘¨ğŸ¾â€âš•	docteur, homme, infirmier, peau modÃ©rÃ©ment foncÃ©e, professionnel de la santÃ©, professionnel de la santÃ©Â : peau modÃ©rÃ©ment foncÃ©e, santÃ©
ğŸ‘¨ğŸ¿â€âš•	professionnel de la santÃ©Â : peau foncÃ©e
ğŸ‘©ğŸ»â€âš•	professionnelle de la santÃ©Â : peau claire
ğŸ‘©ğŸ¼â€âš•	docteur, femme, infirmiÃ¨re, peau modÃ©rÃ©ment claire, professionnelle de la santÃ©, professionnelle de la santÃ©Â : peau modÃ©rÃ©ment claire, santÃ©
ğŸ‘©ğŸ½â€âš•	professionnelle de la santÃ©Â : peau lÃ©gÃ¨rement mate
ğŸ‘©ğŸ¾â€âš•	docteur, femme, infirmiÃ¨re, peau modÃ©rÃ©ment foncÃ©e, professionnelle de la santÃ©, professionnelle de la santÃ©Â : peau modÃ©rÃ©ment foncÃ©e, santÃ©
ğŸ‘©ğŸ¿â€âš•	professionnelle de la santÃ©Â : peau foncÃ©e
ğŸ‘¨ğŸ»â€ğŸ“	Ã©tudiantÂ : peau claire
ğŸ‘¨ğŸ¼â€ğŸ“	diplÃ´mÃ©, homme, peau modÃ©rÃ©ment claire, Ã©tudiant, Ã©tudiantÂ : peau modÃ©rÃ©ment claire
ğŸ‘¨ğŸ½â€ğŸ“	Ã©tudiantÂ : peau lÃ©gÃ¨rement mate
ğŸ‘¨ğŸ¾â€ğŸ“	diplÃ´mÃ©, homme, peau modÃ©rÃ©ment foncÃ©e, Ã©tudiant, Ã©tudiantÂ : peau modÃ©rÃ©ment foncÃ©e
ğŸ‘¨ğŸ¿â€ğŸ“	Ã©tudiantÂ : peau foncÃ©e
ğŸ‘©ğŸ»â€ğŸ“	Ã©tudianteÂ : peau claire
ğŸ‘©ğŸ¼â€ğŸ“	diplÃ´mÃ©e, femme, peau modÃ©rÃ©ment claire, Ã©tudiante, Ã©tudianteÂ : peau modÃ©rÃ©ment claire
ğŸ‘©ğŸ½â€ğŸ“	Ã©tudianteÂ : peau lÃ©gÃ¨rement mate
ğŸ‘©ğŸ¾â€ğŸ“	diplÃ´mÃ©e, femme, peau modÃ©rÃ©ment foncÃ©e, Ã©tudiante, Ã©tudianteÂ : peau modÃ©rÃ©ment foncÃ©e
ğŸ‘©ğŸ¿â€ğŸ“	Ã©tudianteÂ : peau foncÃ©e
ğŸ‘¨ğŸ»â€ğŸ«	enseignantÂ : peau claire
ğŸ‘¨ğŸ¼â€ğŸ«	enseignant, enseignantÂ : peau modÃ©rÃ©ment claire, homme, instituteur, instructeur, peau modÃ©rÃ©ment claire, professeur
ğŸ‘¨ğŸ½â€ğŸ«	enseignantÂ : peau lÃ©gÃ¨rement mate
ğŸ‘¨ğŸ¾â€ğŸ«	enseignant, enseignantÂ : peau modÃ©rÃ©ment foncÃ©e, homme, instituteur, instructeur, peau modÃ©rÃ©ment foncÃ©e, professeur
ğŸ‘¨ğŸ¿â€ğŸ«	enseignantÂ : peau foncÃ©e
ğŸ‘©ğŸ»â€ğŸ«	enseignanteÂ : peau claire
ğŸ‘©ğŸ¼â€ğŸ«	enseignante, enseignanteÂ : peau modÃ©rÃ©ment claire, femme, institutrice, instructrice, peau modÃ©rÃ©ment claire, professeure
ğŸ‘©ğŸ½â€ğŸ«	enseignanteÂ : peau lÃ©gÃ¨rement mate
ğŸ‘©ğŸ¾â€ğŸ«	enseignante, enseignanteÂ : peau modÃ©rÃ©ment foncÃ©e, femme, institutrice, instructrice, peau modÃ©rÃ©ment foncÃ©e, professeure
ğŸ‘©ğŸ¿â€ğŸ«	enseignanteÂ : peau foncÃ©e
ğŸ‘¨â€âš–	balance, homme, juge, justice
ğŸ‘¨ğŸ»â€âš–	balance, homme, juge, juge hommeÂ : peau claire, justice, peau claire
ğŸ‘¨ğŸ¼â€âš–	balance, homme, juge, juge hommeÂ : peau modÃ©rÃ©ment claire, justice, peau modÃ©rÃ©ment claire
ğŸ‘¨ğŸ½â€âš–	balance, homme, juge, juge hommeÂ : peau lÃ©gÃ¨rement mate, justice, peau lÃ©gÃ¨rement mate
ğŸ‘¨ğŸ¾â€âš–	balance, homme, juge, juge hommeÂ : peau modÃ©rÃ©ment foncÃ©e, justice, peau modÃ©rÃ©ment foncÃ©e
ğŸ‘¨ğŸ¿â€âš–	balance, homme, juge, juge hommeÂ : peau foncÃ©e, justice, peau foncÃ©e
ğŸ‘©ğŸ»â€âš–	juge femmeÂ : peau claire
ğŸ‘©ğŸ¼â€âš–	balance, femme, juge, juge femmeÂ : peau modÃ©rÃ©ment claire, peau modÃ©rÃ©ment claire
ğŸ‘©ğŸ½â€âš–	juge femmeÂ : peau lÃ©gÃ¨rement mate
ğŸ‘©ğŸ¾â€âš–	balance, femme, juge, juge femmeÂ : peau modÃ©rÃ©ment foncÃ©e, peau modÃ©rÃ©ment foncÃ©e
ğŸ‘©ğŸ¿â€âš–	juge femmeÂ : peau foncÃ©e
ğŸ‘¨ğŸ»â€ğŸŒ¾	fermierÂ : peau claire
ğŸ‘¨ğŸ¼â€ğŸŒ¾	agriculteur, fermier, fermierÂ : peau modÃ©rÃ©ment claire, homme, jardinier, peau modÃ©rÃ©ment claire
ğŸ‘¨ğŸ½â€ğŸŒ¾	fermierÂ : peau lÃ©gÃ¨rement mate
ğŸ‘¨ğŸ¾â€ğŸŒ¾	agriculteur, fermier, fermierÂ : peau modÃ©rÃ©ment foncÃ©e, homme, jardinier, peau modÃ©rÃ©ment foncÃ©e
ğŸ‘¨ğŸ¿â€ğŸŒ¾	fermierÂ : peau foncÃ©e
ğŸ‘©ğŸ»â€ğŸŒ¾	fermiÃ¨reÂ : peau claire
ğŸ‘©ğŸ¼â€ğŸŒ¾	agricultrice, femme, fermiÃ¨re, fermiÃ¨reÂ : peau modÃ©rÃ©ment claire, jardiniÃ¨re, peau modÃ©rÃ©ment claire
ğŸ‘©ğŸ½â€ğŸŒ¾	fermiÃ¨reÂ : peau lÃ©gÃ¨rement mate
ğŸ‘©ğŸ¾â€ğŸŒ¾	agricultrice, femme, fermiÃ¨re, fermiÃ¨reÂ : peau modÃ©rÃ©ment foncÃ©e, jardiniÃ¨re, peau modÃ©rÃ©ment foncÃ©e
ğŸ‘©ğŸ¿â€ğŸŒ¾	fermiÃ¨reÂ : peau foncÃ©e
ğŸ‘¨ğŸ»â€ğŸ³	cuisinierÂ : peau claire
ğŸ‘¨ğŸ¼â€ğŸ³	chef, cuisinier, cuisinierÂ : peau modÃ©rÃ©ment claire, homme, peau modÃ©rÃ©ment claire
ğŸ‘¨ğŸ½â€ğŸ³	cuisinierÂ : peau lÃ©gÃ¨rement mate
ğŸ‘¨ğŸ¾â€ğŸ³	chef, cuisinier, cuisinierÂ : peau modÃ©rÃ©ment foncÃ©e, homme, peau modÃ©rÃ©ment foncÃ©e
ğŸ‘¨ğŸ¿â€ğŸ³	cuisinierÂ : peau foncÃ©e
ğŸ‘©ğŸ»â€ğŸ³	cuisiniÃ¨reÂ : peau claire
ğŸ‘©ğŸ¼â€ğŸ³	chef, cuisiniÃ¨re, cuisiniÃ¨reÂ : peau modÃ©rÃ©ment claire, femme, peau modÃ©rÃ©ment claire
ğŸ‘©ğŸ½â€ğŸ³	cuisiniÃ¨reÂ : peau lÃ©gÃ¨rement mate
ğŸ‘©ğŸ¾â€ğŸ³	chef, cuisiniÃ¨re, cuisiniÃ¨reÂ : peau modÃ©rÃ©ment foncÃ©e, femme, peau modÃ©rÃ©ment foncÃ©e
ğŸ‘©ğŸ¿â€ğŸ³	cuisiniÃ¨reÂ : peau foncÃ©e
ğŸ‘¨ğŸ»â€ğŸ”§	mÃ©canicienÂ : peau claire
ğŸ‘¨ğŸ¼â€ğŸ”§	homme, mÃ©canicien, mÃ©canicienÂ : peau modÃ©rÃ©ment claire, mÃ©canique, peau modÃ©rÃ©ment claire, plombier, Ã©lectricien
ğŸ‘¨ğŸ½â€ğŸ”§	mÃ©canicienÂ : peau lÃ©gÃ¨rement mate
ğŸ‘¨ğŸ¾â€ğŸ”§	homme, mÃ©canicien, mÃ©canicienÂ : peau modÃ©rÃ©ment foncÃ©e, mÃ©canique, peau modÃ©rÃ©ment foncÃ©e, plombier, Ã©lectricien
ğŸ‘¨ğŸ¿â€ğŸ”§	mÃ©canicienÂ : peau foncÃ©e
ğŸ‘©ğŸ»â€ğŸ”§	mÃ©canicienneÂ : peau claire
ğŸ‘©ğŸ¼â€ğŸ”§	femme, mÃ©canicienne, mÃ©canicienneÂ : peau modÃ©rÃ©ment claire, mÃ©canique, peau modÃ©rÃ©ment claire, plombier, Ã©lectricienne
ğŸ‘©ğŸ½â€ğŸ”§	mÃ©canicienneÂ : peau lÃ©gÃ¨rement mate
ğŸ‘©ğŸ¾â€ğŸ”§	femme, mÃ©canicienne, mÃ©canicienneÂ : peau modÃ©rÃ©ment foncÃ©e, mÃ©canique, peau modÃ©rÃ©ment foncÃ©e, plombier, Ã©lectricienne
ğŸ‘©ğŸ¿â€ğŸ”§	mÃ©canicienneÂ : peau foncÃ©e
ğŸ‘¨â€ğŸ­	assemblage, homme, industrie, ouvrier, usine
ğŸ‘¨ğŸ»â€ğŸ­	assemblage, homme, industrie, ouvrier, ouvrierÂ : peau claire, peau claire, usine
ğŸ‘¨ğŸ¼â€ğŸ­	assemblage, homme, industrie, ouvrier, ouvrierÂ : peau modÃ©rÃ©ment claire, peau modÃ©rÃ©ment claire, usine
ğŸ‘¨ğŸ½â€ğŸ­	assemblage, homme, industrie, ouvrier, ouvrierÂ : peau lÃ©gÃ¨rement mate, peau lÃ©gÃ¨rement mate, usine
ğŸ‘¨ğŸ¾â€ğŸ­	assemblage, homme, industrie, ouvrier, ouvrierÂ : peau modÃ©rÃ©ment foncÃ©e, peau modÃ©rÃ©ment foncÃ©e, usine
ğŸ‘¨ğŸ¿â€ğŸ­	assemblage, homme, industrie, ouvrier, ouvrierÂ : peau foncÃ©e, peau foncÃ©e, usine
ğŸ‘©â€ğŸ­	assemblage, femme, industrie, ouvriÃ¨re, usine
ğŸ‘©ğŸ»â€ğŸ­	assemblage, femme, industrie, ouvriÃ¨re, ouvriÃ¨reÂ : peau claire, peau claire, usine
ğŸ‘©ğŸ¼â€ğŸ­	assemblage, femme, industrie, ouvriÃ¨re, ouvriÃ¨reÂ : peau modÃ©rÃ©ment claire, peau modÃ©rÃ©ment claire, usine
ğŸ‘©ğŸ½â€ğŸ­	assemblage, femme, industrie, ouvriÃ¨re, ouvriÃ¨reÂ : peau lÃ©gÃ¨rement mate, peau lÃ©gÃ¨rement mate, usine
ğŸ‘©ğŸ¾â€ğŸ­	assemblage, femme, industrie, ouvriÃ¨re, ouvriÃ¨reÂ : peau modÃ©rÃ©ment foncÃ©e, peau modÃ©rÃ©ment foncÃ©e, usine
ğŸ‘©ğŸ¿â€ğŸ­	assemblage, femme, industrie, ouvriÃ¨re, ouvriÃ¨reÂ : peau foncÃ©e, peau foncÃ©e, usine
ğŸ‘¨ğŸ»â€ğŸ’¼	employÃ© de bureauÂ : peau claire
ğŸ‘¨ğŸ¼â€ğŸ’¼	affaires, architecte, bureau, employÃ© de bureau, employÃ© de bureauÂ : peau modÃ©rÃ©ment claire, homme, peau modÃ©rÃ©ment claire
ğŸ‘¨ğŸ½â€ğŸ’¼	employÃ© de bureauÂ : peau lÃ©gÃ¨rement mate
ğŸ‘¨ğŸ¾â€ğŸ’¼	affaires, architecte, bureau, employÃ© de bureau, employÃ© de bureauÂ : peau modÃ©rÃ©ment foncÃ©e, homme, peau modÃ©rÃ©ment foncÃ©e
ğŸ‘¨ğŸ¿â€ğŸ’¼	employÃ© de bureauÂ : peau foncÃ©e
ğŸ‘©ğŸ»â€ğŸ’¼	employÃ©e de bureauÂ : peau claire
ğŸ‘©ğŸ¼â€ğŸ’¼	affaires, architecte, bureau, employÃ©e de bureau, employÃ©e de bureauÂ : peau modÃ©rÃ©ment claire, femme, peau modÃ©rÃ©ment claire
ğŸ‘©ğŸ½â€ğŸ’¼	employÃ©e de bureauÂ : peau lÃ©gÃ¨rement mate
ğŸ‘©ğŸ¾â€ğŸ’¼	affaires, architecte, bureau, employÃ©e de bureau, employÃ©e de bureauÂ : peau modÃ©rÃ©ment foncÃ©e, femme, peau modÃ©rÃ©ment foncÃ©e
ğŸ‘©ğŸ¿â€ğŸ’¼	employÃ©e de bureauÂ : peau foncÃ©e
ğŸ‘¨â€ğŸ”¬	biologiste, chimiste, homme, physicien, scientifique
ğŸ‘¨ğŸ»â€ğŸ”¬	biologiste, chimiste, homme, peau claire, physicien, scientifique, scientifique hommeÂ : peau claire
ğŸ‘¨ğŸ¼â€ğŸ”¬	biologiste, chimiste, homme, peau modÃ©rÃ©ment claire, physicien, scientifique, scientifique hommeÂ : peau modÃ©rÃ©ment claire
ğŸ‘¨ğŸ½â€ğŸ”¬	biologiste, chimiste, homme, peau lÃ©gÃ¨rement mate, physicien, scientifique, scientifique hommeÂ : peau lÃ©gÃ¨rement mate
ğŸ‘¨ğŸ¾â€ğŸ”¬	biologiste, chimiste, homme, peau modÃ©rÃ©ment foncÃ©e, physicien, scientifique, scientifique hommeÂ : peau modÃ©rÃ©ment foncÃ©e
ğŸ‘¨ğŸ¿â€ğŸ”¬	biologiste, chimiste, homme, peau foncÃ©e, physicien, scientifique, scientifique hommeÂ : peau foncÃ©e
ğŸ‘©â€ğŸ”¬	biologiste, chimiste, femme, physicienne, scientifique
ğŸ‘©ğŸ»â€ğŸ”¬	biologiste, chimiste, femme, peau claire, physicienne, scientifique, scientifique femmeÂ : peau claire
ğŸ‘©ğŸ¼â€ğŸ”¬	biologiste, chimiste, femme, peau modÃ©rÃ©ment claire, physicienne, scientifique, scientifique femmeÂ : peau modÃ©rÃ©ment claire
ğŸ‘©ğŸ½â€ğŸ”¬	biologiste, chimiste, femme, peau lÃ©gÃ¨rement mate, physicienne, scientifique, scientifique femmeÂ : peau lÃ©gÃ¨rement mate
ğŸ‘©ğŸ¾â€ğŸ”¬	biologiste, chimiste, femme, peau modÃ©rÃ©ment foncÃ©e, physicienne, scientifique, scientifique femmeÂ : peau modÃ©rÃ©ment foncÃ©e
ğŸ‘©ğŸ¿â€ğŸ”¬	biologiste, chimiste, femme, peau foncÃ©e, physicienne, scientifique, scientifique femmeÂ : peau foncÃ©e
ğŸ‘¨ğŸ»â€ğŸ’»	informaticienÂ : peau claire
ğŸ‘¨ğŸ¼â€ğŸ’»	dÃ©veloppeur, homme, informaticien, informaticienÂ : peau modÃ©rÃ©ment claire, logiciels, peau modÃ©rÃ©ment claire, technologie
ğŸ‘¨ğŸ½â€ğŸ’»	informaticienÂ : peau lÃ©gÃ¨rement mate
ğŸ‘¨ğŸ¾â€ğŸ’»	dÃ©veloppeur, homme, informaticien, informaticienÂ : peau modÃ©rÃ©ment foncÃ©e, logiciels, peau modÃ©rÃ©ment foncÃ©e, technologie
ğŸ‘¨ğŸ¿â€ğŸ’»	informaticienÂ : peau foncÃ©e
ğŸ‘©ğŸ»â€ğŸ’»	informaticienneÂ : peau claire
ğŸ‘©ğŸ¼â€ğŸ’»	dÃ©veloppeuse, femme, informaticienne, informaticienneÂ : peau modÃ©rÃ©ment claire, logiciels, peau modÃ©rÃ©ment claire, technologie
ğŸ‘©ğŸ½â€ğŸ’»	informaticienneÂ : peau lÃ©gÃ¨rement mate
ğŸ‘©ğŸ¾â€ğŸ’»	dÃ©veloppeuse, femme, informaticienne, informaticienneÂ : peau modÃ©rÃ©ment foncÃ©e, logiciels, peau modÃ©rÃ©ment foncÃ©e, technologie
ğŸ‘©ğŸ¿â€ğŸ’»	informaticienneÂ : peau foncÃ©e
ğŸ‘¨â€ğŸ¤	artiste, chanteur, homme, rock, vedette
ğŸ‘¨ğŸ»â€ğŸ¤	artiste, chanteur, chanteurÂ : peau claire, homme, peau claire, rock, vedette
ğŸ‘¨ğŸ¼â€ğŸ¤	artiste, chanteur, chanteurÂ : peau modÃ©rÃ©ment claire, homme, peau modÃ©rÃ©ment claire, rock, vedette
ğŸ‘¨ğŸ½â€ğŸ¤	artiste, chanteur, chanteurÂ : peau lÃ©gÃ¨rement mate, homme, peau lÃ©gÃ¨rement mate, rock, vedette
ğŸ‘¨ğŸ¾â€ğŸ¤	artiste, chanteur, chanteurÂ : peau modÃ©rÃ©ment foncÃ©e, homme, peau modÃ©rÃ©ment foncÃ©e, rock, vedette
ğŸ‘¨ğŸ¿â€ğŸ¤	artiste, chanteur, chanteurÂ : peau foncÃ©e, homme, peau foncÃ©e, rock, vedette
ğŸ‘©â€ğŸ¤	artiste, chanteuse, femme, rock, vedette
ğŸ‘©ğŸ»â€ğŸ¤	artiste, chanteuse, chanteuseÂ : peau claire, femme, peau claire, rock, vedette
ğŸ‘©ğŸ¼â€ğŸ¤	artiste, chanteuse, chanteuseÂ : peau modÃ©rÃ©ment claire, femme, peau modÃ©rÃ©ment claire, rock, vedette
ğŸ‘©ğŸ½â€ğŸ¤	artiste, chanteuse, chanteuseÂ : peau lÃ©gÃ¨rement mate, femme, peau lÃ©gÃ¨rement mate, rock, vedette
ğŸ‘©ğŸ¾â€ğŸ¤	artiste, chanteuse, chanteuseÂ : peau modÃ©rÃ©ment foncÃ©e, femme, peau modÃ©rÃ©ment foncÃ©e, rock, vedette
ğŸ‘©ğŸ¿â€ğŸ¤	artiste, chanteuse, chanteuseÂ : peau foncÃ©e, femme, peau foncÃ©e, rock, vedette
ğŸ‘¨â€ğŸ¨	artiste, homme, peintre
ğŸ‘¨ğŸ»â€ğŸ¨	artiste, artiste hommeÂ : peau claire, homme, peau claire, peintre
ğŸ‘¨ğŸ¼â€ğŸ¨	artiste, artiste hommeÂ : peau modÃ©rÃ©ment claire, homme, peau modÃ©rÃ©ment claire, peintre
ğŸ‘¨ğŸ½â€ğŸ¨	artiste, artiste hommeÂ : peau lÃ©gÃ¨rement mate, homme, peau lÃ©gÃ¨rement mate, peintre
ğŸ‘¨ğŸ¾â€ğŸ¨	artiste, artiste hommeÂ : peau modÃ©rÃ©ment foncÃ©e, homme, peau modÃ©rÃ©ment foncÃ©e, peintre
ğŸ‘¨ğŸ¿â€ğŸ¨	artiste, artiste hommeÂ : peau foncÃ©e, homme, peau foncÃ©e, peintre
ğŸ‘©â€ğŸ¨	artiste, femme, peintre
ğŸ‘©ğŸ»â€ğŸ¨	artiste, artiste femmeÂ : peau claire, femme, peau claire, peintre
ğŸ‘©ğŸ¼â€ğŸ¨	artiste, artiste femmeÂ : peau modÃ©rÃ©ment claire, femme, peau modÃ©rÃ©ment claire, peintre
ğŸ‘©ğŸ½â€ğŸ¨	artiste, artiste femmeÂ : peau lÃ©gÃ¨rement mate, femme, peau lÃ©gÃ¨rement mate, peintre
ğŸ‘©ğŸ¾â€ğŸ¨	artiste, artiste femmeÂ : peau modÃ©rÃ©ment foncÃ©e, femme, peau modÃ©rÃ©ment foncÃ©e, peintre
ğŸ‘©ğŸ¿â€ğŸ¨	artiste, artiste femmeÂ : peau foncÃ©e, femme, peau foncÃ©e, peintre
ğŸ‘¨ğŸ»â€âœˆ	pilote hommeÂ : peau claire
ğŸ‘¨ğŸ¼â€âœˆ	avion, homme, peau modÃ©rÃ©ment claire, pilote, pilote hommeÂ : peau modÃ©rÃ©ment claire
ğŸ‘¨ğŸ½â€âœˆ	pilote hommeÂ : peau lÃ©gÃ¨rement mate
ğŸ‘¨ğŸ¾â€âœˆ	avion, homme, peau modÃ©rÃ©ment foncÃ©e, pilote, pilote hommeÂ : peau modÃ©rÃ©ment foncÃ©e
ğŸ‘¨ğŸ¿â€âœˆ	pilote hommeÂ : peau foncÃ©e
ğŸ‘©ğŸ»â€âœˆ	pilote femmeÂ : peau claire
ğŸ‘©ğŸ¼â€âœˆ	avion, femme, peau modÃ©rÃ©ment claire, pilote, pilote femmeÂ : peau modÃ©rÃ©ment claire
ğŸ‘©ğŸ½â€âœˆ	pilote femmeÂ : peau lÃ©gÃ¨rement mate
ğŸ‘©ğŸ¾â€âœˆ	avion, femme, peau modÃ©rÃ©ment foncÃ©e, pilote, pilote femmeÂ : peau modÃ©rÃ©ment foncÃ©e
ğŸ‘©ğŸ¿â€âœˆ	pilote femmeÂ : peau foncÃ©e
ğŸ‘¨ğŸ»â€ğŸš€	astronaute hommeÂ : peau claire
ğŸ‘¨ğŸ¼â€ğŸš€	astronaute, astronaute hommeÂ : peau modÃ©rÃ©ment claire, espace, fusÃ©e, homme, peau modÃ©rÃ©ment claire
ğŸ‘¨ğŸ½â€ğŸš€	astronaute hommeÂ : peau lÃ©gÃ¨rement mate
ğŸ‘¨ğŸ¾â€ğŸš€	astronaute, astronaute hommeÂ : peau modÃ©rÃ©ment foncÃ©e, espace, fusÃ©e, homme, peau modÃ©rÃ©ment foncÃ©e
ğŸ‘¨ğŸ¿â€ğŸš€	astronaute hommeÂ : peau foncÃ©e
ğŸ‘©ğŸ»â€ğŸš€	astronaute femmeÂ : peau claire
ğŸ‘©ğŸ¼â€ğŸš€	astronaute, astronaute femmeÂ : peau modÃ©rÃ©ment claire, espace, femme, fusÃ©e, peau modÃ©rÃ©ment claire
ğŸ‘©ğŸ½â€ğŸš€	astronaute femmeÂ : peau lÃ©gÃ¨rement mate
ğŸ‘©ğŸ¾â€ğŸš€	astronaute, astronaute femmeÂ : peau modÃ©rÃ©ment foncÃ©e, espace, femme, fusÃ©e, peau modÃ©rÃ©ment foncÃ©e
ğŸ‘©ğŸ¿â€ğŸš€	astronaute femmeÂ : peau foncÃ©e
ğŸ‘¨ğŸ»â€ğŸš’	pompier hommeÂ : peau claire
ğŸ‘¨ğŸ¼â€ğŸš’	camion de pompiers, homme, peau modÃ©rÃ©ment claire, pompier, pompier hommeÂ : peau modÃ©rÃ©ment claire
ğŸ‘¨ğŸ½â€ğŸš’	pompier hommeÂ : peau lÃ©gÃ¨rement mate
ğŸ‘¨ğŸ¾â€ğŸš’	camion de pompiers, homme, peau modÃ©rÃ©ment foncÃ©e, pompier, pompier hommeÂ : peau modÃ©rÃ©ment foncÃ©e
ğŸ‘¨ğŸ¿â€ğŸš’	pompier hommeÂ : peau foncÃ©e
ğŸ‘©ğŸ»â€ğŸš’	pompier femmeÂ : peau claire
ğŸ‘©ğŸ¼â€ğŸš’	camion de pompiers, femme, peau modÃ©rÃ©ment claire, pompier, pompier femmeÂ : peau modÃ©rÃ©ment claire
ğŸ‘©ğŸ½â€ğŸš’	pompier femmeÂ : peau lÃ©gÃ¨rement mate
ğŸ‘©ğŸ¾â€ğŸš’	camion de pompiers, femme, peau modÃ©rÃ©ment foncÃ©e, pompier, pompier femmeÂ : peau modÃ©rÃ©ment foncÃ©e
ğŸ‘©ğŸ¿â€ğŸš’	pompier femmeÂ : peau foncÃ©e
ğŸ‘®	agent de la paix, flic, officier, police
ğŸ‘®ğŸ»	agent de la paix, agent de la paixÂ : peau claire, flic, officier, peau claire, police
ğŸ‘®ğŸ¼	agent de la paix, agent de la paixÂ : peau modÃ©rÃ©ment claire, flic, officier, peau modÃ©rÃ©ment claire, police
ğŸ‘®ğŸ½	agent de la paix, agent de la paixÂ : peau lÃ©gÃ¨rement mate, flic, officier, peau lÃ©gÃ¨rement mate, police
ğŸ‘®ğŸ¾	agent de la paix, agent de la paixÂ : peau modÃ©rÃ©ment foncÃ©e, flic, officier, peau modÃ©rÃ©ment foncÃ©e, police
ğŸ‘®ğŸ¿	agent de la paix, agent de la paixÂ : peau foncÃ©e, flic, officier, peau foncÃ©e, police
ğŸ‘®ğŸ»â€â™‚	policierÂ : peau claire
ğŸ‘®ğŸ¼â€â™‚	flic, homme, officier, peau modÃ©rÃ©ment claire, police, policier, policierÂ : peau modÃ©rÃ©ment claire
ğŸ‘®ğŸ½â€â™‚	policierÂ : peau lÃ©gÃ¨rement mate
ğŸ‘®ğŸ¾â€â™‚	flic, homme, officier, peau modÃ©rÃ©ment foncÃ©e, police, policier, policierÂ : peau modÃ©rÃ©ment foncÃ©e
ğŸ‘®ğŸ¿â€â™‚	policierÂ : peau foncÃ©e
ğŸ‘®ğŸ»â€â™€	policiÃ¨reÂ : peau claire
ğŸ‘®ğŸ¼â€â™€	femme, flic, officier, peau modÃ©rÃ©ment claire, police, policiÃ¨re, policiÃ¨reÂ : peau modÃ©rÃ©ment claire
ğŸ‘®ğŸ½â€â™€	policiÃ¨reÂ : peau lÃ©gÃ¨rement mate
ğŸ‘®ğŸ¾â€â™€	femme, flic, officier, peau modÃ©rÃ©ment foncÃ©e, police, policiÃ¨re, policiÃ¨reÂ : peau modÃ©rÃ©ment foncÃ©e
ğŸ‘®ğŸ¿â€â™€	policiÃ¨reÂ : peau foncÃ©e
ğŸ•µğŸ»	dÃ©tectiveÂ : peau claire
ğŸ•µğŸ¼	dÃ©tective, dÃ©tectiveÂ : peau modÃ©rÃ©ment claire, enquÃªteur, espion, peau modÃ©rÃ©ment claire
ğŸ•µğŸ½	dÃ©tectiveÂ : peau lÃ©gÃ¨rement mate
ğŸ•µğŸ¾	dÃ©tective, dÃ©tectiveÂ : peau modÃ©rÃ©ment foncÃ©e, enquÃªteur, espion, peau modÃ©rÃ©ment foncÃ©e
ğŸ•µğŸ¿	dÃ©tectiveÂ : peau foncÃ©e
ğŸ•µğŸ»â€â™‚	dÃ©tective hommeÂ : peau claire
ğŸ•µğŸ¼â€â™‚	dÃ©tective, dÃ©tective hommeÂ : peau modÃ©rÃ©ment claire, enquÃªteur, espion, homme, peau modÃ©rÃ©ment claire
ğŸ•µğŸ½â€â™‚	dÃ©tective hommeÂ : peau lÃ©gÃ¨rement mate
ğŸ•µğŸ¾â€â™‚	dÃ©tective, dÃ©tective hommeÂ : peau modÃ©rÃ©ment foncÃ©e, enquÃªteur, espion, homme, peau modÃ©rÃ©ment foncÃ©e
ğŸ•µğŸ¿â€â™‚	dÃ©tective hommeÂ : peau foncÃ©e
ğŸ•µâ€â™€	dÃ©tective, enquÃªteuse, enquÃªtrice, espionne, femme
ğŸ•µğŸ»â€â™€	dÃ©tective, dÃ©tective femmeÂ : peau claire, enquÃªteuse, enquÃªtrice, espionne, femme, peau claire
ğŸ•µğŸ¼â€â™€	dÃ©tective, dÃ©tective femmeÂ : peau modÃ©rÃ©ment claire, enquÃªteuse, enquÃªtrice, espionne, femme, peau modÃ©rÃ©ment claire
ğŸ•µğŸ½â€â™€	dÃ©tective, dÃ©tective femmeÂ : peau lÃ©gÃ¨rement mate, enquÃªteuse, enquÃªtrice, espionne, femme, peau lÃ©gÃ¨rement mate
ğŸ•µğŸ¾â€â™€	dÃ©tective, dÃ©tective femmeÂ : peau modÃ©rÃ©ment foncÃ©e, enquÃªteuse, enquÃªtrice, espionne, femme, peau modÃ©rÃ©ment foncÃ©e
ğŸ•µğŸ¿â€â™€	dÃ©tective, dÃ©tective femmeÂ : peau foncÃ©e, enquÃªteuse, enquÃªtrice, espionne, femme, peau foncÃ©e
ğŸ’‚ğŸ»	gardeÂ : peau claire
ğŸ’‚ğŸ¼	garde, gardeÂ : peau modÃ©rÃ©ment claire, peau modÃ©rÃ©ment claire
ğŸ’‚ğŸ½	gardeÂ : peau lÃ©gÃ¨rement mate
ğŸ’‚ğŸ¾	garde, gardeÂ : peau modÃ©rÃ©ment foncÃ©e, peau modÃ©rÃ©ment foncÃ©e
ğŸ’‚ğŸ¿	gardeÂ : peau foncÃ©e
ğŸ’‚ğŸ»â€â™‚	garde hommeÂ : peau claire
ğŸ’‚ğŸ¼â€â™‚	garde, garde hommeÂ : peau modÃ©rÃ©ment claire, homme, peau modÃ©rÃ©ment claire
ğŸ’‚ğŸ½â€â™‚	garde hommeÂ : peau lÃ©gÃ¨rement mate
ğŸ’‚ğŸ¾â€â™‚	garde, garde hommeÂ : peau modÃ©rÃ©ment foncÃ©e, homme, peau modÃ©rÃ©ment foncÃ©e
ğŸ’‚ğŸ¿â€â™‚	garde hommeÂ : peau foncÃ©e
ğŸ’‚ğŸ»â€â™€	garde femmeÂ : peau claire
ğŸ’‚ğŸ¼â€â™€	femme, garde, garde femmeÂ : peau modÃ©rÃ©ment claire, peau modÃ©rÃ©ment claire
ğŸ’‚ğŸ½â€â™€	garde femmeÂ : peau lÃ©gÃ¨rement mate
ğŸ’‚ğŸ¾â€â™€	femme, garde, garde femmeÂ : peau modÃ©rÃ©ment foncÃ©e, peau modÃ©rÃ©ment foncÃ©e
ğŸ’‚ğŸ¿â€â™€	garde femmeÂ : peau foncÃ©e
ğŸ‘·ğŸ»	personnel du bÃ¢timentÂ : peau claire
ğŸ‘·ğŸ¼	bÃ¢timent, casque, ouvrier, peau modÃ©rÃ©ment claire, personnel du bÃ¢timent, personnel du bÃ¢timentÂ : peau modÃ©rÃ©ment claire
ğŸ‘·ğŸ½	personnel du bÃ¢timentÂ : peau lÃ©gÃ¨rement mate
ğŸ‘·ğŸ¾	bÃ¢timent, casque, ouvrier, peau modÃ©rÃ©ment foncÃ©e, personnel du bÃ¢timent, personnel du bÃ¢timentÂ : peau modÃ©rÃ©ment foncÃ©e
ğŸ‘·ğŸ¿	personnel du bÃ¢timentÂ : peau foncÃ©e
ğŸ‘·ğŸ»â€â™‚	ouvrier du bÃ¢timentÂ : peau claire
ğŸ‘·ğŸ¼â€â™‚	bÃ¢timent, homme, ouvrier, ouvrier du bÃ¢timent, ouvrier du bÃ¢timentÂ : peau modÃ©rÃ©ment claire, peau modÃ©rÃ©ment claire
ğŸ‘·ğŸ½â€â™‚	ouvrier du bÃ¢timentÂ : peau lÃ©gÃ¨rement mate
ğŸ‘·ğŸ¾â€â™‚	bÃ¢timent, homme, ouvrier, ouvrier du bÃ¢timent, ouvrier du bÃ¢timentÂ : peau modÃ©rÃ©ment foncÃ©e, peau modÃ©rÃ©ment foncÃ©e
ğŸ‘·ğŸ¿â€â™‚	ouvrier du bÃ¢timentÂ : peau foncÃ©e
ğŸ‘·ğŸ»â€â™€	ouvriÃ¨re du bÃ¢timentÂ : peau claire
ğŸ‘·ğŸ¼â€â™€	bÃ¢timent, femme, ouvriÃ¨re, ouvriÃ¨re du bÃ¢timent, ouvriÃ¨re du bÃ¢timentÂ : peau modÃ©rÃ©ment claire, peau modÃ©rÃ©ment claire
ğŸ‘·ğŸ½â€â™€	ouvriÃ¨re du bÃ¢timentÂ : peau lÃ©gÃ¨rement mate
ğŸ‘·ğŸ¾â€â™€	bÃ¢timent, femme, ouvriÃ¨re, ouvriÃ¨re du bÃ¢timent, ouvriÃ¨re du bÃ¢timentÂ : peau modÃ©rÃ©ment foncÃ©e, peau modÃ©rÃ©ment foncÃ©e
ğŸ‘·ğŸ¿â€â™€	ouvriÃ¨re du bÃ¢timentÂ : peau foncÃ©e
ğŸ¤´ğŸ»	princeÂ : peau claire
ğŸ¤´ğŸ¼	peau modÃ©rÃ©ment claire, prince, princeÂ : peau modÃ©rÃ©ment claire
ğŸ¤´ğŸ½	princeÂ : peau lÃ©gÃ¨rement mate
ğŸ¤´ğŸ¾	peau modÃ©rÃ©ment foncÃ©e, prince, princeÂ : peau modÃ©rÃ©ment foncÃ©e
ğŸ¤´ğŸ¿	princeÂ : peau foncÃ©e
ğŸ‘¸	conte de fÃ©es, fantastique, princesse
ğŸ‘¸ğŸ»	conte de fÃ©es, fantastique, peau claire, princesse, princesseÂ : peau claire
ğŸ‘¸ğŸ¼	conte de fÃ©es, fantastique, peau modÃ©rÃ©ment claire, princesse, princesseÂ : peau modÃ©rÃ©ment claire
ğŸ‘¸ğŸ½	conte de fÃ©es, fantastique, peau lÃ©gÃ¨rement mate, princesse, princesseÂ : peau lÃ©gÃ¨rement mate
ğŸ‘¸ğŸ¾	conte de fÃ©es, fantastique, peau modÃ©rÃ©ment foncÃ©e, princesse, princesseÂ : peau modÃ©rÃ©ment foncÃ©e
ğŸ‘¸ğŸ¿	conte de fÃ©es, fantastique, peau foncÃ©e, princesse, princesseÂ : peau foncÃ©e
ğŸ‘³ğŸ»	personne en turbanÂ : peau claire
ğŸ‘³ğŸ¼	peau modÃ©rÃ©ment claire, personne en turban, personne en turbanÂ : peau modÃ©rÃ©ment claire, turban
ğŸ‘³ğŸ½	personne en turbanÂ : peau lÃ©gÃ¨rement mate
ğŸ‘³ğŸ¾	peau modÃ©rÃ©ment foncÃ©e, personne en turban, personne en turbanÂ : peau modÃ©rÃ©ment foncÃ©e, turban
ğŸ‘³ğŸ¿	personne en turbanÂ : peau foncÃ©e
ğŸ‘³ğŸ»â€â™‚	homme en turbanÂ : peau claire
ğŸ‘³ğŸ¼â€â™‚	homme, homme en turban, homme en turbanÂ : peau modÃ©rÃ©ment claire, peau modÃ©rÃ©ment claire, turban
ğŸ‘³ğŸ½â€â™‚	homme en turbanÂ : peau lÃ©gÃ¨rement mate
ğŸ‘³ğŸ¾â€â™‚	homme, homme en turban, homme en turbanÂ : peau modÃ©rÃ©ment foncÃ©e, peau modÃ©rÃ©ment foncÃ©e, turban
ğŸ‘³ğŸ¿â€â™‚	homme en turbanÂ : peau foncÃ©e
ğŸ‘³ğŸ»â€â™€	femme en turbanÂ : peau claire
ğŸ‘³ğŸ¼â€â™€	femme, femme en turban, femme en turbanÂ : peau modÃ©rÃ©ment claire, peau modÃ©rÃ©ment claire, turban
ğŸ‘³ğŸ½â€â™€	femme en turbanÂ : peau lÃ©gÃ¨rement mate
ğŸ‘³ğŸ¾â€â™€	femme, femme en turban, femme en turbanÂ : peau modÃ©rÃ©ment foncÃ©e, peau modÃ©rÃ©ment foncÃ©e, turban
ğŸ‘³ğŸ¿â€â™€	femme en turbanÂ : peau foncÃ©e
ğŸ‘²	calotte chinoise, chapeau, gua pi mao, homme, homme coiffÃ© dâ€™une calotte chinoise
ğŸ‘²ğŸ»	calotte chinoise, chapeau, gua pi mao, homme, homme coiffÃ© dâ€™une calotte chinoise, homme coiffÃ© dâ€™une calotte chinoiseÂ : peau claire, peau claire
ğŸ‘²ğŸ¼	calotte chinoise, chapeau, gua pi mao, homme, homme coiffÃ© dâ€™une calotte chinoise, homme coiffÃ© dâ€™une calotte chinoiseÂ : peau modÃ©rÃ©ment claire, peau modÃ©rÃ©ment claire
ğŸ‘²ğŸ½	calotte chinoise, chapeau, gua pi mao, homme, homme coiffÃ© dâ€™une calotte chinoise, homme coiffÃ© dâ€™une calotte chinoiseÂ : peau lÃ©gÃ¨rement mate, peau lÃ©gÃ¨rement mate
ğŸ‘²ğŸ¾	calotte chinoise, chapeau, gua pi mao, homme, homme coiffÃ© dâ€™une calotte chinoise, homme coiffÃ© dâ€™une calotte chinoiseÂ : peau modÃ©rÃ©ment foncÃ©e, peau modÃ©rÃ©ment foncÃ©e
ğŸ‘²ğŸ¿	calotte chinoise, chapeau, gua pi mao, homme, homme coiffÃ© dâ€™une calotte chinoise, homme coiffÃ© dâ€™une calotte chinoiseÂ : peau foncÃ©e, peau foncÃ©e
ğŸ§•ğŸ»	femme avec foulardÂ : peau claire
ğŸ§•ğŸ¼	femme avec foulard, femme avec foulardÂ : peau modÃ©rÃ©ment claire, foulard, hijab, mantilla, peau modÃ©rÃ©ment claire, tichel
ğŸ§•ğŸ½	femme avec foulardÂ : peau lÃ©gÃ¨rement mate
ğŸ§•ğŸ¾	femme avec foulard, femme avec foulardÂ : peau modÃ©rÃ©ment foncÃ©e, foulard, hijab, mantilla, peau modÃ©rÃ©ment foncÃ©e, tichel
ğŸ§•ğŸ¿	femme avec foulardÂ : peau foncÃ©e
ğŸ¤µ	complet, homme, homme portant un complet, smoking
ğŸ¤µğŸ»	complet, homme, homme portant un complet, homme portant un completÂ : peau claire, peau claire, smoking
ğŸ¤µğŸ¼	complet, homme, homme portant un complet, homme portant un completÂ : peau modÃ©rÃ©ment claire, peau modÃ©rÃ©ment claire, smoking
ğŸ¤µğŸ½	complet, homme, homme portant un complet, homme portant un completÂ : peau lÃ©gÃ¨rement mate, peau lÃ©gÃ¨rement mate, smoking
ğŸ¤µğŸ¾	complet, homme, homme portant un complet, homme portant un completÂ : peau modÃ©rÃ©ment foncÃ©e, peau modÃ©rÃ©ment foncÃ©e, smoking
ğŸ¤µğŸ¿	complet, homme, homme portant un complet, homme portant un completÂ : peau foncÃ©e, peau foncÃ©e, smoking
ğŸ‘°	mariage, mariÃ©e, voile
ğŸ‘°ğŸ»	mariage, mariÃ©e, mariÃ©e avec voileÂ : peau claire, peau claire, voile
ğŸ‘°ğŸ¼	mariage, mariÃ©e, mariÃ©e avec voileÂ : peau modÃ©rÃ©ment claire, peau modÃ©rÃ©ment claire, voile
ğŸ‘°ğŸ½	mariage, mariÃ©e, mariÃ©e avec voileÂ : peau lÃ©gÃ¨rement mate, peau lÃ©gÃ¨rement mate, voile
ğŸ‘°ğŸ¾	mariage, mariÃ©e, mariÃ©e avec voileÂ : peau modÃ©rÃ©ment foncÃ©e, peau modÃ©rÃ©ment foncÃ©e, voile
ğŸ‘°ğŸ¿	mariage, mariÃ©e, mariÃ©e avec voileÂ : peau foncÃ©e, peau foncÃ©e, voile
ğŸ¤°ğŸ»	femme enceinteÂ : peau claire
ğŸ¤°ğŸ¼	enceinte, femme, femme enceinteÂ : peau modÃ©rÃ©ment claire, peau modÃ©rÃ©ment claire
ğŸ¤°ğŸ½	femme enceinteÂ : peau lÃ©gÃ¨rement mate
ğŸ¤°ğŸ¾	enceinte, femme, femme enceinteÂ : peau modÃ©rÃ©ment foncÃ©e, peau modÃ©rÃ©ment foncÃ©e
ğŸ¤°ğŸ¿	femme enceinteÂ : peau foncÃ©e
ğŸ¤±ğŸ»	allaitementÂ : peau claire
ğŸ¤±ğŸ¼	allaitement, allaitementÂ : peau modÃ©rÃ©ment claire, bÃ©bÃ©, peau modÃ©rÃ©ment claire, sein, soins
ğŸ¤±ğŸ½	allaitementÂ : peau lÃ©gÃ¨rement mate
ğŸ¤±ğŸ¾	allaitement, allaitementÂ : peau modÃ©rÃ©ment foncÃ©e, bÃ©bÃ©, peau modÃ©rÃ©ment foncÃ©e, sein, soins
ğŸ¤±ğŸ¿	allaitementÂ : peau foncÃ©e
ğŸ‘¼ğŸ»	bÃ©bÃ© angeÂ : peau claire
ğŸ‘¼ğŸ¼	ange, bÃ©bÃ©, bÃ©bÃ© angeÂ : peau modÃ©rÃ©ment claire, fantastique, peau modÃ©rÃ©ment claire, visage
ğŸ‘¼ğŸ½	bÃ©bÃ© angeÂ : peau lÃ©gÃ¨rement mate
ğŸ‘¼ğŸ¾	ange, bÃ©bÃ©, bÃ©bÃ© angeÂ : peau modÃ©rÃ©ment foncÃ©e, fantastique, peau modÃ©rÃ©ment foncÃ©e, visage
ğŸ‘¼ğŸ¿	bÃ©bÃ© angeÂ : peau foncÃ©e
ğŸ…	NoÃ«l, cÃ©lÃ©bration, fÃªte, pÃ¨re
ğŸ…ğŸ»	NoÃ«l, cÃ©lÃ©bration, fÃªte, peau claire, pÃ¨re, pÃ¨re NoÃ«lÂ : peau claire
ğŸ…ğŸ¼	NoÃ«l, cÃ©lÃ©bration, fÃªte, peau modÃ©rÃ©ment claire, pÃ¨re, pÃ¨re NoÃ«lÂ : peau modÃ©rÃ©ment claire
ğŸ…ğŸ½	NoÃ«l, cÃ©lÃ©bration, fÃªte, peau lÃ©gÃ¨rement mate, pÃ¨re, pÃ¨re NoÃ«lÂ : peau lÃ©gÃ¨rement mate
ğŸ…ğŸ¾	NoÃ«l, cÃ©lÃ©bration, fÃªte, peau modÃ©rÃ©ment foncÃ©e, pÃ¨re, pÃ¨re NoÃ«lÂ : peau modÃ©rÃ©ment foncÃ©e
ğŸ…ğŸ¿	NoÃ«l, cÃ©lÃ©bration, fÃªte, peau foncÃ©e, pÃ¨re, pÃ¨re NoÃ«lÂ : peau foncÃ©e
ğŸ¤¶	NoÃ«l, cÃ©lÃ©bration, fÃªte, mÃ¨re
ğŸ¤¶ğŸ»	NoÃ«l, cÃ©lÃ©bration, fÃªte, mÃ¨re, mÃ¨re NoÃ«lÂ : peau claire, peau claire
ğŸ¤¶ğŸ¼	NoÃ«l, cÃ©lÃ©bration, fÃªte, mÃ¨re, mÃ¨re NoÃ«lÂ : peau modÃ©rÃ©ment claire, peau modÃ©rÃ©ment claire
ğŸ¤¶ğŸ½	NoÃ«l, cÃ©lÃ©bration, fÃªte, mÃ¨re, mÃ¨re NoÃ«lÂ : peau lÃ©gÃ¨rement mate, peau lÃ©gÃ¨rement mate
ğŸ¤¶ğŸ¾	NoÃ«l, cÃ©lÃ©bration, fÃªte, mÃ¨re, mÃ¨re NoÃ«lÂ : peau modÃ©rÃ©ment foncÃ©e, peau modÃ©rÃ©ment foncÃ©e
ğŸ¤¶ğŸ¿	NoÃ«l, cÃ©lÃ©bration, fÃªte, mÃ¨re, mÃ¨re NoÃ«lÂ : peau foncÃ©e, peau foncÃ©e
ğŸ¦¸	gentil, hÃ©roÃ¯ne, hÃ©ros, super pouvoirs, superhÃ©ros
ğŸ¦¸ğŸ»	gentil, hÃ©roÃ¯ne, hÃ©ros, super pouvoirs, peau claire, superhÃ©ros, superhÃ©rosÂ : peau claire
ğŸ¦¸ğŸ¼	gentil, hÃ©roÃ¯ne, hÃ©ros, super pouvoirs, peau modÃ©rÃ©ment claire, superhÃ©ros, superhÃ©rosÂ : peau modÃ©rÃ©ment claire
ğŸ¦¸ğŸ½	gentil, hÃ©roÃ¯ne, hÃ©ros, super pouvoirs, peau lÃ©gÃ¨rement mate, superhÃ©ros, superhÃ©rosÂ : peau lÃ©gÃ¨rement mate
ğŸ¦¸ğŸ¾	gentil, hÃ©roÃ¯ne, hÃ©ros, super pouvoirs, peau modÃ©rÃ©ment foncÃ©e, superhÃ©ros, superhÃ©rosÂ : peau modÃ©rÃ©ment foncÃ©e
ğŸ¦¸ğŸ¿	gentil, hÃ©roÃ¯ne, hÃ©ros, super pouvoirs, peau foncÃ©e, superhÃ©ros, superhÃ©rosÂ : peau foncÃ©e
ğŸ¦¸â€â™‚	super-hÃ©ros
ğŸ¦¸ğŸ»â€â™‚	peau claire, super-hÃ©ros, super-hÃ©rosÂ : peau claire
ğŸ¦¸ğŸ¼â€â™‚	peau modÃ©rÃ©ment claire, super-hÃ©ros, super-hÃ©rosÂ : peau modÃ©rÃ©ment claire
ğŸ¦¸ğŸ½â€â™‚	peau lÃ©gÃ¨rement mate, super-hÃ©ros, super-hÃ©rosÂ : peau lÃ©gÃ¨rement mate
ğŸ¦¸ğŸ¾â€â™‚	peau modÃ©rÃ©ment foncÃ©e, super-hÃ©ros, super-hÃ©rosÂ : peau modÃ©rÃ©ment foncÃ©e
ğŸ¦¸ğŸ¿â€â™‚	peau foncÃ©e, super-hÃ©ros, super-hÃ©rosÂ : peau foncÃ©e
ğŸ¦¸â€â™€	bien, femme, hÃ©roÃ¯ne, hÃ©ros, super pouvoir
ğŸ¦¸ğŸ»â€â™€	bien, femme, hÃ©roÃ¯ne, hÃ©ros, super pouvoir, peau claire, super-hÃ©roÃ¯neÂ : peau claire
ğŸ¦¸ğŸ¼â€â™€	bien, femme, hÃ©roÃ¯ne, hÃ©ros, super pouvoir, peau modÃ©rÃ©ment claire, super-hÃ©roÃ¯neÂ : peau modÃ©rÃ©ment claire
ğŸ¦¸ğŸ½â€â™€	bien, femme, hÃ©roÃ¯ne, hÃ©ros, super pouvoir, peau lÃ©gÃ¨rement mate, super-hÃ©roÃ¯neÂ : peau lÃ©gÃ¨rement mate
ğŸ¦¸ğŸ¾â€â™€	bien, femme, hÃ©roÃ¯ne, hÃ©ros, super pouvoir, peau modÃ©rÃ©ment foncÃ©e, super-hÃ©roÃ¯neÂ : peau modÃ©rÃ©ment foncÃ©e
ğŸ¦¸ğŸ¿â€â™€	bien, femme, hÃ©roÃ¯ne, hÃ©ros, super pouvoir, peau foncÃ©e, super-hÃ©roÃ¯neÂ : peau foncÃ©e
ğŸ¦¹	criminel, mal, mÃ©chant, super pouvoir
ğŸ¦¹ğŸ»	criminel, mal, mÃ©chant, super pouvoir, peau claire, super-vilainÂ : peau claire
ğŸ¦¹ğŸ¼	criminel, mal, mÃ©chant, super pouvoir, peau modÃ©rÃ©ment claire, super-vilainÂ : peau modÃ©rÃ©ment claire
ğŸ¦¹ğŸ½	criminel, mal, mÃ©chant, super pouvoir, peau lÃ©gÃ¨rement mate, super-vilainÂ : peau lÃ©gÃ¨rement mate
ğŸ¦¹ğŸ¾	criminel, mal, mÃ©chant, super pouvoir, peau modÃ©rÃ©ment foncÃ©e, super-vilainÂ : peau modÃ©rÃ©ment foncÃ©e
ğŸ¦¹ğŸ¿	criminel, mal, mÃ©chant, super pouvoir, peau foncÃ©e, super-vilainÂ : peau foncÃ©e
ğŸ¦¹â€â™‚	criminel, homme, mal, mÃ©chant, super pouvoir
ğŸ¦¹ğŸ»â€â™‚	criminel, homme, mal, mÃ©chant, super pouvoir, peau claire, super-vilain hommeÂ : peau claire
ğŸ¦¹ğŸ¼â€â™‚	criminel, homme, mal, mÃ©chant, super pouvoir, peau modÃ©rÃ©ment claire, super-vilain hommeÂ : peau modÃ©rÃ©ment claire
ğŸ¦¹ğŸ½â€â™‚	criminel, homme, mal, mÃ©chant, super pouvoir, peau lÃ©gÃ¨rement mate, super-vilain hommeÂ : peau lÃ©gÃ¨rement mate
ğŸ¦¹ğŸ¾â€â™‚	criminel, homme, mal, mÃ©chant, super pouvoir, peau modÃ©rÃ©ment foncÃ©e, super-vilain hommeÂ : peau modÃ©rÃ©ment foncÃ©e
ğŸ¦¹ğŸ¿â€â™‚	criminel, homme, mal, mÃ©chant, super pouvoir, peau foncÃ©e, super-vilain hommeÂ : peau foncÃ©e
ğŸ¦¹â€â™€	criminelle, femme, mal, mÃ©chante, super pouvoir
ğŸ¦¹ğŸ»â€â™€	criminelle, femme, mal, mÃ©chante, super pouvoir, peau claire, super-vilain femmeÂ : peau claire
ğŸ¦¹ğŸ¼â€â™€	criminelle, femme, mal, mÃ©chante, super pouvoir, peau modÃ©rÃ©ment claire, super-vilain femmeÂ : peau modÃ©rÃ©ment claire
ğŸ¦¹ğŸ½â€â™€	criminelle, femme, mal, mÃ©chante, super pouvoir, peau lÃ©gÃ¨rement mate, super-vilain femmeÂ : peau lÃ©gÃ¨rement mate
ğŸ¦¹ğŸ¾â€â™€	criminelle, femme, mal, mÃ©chante, super pouvoir, peau modÃ©rÃ©ment foncÃ©e, super-vilain femmeÂ : peau modÃ©rÃ©ment foncÃ©e
ğŸ¦¹ğŸ¿â€â™€	criminelle, femme, mal, mÃ©chante, super pouvoir, peau foncÃ©e, super-vilain femmeÂ : peau foncÃ©e
ğŸ§™	enchanteur, mage, magicien, sorcier, sorciÃ¨re
ğŸ§™ğŸ»	enchanteur, mage, mageÂ : peau claire, magicien, peau claire, sorcier, sorciÃ¨re
ğŸ§™ğŸ¼	enchanteur, mage, mageÂ : peau modÃ©rÃ©ment claire, magicien, peau modÃ©rÃ©ment claire, sorcier, sorciÃ¨re
ğŸ§™ğŸ½	enchanteur, mage, mageÂ : peau lÃ©gÃ¨rement mate, magicien, peau lÃ©gÃ¨rement mate, sorcier, sorciÃ¨re
ğŸ§™ğŸ¾	enchanteur, mage, mageÂ : peau modÃ©rÃ©ment foncÃ©e, magicien, peau modÃ©rÃ©ment foncÃ©e, sorcier, sorciÃ¨re
ğŸ§™ğŸ¿	enchanteur, mage, mageÂ : peau foncÃ©e, magicien, peau foncÃ©e, sorcier, sorciÃ¨re
ğŸ§™â€â™‚	enchanteur, homme, mage, magicien, sorcier
ğŸ§™ğŸ»â€â™‚	enchanteur, homme, mage, mage hommeÂ : peau claire, magicien, peau claire, sorcier
ğŸ§™ğŸ¼â€â™‚	enchanteur, homme, mage, mage hommeÂ : peau modÃ©rÃ©ment claire, magicien, peau modÃ©rÃ©ment claire, sorcier
ğŸ§™ğŸ½â€â™‚	enchanteur, homme, mage, mage hommeÂ : peau lÃ©gÃ¨rement mate, magicien, peau lÃ©gÃ¨rement mate, sorcier
ğŸ§™ğŸ¾â€â™‚	enchanteur, homme, mage, mage hommeÂ : peau modÃ©rÃ©ment foncÃ©e, magicien, peau modÃ©rÃ©ment foncÃ©e, sorcier
ğŸ§™ğŸ¿â€â™‚	enchanteur, homme, mage, mage hommeÂ : peau foncÃ©e, magicien, peau foncÃ©e, sorcier
ğŸ§™â€â™€	enchanteresse, femme, mage, magicienne, sorciÃ¨re
ğŸ§™ğŸ»â€â™€	enchanteresse, femme, mage, mage femmeÂ : peau claire, magicienne, peau claire, sorciÃ¨re
ğŸ§™ğŸ¼â€â™€	enchanteresse, femme, mage, mage femmeÂ : peau modÃ©rÃ©ment claire, magicienne, peau modÃ©rÃ©ment claire, sorciÃ¨re
ğŸ§™ğŸ½â€â™€	enchanteresse, femme, mage, mage femmeÂ : peau lÃ©gÃ¨rement mate, magicienne, peau lÃ©gÃ¨rement mate, sorciÃ¨re
ğŸ§™ğŸ¾â€â™€	enchanteresse, femme, mage, mage femmeÂ : peau modÃ©rÃ©ment foncÃ©e, magicienne, peau modÃ©rÃ©ment foncÃ©e, sorciÃ¨re
ğŸ§™ğŸ¿â€â™€	enchanteresse, femme, mage, mage femmeÂ : peau foncÃ©e, magicienne, peau foncÃ©e, sorciÃ¨re
ğŸ§š	fÃ©e, personnage fÃ©Ã©rique
ğŸ§šğŸ»	fÃ©e, peau claire, personnage fÃ©Ã©rique, personnage fÃ©Ã©riqueÂ : peau claire
ğŸ§šğŸ¼	fÃ©e, peau modÃ©rÃ©ment claire, personnage fÃ©Ã©rique, personnage fÃ©Ã©riqueÂ : peau modÃ©rÃ©ment claire
ğŸ§šğŸ½	fÃ©e, peau lÃ©gÃ¨rement mate, personnage fÃ©Ã©rique, personnage fÃ©Ã©riqueÂ : peau lÃ©gÃ¨rement mate
ğŸ§šğŸ¾	fÃ©e, peau modÃ©rÃ©ment foncÃ©e, personnage fÃ©Ã©rique, personnage fÃ©Ã©riqueÂ : peau modÃ©rÃ©ment foncÃ©e
ğŸ§šğŸ¿	fÃ©e, peau foncÃ©e, personnage fÃ©Ã©rique, personnage fÃ©Ã©riqueÂ : peau foncÃ©e
ğŸ§šâ€â™‚	fÃ©etaud, homme
ğŸ§šğŸ»â€â™‚	fÃ©etaud, fÃ©etaudÂ : peau claire, homme, peau claire
ğŸ§šğŸ¼â€â™‚	fÃ©etaud, fÃ©etaudÂ : peau modÃ©rÃ©ment claire, homme, peau modÃ©rÃ©ment claire
ğŸ§šğŸ½â€â™‚	fÃ©etaud, fÃ©etaudÂ : peau lÃ©gÃ¨rement mate, homme, peau lÃ©gÃ¨rement mate
ğŸ§šğŸ¾â€â™‚	fÃ©etaud, fÃ©etaudÂ : peau modÃ©rÃ©ment foncÃ©e, homme, peau modÃ©rÃ©ment foncÃ©e
ğŸ§šğŸ¿â€â™‚	fÃ©etaud, fÃ©etaudÂ : peau foncÃ©e, homme, peau foncÃ©e
ğŸ§šâ€â™€	femme, fÃ©e
ğŸ§šğŸ»â€â™€	femme, fÃ©e, fÃ©eÂ : peau claire, peau claire
ğŸ§šğŸ¼â€â™€	femme, fÃ©e, fÃ©eÂ : peau modÃ©rÃ©ment claire, peau modÃ©rÃ©ment claire
ğŸ§šğŸ½â€â™€	femme, fÃ©e, fÃ©eÂ : peau lÃ©gÃ¨rement mate, peau lÃ©gÃ¨rement mate
ğŸ§šğŸ¾â€â™€	femme, fÃ©e, fÃ©eÂ : peau modÃ©rÃ©ment foncÃ©e, peau modÃ©rÃ©ment foncÃ©e
ğŸ§šğŸ¿â€â™€	femme, fÃ©e, fÃ©eÂ : peau foncÃ©e, peau foncÃ©e
ğŸ§›ğŸ»	vampireÂ : peau claire
ğŸ§›ğŸ¼	Dracula, mort-vivant, peau modÃ©rÃ©ment claire, vampire, vampireÂ : peau modÃ©rÃ©ment claire
ğŸ§›ğŸ½	vampireÂ : peau lÃ©gÃ¨rement mate
ğŸ§›ğŸ¾	Dracula, mort-vivant, peau modÃ©rÃ©ment foncÃ©e, vampire, vampireÂ : peau modÃ©rÃ©ment foncÃ©e
ğŸ§›ğŸ¿	vampireÂ : peau foncÃ©e
ğŸ§›â€â™‚	Dracula, homme, mort-vivant, vampire
ğŸ§›ğŸ»â€â™‚	Dracula, homme, mort-vivant, peau claire, vampire, vampire hommeÂ : peau claire
ğŸ§›ğŸ¼â€â™‚	Dracula, homme, mort-vivant, peau modÃ©rÃ©ment claire, vampire, vampire hommeÂ : peau modÃ©rÃ©ment claire
ğŸ§›ğŸ½â€â™‚	Dracula, homme, mort-vivant, peau lÃ©gÃ¨rement mate, vampire, vampire hommeÂ : peau lÃ©gÃ¨rement mate
ğŸ§›ğŸ¾â€â™‚	Dracula, homme, mort-vivant, peau modÃ©rÃ©ment foncÃ©e, vampire, vampire hommeÂ : peau modÃ©rÃ©ment foncÃ©e
ğŸ§›ğŸ¿â€â™‚	Dracula, homme, mort-vivant, peau foncÃ©e, vampire, vampire hommeÂ : peau foncÃ©e
ğŸ§›â€â™€	femme, morte-vivante, vampire
ğŸ§›ğŸ»â€â™€	femme, morte-vivante, peau claire, vampire, vampire femmeÂ : peau claire
ğŸ§›ğŸ¼â€â™€	femme, morte-vivante, peau modÃ©rÃ©ment claire, vampire, vampire femmeÂ : peau modÃ©rÃ©ment claire
ğŸ§›ğŸ½â€â™€	femme, morte-vivante, peau lÃ©gÃ¨rement mate, vampire, vampire femmeÂ : peau lÃ©gÃ¨rement mate
ğŸ§›ğŸ¾â€â™€	femme, morte-vivante, peau modÃ©rÃ©ment foncÃ©e, vampire, vampire femmeÂ : peau modÃ©rÃ©ment foncÃ©e
ğŸ§›ğŸ¿â€â™€	femme, morte-vivante, peau foncÃ©e, vampire, vampire femmeÂ : peau foncÃ©e
ğŸ§œğŸ»	crÃ©ature aquatiqueÂ : peau claire
ğŸ§œğŸ¼	crÃ©ature aquatique, crÃ©ature aquatiqueÂ : peau modÃ©rÃ©ment claire, peau modÃ©rÃ©ment claire, sirÃ¨ne, triton
ğŸ§œğŸ½	crÃ©ature aquatiqueÂ : peau lÃ©gÃ¨rement mate
ğŸ§œğŸ¾	crÃ©ature aquatique, crÃ©ature aquatiqueÂ : peau modÃ©rÃ©ment foncÃ©e, peau modÃ©rÃ©ment foncÃ©e, sirÃ¨ne, triton
ğŸ§œğŸ¿	crÃ©ature aquatiqueÂ : peau foncÃ©e
ğŸ§œâ€â™‚	triton
ğŸ§œğŸ»â€â™‚	peau claire, triton, tritonÂ : peau claire
ğŸ§œğŸ¼â€â™‚	peau modÃ©rÃ©ment claire, triton, tritonÂ : peau modÃ©rÃ©ment claire
ğŸ§œğŸ½â€â™‚	peau lÃ©gÃ¨rement mate, triton, tritonÂ : peau lÃ©gÃ¨rement mate
ğŸ§œğŸ¾â€â™‚	peau modÃ©rÃ©ment foncÃ©e, triton, tritonÂ : peau modÃ©rÃ©ment foncÃ©e
ğŸ§œğŸ¿â€â™‚	peau foncÃ©e, triton, tritonÂ : peau foncÃ©e
ğŸ§œğŸ»â€â™€	sirÃ¨neÂ : peau claire
ğŸ§œğŸ¼â€â™€	peau modÃ©rÃ©ment claire, sirÃ¨ne, sirÃ¨neÂ : peau modÃ©rÃ©ment claire
ğŸ§œğŸ½â€â™€	sirÃ¨neÂ : peau lÃ©gÃ¨rement mate
ğŸ§œğŸ¾â€â™€	peau modÃ©rÃ©ment foncÃ©e, sirÃ¨ne, sirÃ¨neÂ : peau modÃ©rÃ©ment foncÃ©e
ğŸ§œğŸ¿â€â™€	sirÃ¨neÂ : peau foncÃ©e
ğŸ§ğŸ»	elfeÂ : peau claire
ğŸ§ğŸ¼	elfe, elfeÂ : peau modÃ©rÃ©ment claire, magique, peau modÃ©rÃ©ment claire
ğŸ§ğŸ½	elfeÂ : peau lÃ©gÃ¨rement mate
ğŸ§ğŸ¾	elfe, elfeÂ : peau modÃ©rÃ©ment foncÃ©e, magique, peau modÃ©rÃ©ment foncÃ©e
ğŸ§ğŸ¿	elfeÂ : peau foncÃ©e
ğŸ§â€â™‚	elfe, homme, magique
ğŸ§ğŸ»â€â™‚	elfe, elfe hommeÂ : peau claire, homme, magique, peau claire
ğŸ§ğŸ¼â€â™‚	elfe, elfe hommeÂ : peau modÃ©rÃ©ment claire, homme, magique, peau modÃ©rÃ©ment claire
ğŸ§ğŸ½â€â™‚	elfe, elfe hommeÂ : peau lÃ©gÃ¨rement mate, homme, magique, peau lÃ©gÃ¨rement mate
ğŸ§ğŸ¾â€â™‚	elfe, elfe hommeÂ : peau modÃ©rÃ©ment foncÃ©e, homme, magique, peau modÃ©rÃ©ment foncÃ©e
ğŸ§ğŸ¿â€â™‚	elfe, elfe hommeÂ : peau foncÃ©e, homme, magique, peau foncÃ©e
ğŸ§â€â™€	elfe, femme, magique
ğŸ§ğŸ»â€â™€	elfe, elfe femmeÂ : peau claire, femme, magique, peau claire
ğŸ§ğŸ¼â€â™€	elfe, elfe femmeÂ : peau modÃ©rÃ©ment claire, femme, magique, peau modÃ©rÃ©ment claire
ğŸ§ğŸ½â€â™€	elfe, elfe femmeÂ : peau lÃ©gÃ¨rement mate, femme, magique, peau lÃ©gÃ¨rement mate
ğŸ§ğŸ¾â€â™€	elfe, elfe femmeÂ : peau modÃ©rÃ©ment foncÃ©e, femme, magique, peau modÃ©rÃ©ment foncÃ©e
ğŸ§ğŸ¿â€â™€	elfe, elfe femmeÂ : peau foncÃ©e, femme, magique, peau foncÃ©e
ğŸ§â€â™‚	djinn, gÃ©nie, homme
ğŸ§â€â™€	djinn, femme, gÃ©nie
ğŸ§Ÿâ€â™‚	homme, mort-vivant, zombie
ğŸ§Ÿâ€â™€	femme, morte-vivante, zombie
ğŸ’†ğŸ»	personne qui se fait masserÂ : peau claire
ğŸ’†ğŸ¼	massage, peau modÃ©rÃ©ment claire, personne qui se fait masser, personne qui se fait masserÂ : peau modÃ©rÃ©ment claire, salon, visage
ğŸ’†ğŸ½	personne qui se fait masserÂ : peau lÃ©gÃ¨rement mate
ğŸ’†ğŸ¾	massage, peau modÃ©rÃ©ment foncÃ©e, personne qui se fait masser, personne qui se fait masserÂ : peau modÃ©rÃ©ment foncÃ©e, salon, visage
ğŸ’†ğŸ¿	personne qui se fait masserÂ : peau foncÃ©e
ğŸ’†ğŸ»â€â™‚	homme qui se fait masserÂ : peau claire
ğŸ’†ğŸ¼â€â™‚	homme, homme qui se fait masser, homme qui se fait masserÂ : peau modÃ©rÃ©ment claire, massage, peau modÃ©rÃ©ment claire, visage
ğŸ’†ğŸ½â€â™‚	homme qui se fait masserÂ : peau lÃ©gÃ¨rement mate
ğŸ’†ğŸ¾â€â™‚	homme, homme qui se fait masser, homme qui se fait masserÂ : peau modÃ©rÃ©ment foncÃ©e, massage, peau modÃ©rÃ©ment foncÃ©e, visage
ğŸ’†ğŸ¿â€â™‚	homme qui se fait masserÂ : peau foncÃ©e
ğŸ’†ğŸ»â€â™€	femme qui se fait masserÂ : peau claire
ğŸ’†ğŸ¼â€â™€	femme, femme qui se fait masser, femme qui se fait masserÂ : peau modÃ©rÃ©ment claire, massage, peau modÃ©rÃ©ment claire, visage
ğŸ’†ğŸ½â€â™€	femme qui se fait masserÂ : peau lÃ©gÃ¨rement mate
ğŸ’†ğŸ¾â€â™€	femme, femme qui se fait masser, femme qui se fait masserÂ : peau modÃ©rÃ©ment foncÃ©e, massage, peau modÃ©rÃ©ment foncÃ©e, visage
ğŸ’†ğŸ¿â€â™€	femme qui se fait masserÂ : peau foncÃ©e
ğŸ’‡ğŸ»	personne qui se fait couper les cheveuxÂ : peau claire
ğŸ’‡ğŸ¼	barbier, beautÃ©, coiffure, peau modÃ©rÃ©ment claire, personne qui se fait couper les cheveux, personne qui se fait couper les cheveuxÂ : peau modÃ©rÃ©ment claire, salon
ğŸ’‡ğŸ½	personne qui se fait couper les cheveuxÂ : peau lÃ©gÃ¨rement mate
ğŸ’‡ğŸ¾	barbier, beautÃ©, coiffure, peau modÃ©rÃ©ment foncÃ©e, personne qui se fait couper les cheveux, personne qui se fait couper les cheveuxÂ : peau modÃ©rÃ©ment foncÃ©e, salon
ğŸ’‡ğŸ¿	personne qui se fait couper les cheveuxÂ : peau foncÃ©e
ğŸ’‡â€â™‚	homme qui se fait couper les cheveux
ğŸ’‡ğŸ»â€â™‚	homme qui se fait couper les cheveux, homme qui se fait couper les cheveuxÂ : peau claire, peau claire
ğŸ’‡ğŸ¼â€â™‚	homme qui se fait couper les cheveux, homme qui se fait couper les cheveuxÂ : peau modÃ©rÃ©ment claire, peau modÃ©rÃ©ment claire
ğŸ’‡ğŸ½â€â™‚	homme qui se fait couper les cheveux, homme qui se fait couper les cheveuxÂ : peau lÃ©gÃ¨rement mate, peau lÃ©gÃ¨rement mate
ğŸ’‡ğŸ¾â€â™‚	homme qui se fait couper les cheveux, homme qui se fait couper les cheveuxÂ : peau modÃ©rÃ©ment foncÃ©e, peau modÃ©rÃ©ment foncÃ©e
ğŸ’‡ğŸ¿â€â™‚	homme qui se fait couper les cheveux, homme qui se fait couper les cheveuxÂ : peau foncÃ©e, peau foncÃ©e
ğŸ’‡â€â™€	femme qui se fait couper les cheveux
ğŸ’‡ğŸ»â€â™€	femme qui se fait couper les cheveux, femme qui se fait couper les cheveuxÂ : peau claire, peau claire
ğŸ’‡ğŸ¼â€â™€	femme qui se fait couper les cheveux, femme qui se fait couper les cheveuxÂ : peau modÃ©rÃ©ment claire, peau modÃ©rÃ©ment claire
ğŸ’‡ğŸ½â€â™€	femme qui se fait couper les cheveux, femme qui se fait couper les cheveuxÂ : peau lÃ©gÃ¨rement mate, peau lÃ©gÃ¨rement mate
ğŸ’‡ğŸ¾â€â™€	femme qui se fait couper les cheveux, femme qui se fait couper les cheveuxÂ : peau modÃ©rÃ©ment foncÃ©e, peau modÃ©rÃ©ment foncÃ©e
ğŸ’‡ğŸ¿â€â™€	femme qui se fait couper les cheveux, femme qui se fait couper les cheveuxÂ : peau foncÃ©e, peau foncÃ©e
ğŸš¶	personne qui marche, piÃ©ton, randonnÃ©e
ğŸš¶ğŸ»	peau claire, personne qui marche, personne qui marcheÂ : peau claire, piÃ©ton, randonnÃ©e
ğŸš¶ğŸ¼	peau modÃ©rÃ©ment claire, personne qui marche, personne qui marcheÂ : peau modÃ©rÃ©ment claire, piÃ©ton, randonnÃ©e
ğŸš¶ğŸ½	peau lÃ©gÃ¨rement mate, personne qui marche, personne qui marcheÂ : peau lÃ©gÃ¨rement mate, piÃ©ton, randonnÃ©e
ğŸš¶ğŸ¾	peau modÃ©rÃ©ment foncÃ©e, personne qui marche, personne qui marcheÂ : peau modÃ©rÃ©ment foncÃ©e, piÃ©ton, randonnÃ©e
ğŸš¶ğŸ¿	peau foncÃ©e, personne qui marche, personne qui marcheÂ : peau foncÃ©e, piÃ©ton, randonnÃ©e
ğŸš¶â€â™‚	homme, marche, piÃ©ton, randonnÃ©e
ğŸš¶ğŸ»â€â™‚	homme, homme qui marcheÂ : peau claire, marche, peau claire, piÃ©ton, randonnÃ©e
ğŸš¶ğŸ¼â€â™‚	homme, homme qui marcheÂ : peau modÃ©rÃ©ment claire, marche, peau modÃ©rÃ©ment claire, piÃ©ton, randonnÃ©e
ğŸš¶ğŸ½â€â™‚	homme, homme qui marcheÂ : peau lÃ©gÃ¨rement mate, marche, peau lÃ©gÃ¨rement mate, piÃ©ton, randonnÃ©e
ğŸš¶ğŸ¾â€â™‚	homme, homme qui marcheÂ : peau modÃ©rÃ©ment foncÃ©e, marche, peau modÃ©rÃ©ment foncÃ©e, piÃ©ton, randonnÃ©e
ğŸš¶ğŸ¿â€â™‚	homme, homme qui marcheÂ : peau foncÃ©e, marche, peau foncÃ©e, piÃ©ton, randonnÃ©e
ğŸš¶â€â™€	femme, marche, piÃ©tonne, randonnÃ©e
ğŸš¶ğŸ»â€â™€	femme, femme qui marcheÂ : peau claire, marche, peau claire, piÃ©tonne, randonnÃ©e
ğŸš¶ğŸ¼â€â™€	femme, femme qui marcheÂ : peau modÃ©rÃ©ment claire, marche, peau modÃ©rÃ©ment claire, piÃ©tonne, randonnÃ©e
ğŸš¶ğŸ½â€â™€	femme, femme qui marcheÂ : peau lÃ©gÃ¨rement mate, marche, peau lÃ©gÃ¨rement mate, piÃ©tonne, randonnÃ©e
ğŸš¶ğŸ¾â€â™€	femme, femme qui marcheÂ : peau modÃ©rÃ©ment foncÃ©e, marche, peau modÃ©rÃ©ment foncÃ©e, piÃ©tonne, randonnÃ©e
ğŸš¶ğŸ¿â€â™€	femme, femme qui marcheÂ : peau foncÃ©e, marche, peau foncÃ©e, piÃ©tonne, randonnÃ©e
ğŸ§ğŸ»	personne deboutÂ : peau claire
ğŸ§ğŸ¼	debout, peau modÃ©rÃ©ment claire, personne debout, personne deboutÂ : peau modÃ©rÃ©ment claire
ğŸ§ğŸ½	personne deboutÂ : peau lÃ©gÃ¨rement mate
ğŸ§ğŸ¾	debout, peau modÃ©rÃ©ment foncÃ©e, personne debout, personne deboutÂ : peau modÃ©rÃ©ment foncÃ©e
ğŸ§ğŸ¿	personne deboutÂ : peau foncÃ©e
ğŸ§ğŸ»â€â™‚	homme deboutÂ : peau claire
ğŸ§ğŸ¼â€â™‚	debout, homme, homme deboutÂ : peau modÃ©rÃ©ment claire, peau modÃ©rÃ©ment claire
ğŸ§ğŸ½â€â™‚	homme deboutÂ : peau lÃ©gÃ¨rement mate
ğŸ§ğŸ¾â€â™‚	debout, homme, homme deboutÂ : peau modÃ©rÃ©ment foncÃ©e, peau modÃ©rÃ©ment foncÃ©e
ğŸ§ğŸ¿â€â™‚	homme deboutÂ : peau foncÃ©e
ğŸ§ğŸ»â€â™€	femme deboutÂ : peau claire
ğŸ§ğŸ¼â€â™€	debout, femme, femme deboutÂ : peau modÃ©rÃ©ment claire, peau modÃ©rÃ©ment claire
ğŸ§ğŸ½â€â™€	femme deboutÂ : peau lÃ©gÃ¨rement mate
ğŸ§ğŸ¾â€â™€	debout, femme, femme deboutÂ : peau modÃ©rÃ©ment foncÃ©e, peau modÃ©rÃ©ment foncÃ©e
ğŸ§ğŸ¿â€â™€	femme deboutÂ : peau foncÃ©e
ğŸ§ğŸ»	personne Ã  genouxÂ : peau claire
ğŸ§ğŸ¼	peau modÃ©rÃ©ment claire, personne Ã  genoux, personne Ã  genouxÂ : peau modÃ©rÃ©ment claire, Ã  genoux
ğŸ§ğŸ½	personne Ã  genouxÂ : peau lÃ©gÃ¨rement mate
ğŸ§ğŸ¾	peau modÃ©rÃ©ment foncÃ©e, personne Ã  genoux, personne Ã  genouxÂ : peau modÃ©rÃ©ment foncÃ©e, Ã  genoux
ğŸ§ğŸ¿	personne Ã  genouxÂ : peau foncÃ©e
ğŸ§ğŸ»â€â™‚	homme Ã  genouxÂ : peau claire
ğŸ§ğŸ¼â€â™‚	homme, homme Ã  genoux, homme Ã  genouxÂ : peau modÃ©rÃ©ment claire, peau modÃ©rÃ©ment claire, Ã  genoux
ğŸ§ğŸ½â€â™‚	homme Ã  genouxÂ : peau lÃ©gÃ¨rement mate
ğŸ§ğŸ¾â€â™‚	homme, homme Ã  genoux, homme Ã  genouxÂ : peau modÃ©rÃ©ment foncÃ©e, peau modÃ©rÃ©ment foncÃ©e, Ã  genoux
ğŸ§ğŸ¿â€â™‚	homme Ã  genouxÂ : peau foncÃ©e
ğŸ§ğŸ»â€â™€	femme Ã  genouxÂ : peau claire
ğŸ§ğŸ¼â€â™€	femme, femme Ã  genoux, femme Ã  genouxÂ : peau modÃ©rÃ©ment claire, peau modÃ©rÃ©ment claire, Ã  genoux
ğŸ§ğŸ½â€â™€	femme Ã  genouxÂ : peau lÃ©gÃ¨rement mate
ğŸ§ğŸ¾â€â™€	femme, femme Ã  genoux, femme Ã  genouxÂ : peau modÃ©rÃ©ment foncÃ©e, peau modÃ©rÃ©ment foncÃ©e, Ã  genoux
ğŸ§ğŸ¿â€â™€	femme Ã  genouxÂ : peau foncÃ©e
ğŸ‘¨ğŸ»â€ğŸ¦¯	homme avec canne blancheÂ : peau claire
ğŸ‘¨ğŸ¼â€ğŸ¦¯	accessibilitÃ©, aveugle, dÃ©ficient visuel, homme, homme avec canne blanche, homme avec canne blancheÂ : peau modÃ©rÃ©ment claire, malvoyant, peau modÃ©rÃ©ment claire
ğŸ‘¨ğŸ½â€ğŸ¦¯	homme avec canne blancheÂ : peau lÃ©gÃ¨rement mate
ğŸ‘¨ğŸ¾â€ğŸ¦¯	accessibilitÃ©, aveugle, dÃ©ficient visuel, homme, homme avec canne blanche, homme avec canne blancheÂ : peau modÃ©rÃ©ment foncÃ©e, malvoyant, peau modÃ©rÃ©ment foncÃ©e
ğŸ‘¨ğŸ¿â€ğŸ¦¯	homme avec canne blancheÂ : peau foncÃ©e
ğŸ‘©â€ğŸ¦¯	accessibilitÃ©, aveugle, dÃ©ficiente visuelle, femme, malvoyante
ğŸ‘©ğŸ»â€ğŸ¦¯	accessibilitÃ©, aveugle, dÃ©ficiente visuelle, femme, femme avec canne blancheÂ : peau claire, malvoyante, peau claire
ğŸ‘©ğŸ¼â€ğŸ¦¯	accessibilitÃ©, aveugle, dÃ©ficiente visuelle, femme, femme avec canne blancheÂ : peau modÃ©rÃ©ment claire, malvoyante, peau modÃ©rÃ©ment claire
ğŸ‘©ğŸ½â€ğŸ¦¯	accessibilitÃ©, aveugle, dÃ©ficiente visuelle, femme, femme avec canne blancheÂ : peau lÃ©gÃ¨rement mate, malvoyante, peau lÃ©gÃ¨rement mate
ğŸ‘©ğŸ¾â€ğŸ¦¯	accessibilitÃ©, aveugle, dÃ©ficiente visuelle, femme, femme avec canne blancheÂ : peau modÃ©rÃ©ment foncÃ©e, malvoyante, peau modÃ©rÃ©ment foncÃ©e
ğŸ‘©ğŸ¿â€ğŸ¦¯	accessibilitÃ©, aveugle, dÃ©ficiente visuelle, femme, femme avec canne blancheÂ : peau foncÃ©e, malvoyante, peau foncÃ©e
ğŸ‘¨ğŸ»â€ğŸ¦¼	homme en fauteuil motorisÃ©Â : peau claire
ğŸ‘¨ğŸ¼â€ğŸ¦¼	accessibilitÃ©, fauteuil roulant, homme, homme en fauteuil motorisÃ©, homme en fauteuil motorisÃ©Â : peau modÃ©rÃ©ment claire, peau modÃ©rÃ©ment claire
ğŸ‘¨ğŸ½â€ğŸ¦¼	homme en fauteuil motorisÃ©Â : peau lÃ©gÃ¨rement mate
ğŸ‘¨ğŸ¾â€ğŸ¦¼	accessibilitÃ©, fauteuil roulant, homme, homme en fauteuil motorisÃ©, homme en fauteuil motorisÃ©Â : peau modÃ©rÃ©ment foncÃ©e, peau modÃ©rÃ©ment foncÃ©e
ğŸ‘¨ğŸ¿â€ğŸ¦¼	homme en fauteuil motorisÃ©Â : peau foncÃ©e
ğŸ‘©ğŸ»â€ğŸ¦¼	femme en fauteuil motorisÃ©Â : peau claire
ğŸ‘©ğŸ¼â€ğŸ¦¼	accessibilitÃ©, fauteuil roulant, femme, femme en fauteuil motorisÃ©, femme en fauteuil motorisÃ©Â : peau modÃ©rÃ©ment claire, peau modÃ©rÃ©ment claire
ğŸ‘©ğŸ½â€ğŸ¦¼	femme en fauteuil motorisÃ©Â : peau lÃ©gÃ¨rement mate
ğŸ‘©ğŸ¾â€ğŸ¦¼	accessibilitÃ©, fauteuil roulant, femme, femme en fauteuil motorisÃ©, femme en fauteuil motorisÃ©Â : peau modÃ©rÃ©ment foncÃ©e, peau modÃ©rÃ©ment foncÃ©e
ğŸ‘©ğŸ¿â€ğŸ¦¼	femme en fauteuil motorisÃ©Â : peau foncÃ©e
ğŸ‘¨ğŸ»â€ğŸ¦½	homme en fauteuil roulant manuelÂ : peau claire
ğŸ‘¨ğŸ¼â€ğŸ¦½	accessibilitÃ©, fauteuil roulant, homme, homme en fauteuil roulant manuel, homme en fauteuil roulant manuelÂ : peau modÃ©rÃ©ment claire, peau modÃ©rÃ©ment claire
ğŸ‘¨ğŸ½â€ğŸ¦½	homme en fauteuil roulant manuelÂ : peau lÃ©gÃ¨rement mate
ğŸ‘¨ğŸ¾â€ğŸ¦½	accessibilitÃ©, fauteuil roulant, homme, homme en fauteuil roulant manuel, homme en fauteuil roulant manuelÂ : peau modÃ©rÃ©ment foncÃ©e, peau modÃ©rÃ©ment foncÃ©e
ğŸ‘¨ğŸ¿â€ğŸ¦½	homme en fauteuil roulant manuelÂ : peau foncÃ©e
ğŸ‘©ğŸ»â€ğŸ¦½	femme en fauteuil roulant manuelÂ : peau claire
ğŸ‘©ğŸ¼â€ğŸ¦½	accessibilitÃ©, fauteuil roulant, femme, femme en fauteuil roulant manuel, femme en fauteuil roulant manuelÂ : peau modÃ©rÃ©ment claire, peau modÃ©rÃ©ment claire
ğŸ‘©ğŸ½â€ğŸ¦½	femme en fauteuil roulant manuelÂ : peau lÃ©gÃ¨rement mate
ğŸ‘©ğŸ¾â€ğŸ¦½	accessibilitÃ©, fauteuil roulant, femme, femme en fauteuil roulant manuel, femme en fauteuil roulant manuelÂ : peau modÃ©rÃ©ment foncÃ©e, peau modÃ©rÃ©ment foncÃ©e
ğŸ‘©ğŸ¿â€ğŸ¦½	femme en fauteuil roulant manuelÂ : peau foncÃ©e
ğŸƒ	personne qui court
ğŸƒğŸ»	peau claire, personne qui court, personne qui courtÂ : peau claire
ğŸƒğŸ¼	peau modÃ©rÃ©ment claire, personne qui court, personne qui courtÂ : peau modÃ©rÃ©ment claire
ğŸƒğŸ½	peau lÃ©gÃ¨rement mate, personne qui court, personne qui courtÂ : peau lÃ©gÃ¨rement mate
ğŸƒğŸ¾	peau modÃ©rÃ©ment foncÃ©e, personne qui court, personne qui courtÂ : peau modÃ©rÃ©ment foncÃ©e
ğŸƒğŸ¿	peau foncÃ©e, personne qui court, personne qui courtÂ : peau foncÃ©e
ğŸƒâ€â™‚	homme qui court
ğŸƒğŸ»â€â™‚	homme qui court, homme qui courtÂ : peau claire, peau claire
ğŸƒğŸ¼â€â™‚	homme qui court, homme qui courtÂ : peau modÃ©rÃ©ment claire, peau modÃ©rÃ©ment claire
ğŸƒğŸ½â€â™‚	homme qui court, homme qui courtÂ : peau lÃ©gÃ¨rement mate, peau lÃ©gÃ¨rement mate
ğŸƒğŸ¾â€â™‚	homme qui court, homme qui courtÂ : peau modÃ©rÃ©ment foncÃ©e, peau modÃ©rÃ©ment foncÃ©e
ğŸƒğŸ¿â€â™‚	homme qui court, homme qui courtÂ : peau foncÃ©e, peau foncÃ©e
ğŸƒâ€â™€	femme qui court
ğŸƒğŸ»â€â™€	femme qui court, femme qui courtÂ : peau claire, peau claire
ğŸƒğŸ¼â€â™€	femme qui court, femme qui courtÂ : peau modÃ©rÃ©ment claire, peau modÃ©rÃ©ment claire
ğŸƒğŸ½â€â™€	femme qui court, femme qui courtÂ : peau lÃ©gÃ¨rement mate, peau lÃ©gÃ¨rement mate
ğŸƒğŸ¾â€â™€	femme qui court, femme qui courtÂ : peau modÃ©rÃ©ment foncÃ©e, peau modÃ©rÃ©ment foncÃ©e
ğŸƒğŸ¿â€â™€	femme qui court, femme qui courtÂ : peau foncÃ©e, peau foncÃ©e
ğŸ’ƒğŸ»	danseuseÂ : peau claire
ğŸ’ƒğŸ¼	danse, danseuse, danseuseÂ : peau modÃ©rÃ©ment claire, femme, peau modÃ©rÃ©ment claire
ğŸ’ƒğŸ½	danseuseÂ : peau lÃ©gÃ¨rement mate
ğŸ’ƒğŸ¾	danse, danseuse, danseuseÂ : peau modÃ©rÃ©ment foncÃ©e, femme, peau modÃ©rÃ©ment foncÃ©e
ğŸ’ƒğŸ¿	danseuseÂ : peau foncÃ©e
ğŸ•ºğŸ»	danseurÂ : peau claire
ğŸ•ºğŸ¼	danse, danseur, danseurÂ : peau modÃ©rÃ©ment claire, homme, peau modÃ©rÃ©ment claire
ğŸ•ºğŸ½	danseurÂ : peau lÃ©gÃ¨rement mate
ğŸ•ºğŸ¾	danse, danseur, danseurÂ : peau modÃ©rÃ©ment foncÃ©e, homme, peau modÃ©rÃ©ment foncÃ©e
ğŸ•ºğŸ¿	danseurÂ : peau foncÃ©e
ğŸ•´ï¸	affaires, complet, homme, lÃ©vitation
ğŸ•´ğŸ»	affaires, complet, homme, homme dâ€™affaires en lÃ©vitationÂ : peau claire, lÃ©vitation, peau claire
ğŸ•´ğŸ¼	affaires, complet, homme, homme dâ€™affaires en lÃ©vitationÂ : peau modÃ©rÃ©ment claire, lÃ©vitation, peau modÃ©rÃ©ment claire
ğŸ•´ğŸ½	affaires, complet, homme, homme dâ€™affaires en lÃ©vitationÂ : peau lÃ©gÃ¨rement mate, lÃ©vitation, peau lÃ©gÃ¨rement mate
ğŸ•´ğŸ¾	affaires, complet, homme, homme dâ€™affaires en lÃ©vitationÂ : peau modÃ©rÃ©ment foncÃ©e, lÃ©vitation, peau modÃ©rÃ©ment foncÃ©e
ğŸ•´ğŸ¿	affaires, complet, homme, homme dâ€™affaires en lÃ©vitationÂ : peau foncÃ©e, lÃ©vitation, peau foncÃ©e
ğŸ‘¯	danseuse, femme, fille, oreilles, personnes qui portent des oreilles de lapin
ğŸ‘¯â€â™‚	danseur, fÃªte, homme, hommes qui portent des oreilles de lapin, oreilles de lapin
ğŸ‘¯â€â™€	danseuse, femme, femmes qui portent des oreilles de lapin, fÃªte, oreilles de lapin
ğŸ§–	hammam, personne dans un bain de vapeur, sauna
ğŸ§–ğŸ»	hammam, peau claire, personne dans un bain de vapeur, personne dans un bain de vapeurÂ : peau claire, sauna
ğŸ§–ğŸ¼	hammam, peau modÃ©rÃ©ment claire, personne dans un bain de vapeur, personne dans un bain de vapeurÂ : peau modÃ©rÃ©ment claire, sauna
ğŸ§–ğŸ½	hammam, peau lÃ©gÃ¨rement mate, personne dans un bain de vapeur, personne dans un bain de vapeurÂ : peau lÃ©gÃ¨rement mate, sauna
ğŸ§–ğŸ¾	hammam, peau modÃ©rÃ©ment foncÃ©e, personne dans un bain de vapeur, personne dans un bain de vapeurÂ : peau modÃ©rÃ©ment foncÃ©e, sauna
ğŸ§–ğŸ¿	hammam, peau foncÃ©e, personne dans un bain de vapeur, personne dans un bain de vapeurÂ : peau foncÃ©e, sauna
ğŸ§–â€â™‚	hammam, homme dans un bain de vapeur, sauna
ğŸ§–ğŸ»â€â™‚	hammam, homme dans un bain de vapeur, homme dans un bain de vapeurÂ : peau claire, peau claire, sauna
ğŸ§–ğŸ¼â€â™‚	hammam, homme dans un bain de vapeur, homme dans un bain de vapeurÂ : peau modÃ©rÃ©ment claire, peau modÃ©rÃ©ment claire, sauna
ğŸ§–ğŸ½â€â™‚	hammam, homme dans un bain de vapeur, homme dans un bain de vapeurÂ : peau lÃ©gÃ¨rement mate, peau lÃ©gÃ¨rement mate, sauna
ğŸ§–ğŸ¾â€â™‚	hammam, homme dans un bain de vapeur, homme dans un bain de vapeurÂ : peau modÃ©rÃ©ment foncÃ©e, peau modÃ©rÃ©ment foncÃ©e, sauna
ğŸ§–ğŸ¿â€â™‚	hammam, homme dans un bain de vapeur, homme dans un bain de vapeurÂ : peau foncÃ©e, peau foncÃ©e, sauna
ğŸ§–â€â™€	femme dans un bain de vapeur, hammam, sauna
ğŸ§–ğŸ»â€â™€	femme dans un bain de vapeur, femme dans un bain de vapeurÂ : peau claire, hammam, peau claire, sauna
ğŸ§–ğŸ¼â€â™€	femme dans un bain de vapeur, femme dans un bain de vapeurÂ : peau modÃ©rÃ©ment claire, hammam, peau modÃ©rÃ©ment claire, sauna
ğŸ§–ğŸ½â€â™€	femme dans un bain de vapeur, femme dans un bain de vapeurÂ : peau lÃ©gÃ¨rement mate, hammam, peau lÃ©gÃ¨rement mate, sauna
ğŸ§–ğŸ¾â€â™€	femme dans un bain de vapeur, femme dans un bain de vapeurÂ : peau modÃ©rÃ©ment foncÃ©e, hammam, peau modÃ©rÃ©ment foncÃ©e, sauna
ğŸ§–ğŸ¿â€â™€	femme dans un bain de vapeur, femme dans un bain de vapeurÂ : peau foncÃ©e, hammam, peau foncÃ©e, sauna
ğŸ§—ğŸ»	personne qui grimpeÂ : peau claire
ğŸ§—ğŸ¼	alpiniste, grimpeur, peau modÃ©rÃ©ment claire, personne qui grimpe, personne qui grimpeÂ : peau modÃ©rÃ©ment claire
ğŸ§—ğŸ½	personne qui grimpeÂ : peau lÃ©gÃ¨rement mate
ğŸ§—ğŸ¾	alpiniste, grimpeur, peau modÃ©rÃ©ment foncÃ©e, personne qui grimpe, personne qui grimpeÂ : peau modÃ©rÃ©ment foncÃ©e
ğŸ§—ğŸ¿	personne qui grimpeÂ : peau foncÃ©e
ğŸ§—ğŸ»â€â™‚	homme qui grimpeÂ : peau claire
ğŸ§—ğŸ¼â€â™‚	alpiniste, grimpeur, homme qui grimpe, homme qui grimpeÂ : peau modÃ©rÃ©ment claire, peau modÃ©rÃ©ment claire
ğŸ§—ğŸ½â€â™‚	homme qui grimpeÂ : peau lÃ©gÃ¨rement mate
ğŸ§—ğŸ¾â€â™‚	alpiniste, grimpeur, homme qui grimpe, homme qui grimpeÂ : peau modÃ©rÃ©ment foncÃ©e, peau modÃ©rÃ©ment foncÃ©e
ğŸ§—ğŸ¿â€â™‚	homme qui grimpeÂ : peau foncÃ©e
ğŸ§—ğŸ»â€â™€	femme qui grimpeÂ : peau claire
ğŸ§—ğŸ¼â€â™€	alpiniste, femme qui grimpe, femme qui grimpeÂ : peau modÃ©rÃ©ment claire, grimpeuse, peau modÃ©rÃ©ment claire
ğŸ§—ğŸ½â€â™€	femme qui grimpeÂ : peau lÃ©gÃ¨rement mate
ğŸ§—ğŸ¾â€â™€	alpiniste, femme qui grimpe, femme qui grimpeÂ : peau modÃ©rÃ©ment foncÃ©e, grimpeuse, peau modÃ©rÃ©ment foncÃ©e
ğŸ§—ğŸ¿â€â™€	femme qui grimpeÂ : peau foncÃ©e
ğŸ¤º	duel, escrime, escrimeur, personne, Ã©pÃ©e
ğŸ‡	chevaux, course, hippique, jockey
ğŸ‡ğŸ»	chevaux, course, course hippiqueÂ : peau claire, hippique, jockey, peau claire
ğŸ‡ğŸ¼	chevaux, course, course hippiqueÂ : peau modÃ©rÃ©ment claire, hippique, jockey, peau modÃ©rÃ©ment claire
ğŸ‡ğŸ½	chevaux, course, course hippiqueÂ : peau lÃ©gÃ¨rement mate, hippique, jockey, peau lÃ©gÃ¨rement mate
ğŸ‡ğŸ¾	chevaux, course, course hippiqueÂ : peau modÃ©rÃ©ment foncÃ©e, hippique, jockey, peau modÃ©rÃ©ment foncÃ©e
ğŸ‡ğŸ¿	chevaux, course, course hippiqueÂ : peau foncÃ©e, hippique, jockey, peau foncÃ©e
â›·ï¸	ski, skier, skieur, sport
ğŸ‚ï¸	neige, planche de neige, planchiste, ski
ğŸ‚ğŸ»	neige, peau claire, planche de neige, planchiste, planchisteÂ : peau claire, ski
ğŸ‚ğŸ¼	neige, peau modÃ©rÃ©ment claire, planche de neige, planchiste, planchisteÂ : peau modÃ©rÃ©ment claire, ski
ğŸ‚ğŸ½	neige, peau lÃ©gÃ¨rement mate, planche de neige, planchiste, planchisteÂ : peau lÃ©gÃ¨rement mate, ski
ğŸ‚ğŸ¾	neige, peau modÃ©rÃ©ment foncÃ©e, planche de neige, planchiste, planchisteÂ : peau modÃ©rÃ©ment foncÃ©e, ski
ğŸ‚ğŸ¿	neige, peau foncÃ©e, planche de neige, planchiste, planchisteÂ : peau foncÃ©e, ski
ğŸŒğŸ»	joueur de golfÂ : peau claire
ğŸŒğŸ¼	balle, golf, joueur de golf, joueur de golfÂ : peau modÃ©rÃ©ment claire, peau modÃ©rÃ©ment claire
ğŸŒğŸ½	joueur de golfÂ : peau lÃ©gÃ¨rement mate
ğŸŒğŸ¾	balle, golf, joueur de golf, joueur de golfÂ : peau modÃ©rÃ©ment foncÃ©e, peau modÃ©rÃ©ment foncÃ©e
ğŸŒğŸ¿	joueur de golfÂ : peau foncÃ©e
ğŸŒğŸ»â€â™‚	golfeurÂ : peau claire
ğŸŒğŸ¼â€â™‚	golf, golfeur, golfeurÂ : peau modÃ©rÃ©ment claire, homme, peau modÃ©rÃ©ment claire
ğŸŒğŸ½â€â™‚	golfeurÂ : peau lÃ©gÃ¨rement mate
ğŸŒğŸ¾â€â™‚	golf, golfeur, golfeurÂ : peau modÃ©rÃ©ment foncÃ©e, homme, peau modÃ©rÃ©ment foncÃ©e
ğŸŒğŸ¿â€â™‚	golfeurÂ : peau foncÃ©e
ğŸŒğŸ»â€â™€	golfeuseÂ : peau claire
ğŸŒğŸ¼â€â™€	femme, golf, golfeuse, golfeuseÂ : peau modÃ©rÃ©ment claire, peau modÃ©rÃ©ment claire
ğŸŒğŸ½â€â™€	golfeuseÂ : peau lÃ©gÃ¨rement mate
ğŸŒğŸ¾â€â™€	femme, golf, golfeuse, golfeuseÂ : peau modÃ©rÃ©ment foncÃ©e, peau modÃ©rÃ©ment foncÃ©e
ğŸŒğŸ¿â€â™€	golfeuseÂ : peau foncÃ©e
ğŸ„ï¸	personne, personne qui fait du surf, surf
ğŸ„ğŸ»	peau claire, personne, personne qui fait du surf, personne qui fait du surfÂ : peau claire, surf
ğŸ„ğŸ¼	peau modÃ©rÃ©ment claire, personne, personne qui fait du surf, personne qui fait du surfÂ : peau modÃ©rÃ©ment claire, surf
ğŸ„ğŸ½	peau lÃ©gÃ¨rement mate, personne, personne qui fait du surf, personne qui fait du surfÂ : peau lÃ©gÃ¨rement mate, surf
ğŸ„ğŸ¾	peau modÃ©rÃ©ment foncÃ©e, personne, personne qui fait du surf, personne qui fait du surfÂ : peau modÃ©rÃ©ment foncÃ©e, surf
ğŸ„ğŸ¿	peau foncÃ©e, personne, personne qui fait du surf, personne qui fait du surfÂ : peau foncÃ©e, surf
ğŸ„ğŸ»â€â™‚	surfeurÂ : peau claire
ğŸ„ğŸ¼â€â™‚	homme, peau modÃ©rÃ©ment claire, surf, surfeur, surfeurÂ : peau modÃ©rÃ©ment claire
ğŸ„ğŸ½â€â™‚	surfeurÂ : peau lÃ©gÃ¨rement mate
ğŸ„ğŸ¾â€â™‚	homme, peau modÃ©rÃ©ment foncÃ©e, surf, surfeur, surfeurÂ : peau modÃ©rÃ©ment foncÃ©e
ğŸ„ğŸ¿â€â™‚	surfeurÂ : peau foncÃ©e
ğŸ„ğŸ»â€â™€	surfeuseÂ : peau claire
ğŸ„ğŸ¼â€â™€	femme, peau modÃ©rÃ©ment claire, surf, surfeuse, surfeuseÂ : peau modÃ©rÃ©ment claire
ğŸ„ğŸ½â€â™€	surfeuseÂ : peau lÃ©gÃ¨rement mate
ğŸ„ğŸ¾â€â™€	femme, peau modÃ©rÃ©ment foncÃ©e, surf, surfeuse, surfeuseÂ : peau modÃ©rÃ©ment foncÃ©e
ğŸ„ğŸ¿â€â™€	surfeuseÂ : peau foncÃ©e
ğŸš£	barque, bateau, personne, personne qui rame dans une barque, ramer
ğŸš£ğŸ»	barque, bateau, peau claire, personne, personne qui rame dans une barque, personne qui rame dans une barqueÂ : peau claire, ramer
ğŸš£ğŸ¼	barque, bateau, peau modÃ©rÃ©ment claire, personne, personne qui rame dans une barque, personne qui rame dans une barqueÂ : peau modÃ©rÃ©ment claire, ramer
ğŸš£ğŸ½	barque, bateau, peau lÃ©gÃ¨rement mate, personne, personne qui rame dans une barque, personne qui rame dans une barqueÂ : peau lÃ©gÃ¨rement mate, ramer
ğŸš£ğŸ¾	barque, bateau, peau modÃ©rÃ©ment foncÃ©e, personne, personne qui rame dans une barque, personne qui rame dans une barqueÂ : peau modÃ©rÃ©ment foncÃ©e, ramer
ğŸš£ğŸ¿	barque, bateau, peau foncÃ©e, personne, personne qui rame dans une barque, personne qui rame dans une barqueÂ : peau foncÃ©e, ramer
ğŸš£â€â™‚	barque, bateau, homme, rameur
ğŸš£ğŸ»â€â™‚	barque, bateau, homme, peau claire, rameur, rameur dans une barqueÂ : peau claire
ğŸš£ğŸ¼â€â™‚	barque, bateau, homme, peau modÃ©rÃ©ment claire, rameur, rameur dans une barqueÂ : peau modÃ©rÃ©ment claire
ğŸš£ğŸ½â€â™‚	barque, bateau, homme, peau lÃ©gÃ¨rement mate, rameur, rameur dans une barqueÂ : peau lÃ©gÃ¨rement mate
ğŸš£ğŸ¾â€â™‚	barque, bateau, homme, peau modÃ©rÃ©ment foncÃ©e, rameur, rameur dans une barqueÂ : peau modÃ©rÃ©ment foncÃ©e
ğŸš£ğŸ¿â€â™‚	barque, bateau, homme, peau foncÃ©e, rameur, rameur dans une barqueÂ : peau foncÃ©e
ğŸš£â€â™€	barque, bateau, femme, rameuse
ğŸš£ğŸ»â€â™€	barque, bateau, femme, peau claire, rameuse, rameuse dans une barqueÂ : peau claire
ğŸš£ğŸ¼â€â™€	barque, bateau, femme, peau modÃ©rÃ©ment claire, rameuse, rameuse dans une barqueÂ : peau modÃ©rÃ©ment claire
ğŸš£ğŸ½â€â™€	barque, bateau, femme, peau lÃ©gÃ¨rement mate, rameuse, rameuse dans une barqueÂ : peau lÃ©gÃ¨rement mate
ğŸš£ğŸ¾â€â™€	barque, bateau, femme, peau modÃ©rÃ©ment foncÃ©e, rameuse, rameuse dans une barqueÂ : peau modÃ©rÃ©ment foncÃ©e
ğŸš£ğŸ¿â€â™€	barque, bateau, femme, peau foncÃ©e, rameuse, rameuse dans une barqueÂ : peau foncÃ©e
ğŸŠï¸	nager, natation, personne qui nage
ğŸŠğŸ»	nager, natation, peau claire, personne qui nage, personne qui nageÂ : peau claire
ğŸŠğŸ¼	nager, natation, peau modÃ©rÃ©ment claire, personne qui nage, personne qui nageÂ : peau modÃ©rÃ©ment claire
ğŸŠğŸ½	nager, natation, peau lÃ©gÃ¨rement mate, personne qui nage, personne qui nageÂ : peau lÃ©gÃ¨rement mate
ğŸŠğŸ¾	nager, natation, peau modÃ©rÃ©ment foncÃ©e, personne qui nage, personne qui nageÂ : peau modÃ©rÃ©ment foncÃ©e
ğŸŠğŸ¿	nager, natation, peau foncÃ©e, personne qui nage, personne qui nageÂ : peau foncÃ©e
ğŸŠğŸ»â€â™‚	nageurÂ : peau claire
ğŸŠğŸ¼â€â™‚	homme, nage, nageur, nageurÂ : peau modÃ©rÃ©ment claire, peau modÃ©rÃ©ment claire
ğŸŠğŸ½â€â™‚	nageurÂ : peau lÃ©gÃ¨rement mate
ğŸŠğŸ¾â€â™‚	homme, nage, nageur, nageurÂ : peau modÃ©rÃ©ment foncÃ©e, peau modÃ©rÃ©ment foncÃ©e
ğŸŠğŸ¿â€â™‚	nageurÂ : peau foncÃ©e
ğŸŠğŸ»â€â™€	nageuseÂ : peau claire
ğŸŠğŸ¼â€â™€	femme, nage, nageuse, nageuseÂ : peau modÃ©rÃ©ment claire, peau modÃ©rÃ©ment claire
ğŸŠğŸ½â€â™€	nageuseÂ : peau lÃ©gÃ¨rement mate
ğŸŠğŸ¾â€â™€	femme, nage, nageuse, nageuseÂ : peau modÃ©rÃ©ment foncÃ©e, peau modÃ©rÃ©ment foncÃ©e
ğŸŠğŸ¿â€â™€	nageuseÂ : peau foncÃ©e
â›¹ï¸	ballon, personne qui fait rebondir un ballon, rebond, rebondir
â›¹ğŸ»	ballon, peau claire, personne qui fait rebondir un ballon, personne qui fait rebondir un ballonÂ : peau claire, rebond, rebondir
â›¹ğŸ¼	ballon, peau modÃ©rÃ©ment claire, personne qui fait rebondir un ballon, personne qui fait rebondir un ballonÂ : peau modÃ©rÃ©ment claire, rebond, rebondir
â›¹ğŸ½	ballon, peau lÃ©gÃ¨rement mate, personne qui fait rebondir un ballon, personne qui fait rebondir un ballonÂ : peau lÃ©gÃ¨rement mate, rebond, rebondir
â›¹ğŸ¾	ballon, peau modÃ©rÃ©ment foncÃ©e, personne qui fait rebondir un ballon, personne qui fait rebondir un ballonÂ : peau modÃ©rÃ©ment foncÃ©e, rebond, rebondir
â›¹ğŸ¿	ballon, peau foncÃ©e, personne qui fait rebondir un ballon, personne qui fait rebondir un ballonÂ : peau foncÃ©e, rebond, rebondir
â›¹â€â™‚	ballon, homme, homme qui fait rebondir un ballon, rebond, rebondir
â›¹ğŸ»â€â™‚	ballon, homme, homme qui fait rebondir un ballon, homme qui fait rebondir un ballonÂ : peau claire, peau claire, rebond, rebondir
â›¹ğŸ¼â€â™‚	ballon, homme, homme qui fait rebondir un ballon, homme qui fait rebondir un ballonÂ : peau modÃ©rÃ©ment claire, peau modÃ©rÃ©ment claire, rebond, rebondir
â›¹ğŸ½â€â™‚	ballon, homme, homme qui fait rebondir un ballon, homme qui fait rebondir un ballonÂ : peau lÃ©gÃ¨rement mate, peau lÃ©gÃ¨rement mate, rebond, rebondir
â›¹ğŸ¾â€â™‚	ballon, homme, homme qui fait rebondir un ballon, homme qui fait rebondir un ballonÂ : peau modÃ©rÃ©ment foncÃ©e, peau modÃ©rÃ©ment foncÃ©e, rebond, rebondir
â›¹ğŸ¿â€â™‚	ballon, homme, homme qui fait rebondir un ballon, homme qui fait rebondir un ballonÂ : peau foncÃ©e, peau foncÃ©e, rebond, rebondir
â›¹â€â™€	ballon, femme, femme qui fait rebondir un ballon, rebond, rebondir
â›¹ğŸ»â€â™€	ballon, femme, femme qui fait rebondir un ballon, femme qui fait rebondir un ballonÂ : peau claire, peau claire, rebond, rebondir
â›¹ğŸ¼â€â™€	ballon, femme, femme qui fait rebondir un ballon, femme qui fait rebondir un ballonÂ : peau modÃ©rÃ©ment claire, peau modÃ©rÃ©ment claire, rebond, rebondir
â›¹ğŸ½â€â™€	ballon, femme, femme qui fait rebondir un ballon, femme qui fait rebondir un ballonÂ : peau lÃ©gÃ¨rement mate, peau lÃ©gÃ¨rement mate, rebond, rebondir
â›¹ğŸ¾â€â™€	ballon, femme, femme qui fait rebondir un ballon, femme qui fait rebondir un ballonÂ : peau modÃ©rÃ©ment foncÃ©e, peau modÃ©rÃ©ment foncÃ©e, rebond, rebondir
â›¹ğŸ¿â€â™€	ballon, femme, femme qui fait rebondir un ballon, femme qui fait rebondir un ballonÂ : peau foncÃ©e, peau foncÃ©e, rebond, rebondir
ğŸ‹ï¸	haltÃ¨re, haltÃ©rophilie, lever, levÃ©e, poids
ğŸ‹ğŸ»	haltÃ¨re, haltÃ©rophileÂ : peau claire, haltÃ©rophilie, lever, levÃ©e, peau claire, poids
ğŸ‹ğŸ¼	haltÃ¨re, haltÃ©rophileÂ : peau modÃ©rÃ©ment claire, haltÃ©rophilie, lever, levÃ©e, peau modÃ©rÃ©ment claire, poids
ğŸ‹ğŸ½	haltÃ¨re, haltÃ©rophileÂ : peau lÃ©gÃ¨rement mate, haltÃ©rophilie, lever, levÃ©e, peau lÃ©gÃ¨rement mate, poids
ğŸ‹ğŸ¾	haltÃ¨re, haltÃ©rophileÂ : peau modÃ©rÃ©ment foncÃ©e, haltÃ©rophilie, lever, levÃ©e, peau modÃ©rÃ©ment foncÃ©e, poids
ğŸ‹ğŸ¿	haltÃ¨re, haltÃ©rophileÂ : peau foncÃ©e, haltÃ©rophilie, lever, levÃ©e, peau foncÃ©e, poids
ğŸ‹â€â™‚	haltÃ¨re, haltÃ©rophile, homme, lever, levÃ©e, poids
ğŸ‹ğŸ»â€â™‚	haltÃ¨re, haltÃ©rophile, homme, homme haltÃ©rophileÂ : peau claire, lever, levÃ©e, peau claire, poids
ğŸ‹ğŸ¼â€â™‚	haltÃ¨re, haltÃ©rophile, homme, homme haltÃ©rophileÂ : peau modÃ©rÃ©ment claire, lever, levÃ©e, peau modÃ©rÃ©ment claire, poids
ğŸ‹ğŸ½â€â™‚	haltÃ¨re, haltÃ©rophile, homme, homme haltÃ©rophileÂ : peau lÃ©gÃ¨rement mate, lever, levÃ©e, peau lÃ©gÃ¨rement mate, poids
ğŸ‹ğŸ¾â€â™‚	haltÃ¨re, haltÃ©rophile, homme, homme haltÃ©rophileÂ : peau modÃ©rÃ©ment foncÃ©e, lever, levÃ©e, peau modÃ©rÃ©ment foncÃ©e, poids
ğŸ‹ğŸ¿â€â™‚	haltÃ¨re, haltÃ©rophile, homme, homme haltÃ©rophileÂ : peau foncÃ©e, lever, levÃ©e, peau foncÃ©e, poids
ğŸ‹â€â™€	femme, haltÃ¨re, haltÃ©rophile, lever, levÃ©e, poids
ğŸ‹ğŸ»â€â™€	femme, femme haltÃ©rophileÂ : peau claire, haltÃ¨re, haltÃ©rophile, lever, levÃ©e, peau claire, poids
ğŸ‹ğŸ¼â€â™€	femme, femme haltÃ©rophileÂ : peau modÃ©rÃ©ment claire, haltÃ¨re, haltÃ©rophile, lever, levÃ©e, peau modÃ©rÃ©ment claire, poids
ğŸ‹ğŸ½â€â™€	femme, femme haltÃ©rophileÂ : peau lÃ©gÃ¨rement mate, haltÃ¨re, haltÃ©rophile, lever, levÃ©e, peau lÃ©gÃ¨rement mate, poids
ğŸ‹ğŸ¾â€â™€	femme, femme haltÃ©rophileÂ : peau modÃ©rÃ©ment foncÃ©e, haltÃ¨re, haltÃ©rophile, lever, levÃ©e, peau modÃ©rÃ©ment foncÃ©e, poids
ğŸ‹ğŸ¿â€â™€	femme, femme haltÃ©rophileÂ : peau foncÃ©e, haltÃ¨re, haltÃ©rophile, lever, levÃ©e, peau foncÃ©e, poids
ğŸš´	bicyclette, cyclisme, faire du vÃ©lo, personne, vÃ©lo
ğŸš´ğŸ»	bicyclette, cyclisme, cyclisteÂ : peau claire, faire du vÃ©lo, peau claire, personne, vÃ©lo
ğŸš´ğŸ¼	bicyclette, cyclisme, cyclisteÂ : peau modÃ©rÃ©ment claire, faire du vÃ©lo, peau modÃ©rÃ©ment claire, personne, vÃ©lo
ğŸš´ğŸ½	bicyclette, cyclisme, cyclisteÂ : peau lÃ©gÃ¨rement mate, faire du vÃ©lo, peau lÃ©gÃ¨rement mate, personne, vÃ©lo
ğŸš´ğŸ¾	bicyclette, cyclisme, cyclisteÂ : peau modÃ©rÃ©ment foncÃ©e, faire du vÃ©lo, peau modÃ©rÃ©ment foncÃ©e, personne, vÃ©lo
ğŸš´ğŸ¿	bicyclette, cyclisme, cyclisteÂ : peau foncÃ©e, faire du vÃ©lo, peau foncÃ©e, personne, vÃ©lo
ğŸš´â€â™‚	bicyclette, cycliste, faire du vÃ©lo, homme, vÃ©lo
ğŸš´ğŸ»â€â™‚	bicyclette, cycliste, cycliste hommeÂ : peau claire, faire du vÃ©lo, homme, peau claire, vÃ©lo
ğŸš´ğŸ¼â€â™‚	bicyclette, cycliste, cycliste hommeÂ : peau modÃ©rÃ©ment claire, faire du vÃ©lo, homme, peau modÃ©rÃ©ment claire, vÃ©lo
ğŸš´ğŸ½â€â™‚	bicyclette, cycliste, cycliste hommeÂ : peau lÃ©gÃ¨rement mate, faire du vÃ©lo, homme, peau lÃ©gÃ¨rement mate, vÃ©lo
ğŸš´ğŸ¾â€â™‚	bicyclette, cycliste, cycliste hommeÂ : peau modÃ©rÃ©ment foncÃ©e, faire du vÃ©lo, homme, peau modÃ©rÃ©ment foncÃ©e, vÃ©lo
ğŸš´ğŸ¿â€â™‚	bicyclette, cycliste, cycliste hommeÂ : peau foncÃ©e, faire du vÃ©lo, homme, peau foncÃ©e, vÃ©lo
ğŸš´â€â™€	bicyclette, cycliste, faire du vÃ©lo, femme, vÃ©lo
ğŸš´ğŸ»â€â™€	bicyclette, cycliste, cycliste femmeÂ : peau claire, faire du vÃ©lo, femme, peau claire, vÃ©lo
ğŸš´ğŸ¼â€â™€	bicyclette, cycliste, cycliste femmeÂ : peau modÃ©rÃ©ment claire, faire du vÃ©lo, femme, peau modÃ©rÃ©ment claire, vÃ©lo
ğŸš´ğŸ½â€â™€	bicyclette, cycliste, cycliste femmeÂ : peau lÃ©gÃ¨rement mate, faire du vÃ©lo, femme, peau lÃ©gÃ¨rement mate, vÃ©lo
ğŸš´ğŸ¾â€â™€	bicyclette, cycliste, cycliste femmeÂ : peau modÃ©rÃ©ment foncÃ©e, faire du vÃ©lo, femme, peau modÃ©rÃ©ment foncÃ©e, vÃ©lo
ğŸš´ğŸ¿â€â™€	bicyclette, cycliste, cycliste femmeÂ : peau foncÃ©e, faire du vÃ©lo, femme, peau foncÃ©e, vÃ©lo
ğŸšµ	cyclisme, montagne, personne en vÃ©lo de montagne, vÃ©lo
ğŸšµğŸ»	cyclisme, montagne, peau claire, personne en vÃ©lo de montagne, personne en vÃ©lo de montagneÂ : peau claire, vÃ©lo
ğŸšµğŸ¼	cyclisme, montagne, peau modÃ©rÃ©ment claire, personne en vÃ©lo de montagne, personne en vÃ©lo de montagneÂ : peau modÃ©rÃ©ment claire, vÃ©lo
ğŸšµğŸ½	cyclisme, montagne, peau lÃ©gÃ¨rement mate, personne en vÃ©lo de montagne, personne en vÃ©lo de montagneÂ : peau lÃ©gÃ¨rement mate, vÃ©lo
ğŸšµğŸ¾	cyclisme, montagne, peau modÃ©rÃ©ment foncÃ©e, personne en vÃ©lo de montagne, personne en vÃ©lo de montagneÂ : peau modÃ©rÃ©ment foncÃ©e, vÃ©lo
ğŸšµğŸ¿	cyclisme, montagne, peau foncÃ©e, personne en vÃ©lo de montagne, personne en vÃ©lo de montagneÂ : peau foncÃ©e, vÃ©lo
ğŸšµâ€â™‚	cycliste, homme, homme en vÃ©lo de montagne, montagne, vÃ©lo, vÃ©tÃ©tiste
ğŸšµğŸ»â€â™‚	cycliste, homme, homme en vÃ©lo de montagne, homme en vÃ©lo de montagneÂ : peau claire, montagne, peau claire, vÃ©lo, vÃ©tÃ©tiste
ğŸšµğŸ¼â€â™‚	cycliste, homme, homme en vÃ©lo de montagne, homme en vÃ©lo de montagneÂ : peau modÃ©rÃ©ment claire, montagne, peau modÃ©rÃ©ment claire, vÃ©lo, vÃ©tÃ©tiste
ğŸšµğŸ½â€â™‚	cycliste, homme, homme en vÃ©lo de montagne, homme en vÃ©lo de montagneÂ : peau lÃ©gÃ¨rement mate, montagne, peau lÃ©gÃ¨rement mate, vÃ©lo, vÃ©tÃ©tiste
ğŸšµğŸ¾â€â™‚	cycliste, homme, homme en vÃ©lo de montagne, homme en vÃ©lo de montagneÂ : peau modÃ©rÃ©ment foncÃ©e, montagne, peau modÃ©rÃ©ment foncÃ©e, vÃ©lo, vÃ©tÃ©tiste
ğŸšµğŸ¿â€â™‚	cycliste, homme, homme en vÃ©lo de montagne, homme en vÃ©lo de montagneÂ : peau foncÃ©e, montagne, peau foncÃ©e, vÃ©lo, vÃ©tÃ©tiste
ğŸšµâ€â™€	cycliste, femme, femme en vÃ©lo de montagne, montagne, vÃ©lo, vÃ©tÃ©tiste
ğŸšµğŸ»â€â™€	cycliste, femme, femme en vÃ©lo de montagne, femme en vÃ©lo de montagneÂ : peau claire, montagne, peau claire, vÃ©lo, vÃ©tÃ©tiste
ğŸšµğŸ¼â€â™€	cycliste, femme, femme en vÃ©lo de montagne, femme en vÃ©lo de montagneÂ : peau modÃ©rÃ©ment claire, montagne, peau modÃ©rÃ©ment claire, vÃ©lo, vÃ©tÃ©tiste
ğŸšµğŸ½â€â™€	cycliste, femme, femme en vÃ©lo de montagne, femme en vÃ©lo de montagneÂ : peau lÃ©gÃ¨rement mate, montagne, peau lÃ©gÃ¨rement mate, vÃ©lo, vÃ©tÃ©tiste
ğŸšµğŸ¾â€â™€	cycliste, femme, femme en vÃ©lo de montagne, femme en vÃ©lo de montagneÂ : peau modÃ©rÃ©ment foncÃ©e, montagne, peau modÃ©rÃ©ment foncÃ©e, vÃ©lo, vÃ©tÃ©tiste
ğŸšµğŸ¿â€â™€	cycliste, femme, femme en vÃ©lo de montagne, femme en vÃ©lo de montagneÂ : peau foncÃ©e, montagne, peau foncÃ©e, vÃ©lo, vÃ©tÃ©tiste
ğŸ¤¸	gymnastique, personne, personne faisant la roue, roue
ğŸ¤¸ğŸ»	gymnastique, peau claire, personne, personne faisant la roue, personne faisant la roueÂ : peau claire, roue
ğŸ¤¸ğŸ¼	gymnastique, peau modÃ©rÃ©ment claire, personne, personne faisant la roue, personne faisant la roueÂ : peau modÃ©rÃ©ment claire, roue
ğŸ¤¸ğŸ½	gymnastique, peau lÃ©gÃ¨rement mate, personne, personne faisant la roue, personne faisant la roueÂ : peau lÃ©gÃ¨rement mate, roue
ğŸ¤¸ğŸ¾	gymnastique, peau modÃ©rÃ©ment foncÃ©e, personne, personne faisant la roue, personne faisant la roueÂ : peau modÃ©rÃ©ment foncÃ©e, roue
ğŸ¤¸ğŸ¿	gymnastique, peau foncÃ©e, personne, personne faisant la roue, personne faisant la roueÂ : peau foncÃ©e, roue
ğŸ¤¸â€â™‚	gymnaste, homme, roue
ğŸ¤¸ğŸ»â€â™‚	gymnaste, homme, homme faisant la roueÂ : peau claire, peau claire, roue
ğŸ¤¸ğŸ¼â€â™‚	gymnaste, homme, homme faisant la roueÂ : peau modÃ©rÃ©ment claire, peau modÃ©rÃ©ment claire, roue
ğŸ¤¸ğŸ½â€â™‚	gymnaste, homme, homme faisant la roueÂ : peau lÃ©gÃ¨rement mate, peau lÃ©gÃ¨rement mate, roue
ğŸ¤¸ğŸ¾â€â™‚	gymnaste, homme, homme faisant la roueÂ : peau modÃ©rÃ©ment foncÃ©e, peau modÃ©rÃ©ment foncÃ©e, roue
ğŸ¤¸ğŸ¿â€â™‚	gymnaste, homme, homme faisant la roueÂ : peau foncÃ©e, peau foncÃ©e, roue
ğŸ¤¸â€â™€	femme, gymnaste, roue
ğŸ¤¸ğŸ»â€â™€	femme, femme faisant la roueÂ : peau claire, gymnaste, peau claire, roue
ğŸ¤¸ğŸ¼â€â™€	femme, femme faisant la roueÂ : peau modÃ©rÃ©ment claire, gymnaste, peau modÃ©rÃ©ment claire, roue
ğŸ¤¸ğŸ½â€â™€	femme, femme faisant la roueÂ : peau lÃ©gÃ¨rement mate, gymnaste, peau lÃ©gÃ¨rement mate, roue
ğŸ¤¸ğŸ¾â€â™€	femme, femme faisant la roueÂ : peau modÃ©rÃ©ment foncÃ©e, gymnaste, peau modÃ©rÃ©ment foncÃ©e, roue
ğŸ¤¸ğŸ¿â€â™€	femme, femme faisant la roueÂ : peau foncÃ©e, gymnaste, peau foncÃ©e, roue
ğŸ¤¼	lutte, lutteur, personnes
ğŸ¤¼â€â™‚	hommes, lutte, lutteurs
ğŸ¤¼â€â™€	femmes, lutte, lutteuses
ğŸ¤½	personne, personne qui joue au water-polo, water-polo
ğŸ¤½ğŸ»	peau claire, personne, personne qui joue au water-polo, personne qui joue au water-poloÂ : peau claire, water-polo
ğŸ¤½ğŸ¼	peau modÃ©rÃ©ment claire, personne, personne qui joue au water-polo, personne qui joue au water-poloÂ : peau modÃ©rÃ©ment claire, water-polo
ğŸ¤½ğŸ½	peau lÃ©gÃ¨rement mate, personne, personne qui joue au water-polo, personne qui joue au water-poloÂ : peau lÃ©gÃ¨rement mate, water-polo
ğŸ¤½ğŸ¾	peau modÃ©rÃ©ment foncÃ©e, personne, personne qui joue au water-polo, personne qui joue au water-poloÂ : peau modÃ©rÃ©ment foncÃ©e, water-polo
ğŸ¤½ğŸ¿	peau foncÃ©e, personne, personne qui joue au water-polo, personne qui joue au water-poloÂ : peau foncÃ©e, water-polo
ğŸ¤½â€â™‚	homme, joueur de water-polo, water-polo
ğŸ¤½ğŸ»â€â™‚	homme, joueur de water-polo, joueur de water-poloÂ : peau claire, peau claire, water-polo
ğŸ¤½ğŸ¼â€â™‚	homme, joueur de water-polo, joueur de water-poloÂ : peau modÃ©rÃ©ment claire, peau modÃ©rÃ©ment claire, water-polo
ğŸ¤½ğŸ½â€â™‚	homme, joueur de water-polo, joueur de water-poloÂ : peau lÃ©gÃ¨rement mate, peau lÃ©gÃ¨rement mate, water-polo
ğŸ¤½ğŸ¾â€â™‚	homme, joueur de water-polo, joueur de water-poloÂ : peau modÃ©rÃ©ment foncÃ©e, peau modÃ©rÃ©ment foncÃ©e, water-polo
ğŸ¤½ğŸ¿â€â™‚	homme, joueur de water-polo, joueur de water-poloÂ : peau foncÃ©e, peau foncÃ©e, water-polo
ğŸ¤½â€â™€	femme, joueuse de water-polo, water-polo
ğŸ¤½ğŸ»â€â™€	femme, joueuse de water-polo, joueuse de water-poloÂ : peau claire, peau claire, water-polo
ğŸ¤½ğŸ¼â€â™€	femme, joueuse de water-polo, joueuse de water-poloÂ : peau modÃ©rÃ©ment claire, peau modÃ©rÃ©ment claire, water-polo
ğŸ¤½ğŸ½â€â™€	femme, joueuse de water-polo, joueuse de water-poloÂ : peau lÃ©gÃ¨rement mate, peau lÃ©gÃ¨rement mate, water-polo
ğŸ¤½ğŸ¾â€â™€	femme, joueuse de water-polo, joueuse de water-poloÂ : peau modÃ©rÃ©ment foncÃ©e, peau modÃ©rÃ©ment foncÃ©e, water-polo
ğŸ¤½ğŸ¿â€â™€	femme, joueuse de water-polo, joueuse de water-poloÂ : peau foncÃ©e, peau foncÃ©e, water-polo
ğŸ¤¾	ballon, handball, personne, personne qui joue au handball
ğŸ¤¾ğŸ»	ballon, handball, peau claire, personne, personne qui joue au handball, personne qui joue au handballÂ : peau claire
ğŸ¤¾ğŸ¼	ballon, handball, peau modÃ©rÃ©ment claire, personne, personne qui joue au handball, personne qui joue au handballÂ : peau modÃ©rÃ©ment claire
ğŸ¤¾ğŸ½	ballon, handball, peau lÃ©gÃ¨rement mate, personne, personne qui joue au handball, personne qui joue au handballÂ : peau lÃ©gÃ¨rement mate
ğŸ¤¾ğŸ¾	ballon, handball, peau modÃ©rÃ©ment foncÃ©e, personne, personne qui joue au handball, personne qui joue au handballÂ : peau modÃ©rÃ©ment foncÃ©e
ğŸ¤¾ğŸ¿	ballon, handball, peau foncÃ©e, personne, personne qui joue au handball, personne qui joue au handballÂ : peau foncÃ©e
ğŸ¤¾â€â™‚	handball, handballeur, homme
ğŸ¤¾ğŸ»â€â™‚	handball, handballeur, handballeurÂ : peau claire, homme, peau claire
ğŸ¤¾ğŸ¼â€â™‚	handball, handballeur, handballeurÂ : peau modÃ©rÃ©ment claire, homme, peau modÃ©rÃ©ment claire
ğŸ¤¾ğŸ½â€â™‚	handball, handballeur, handballeurÂ : peau lÃ©gÃ¨rement mate, homme, peau lÃ©gÃ¨rement mate
ğŸ¤¾ğŸ¾â€â™‚	handball, handballeur, handballeurÂ : peau modÃ©rÃ©ment foncÃ©e, homme, peau modÃ©rÃ©ment foncÃ©e
ğŸ¤¾ğŸ¿â€â™‚	handball, handballeur, handballeurÂ : peau foncÃ©e, homme, peau foncÃ©e
ğŸ¤¾â€â™€	femme, handball, handballeuse
ğŸ¤¾ğŸ»â€â™€	femme, handball, handballeuse, handballeuseÂ : peau claire, peau claire
ğŸ¤¾ğŸ¼â€â™€	femme, handball, handballeuse, handballeuseÂ : peau modÃ©rÃ©ment claire, peau modÃ©rÃ©ment claire
ğŸ¤¾ğŸ½â€â™€	femme, handball, handballeuse, handballeuseÂ : peau lÃ©gÃ¨rement mate, peau lÃ©gÃ¨rement mate
ğŸ¤¾ğŸ¾â€â™€	femme, handball, handballeuse, handballeuseÂ : peau modÃ©rÃ©ment foncÃ©e, peau modÃ©rÃ©ment foncÃ©e
ğŸ¤¾ğŸ¿â€â™€	femme, handball, handballeuse, handballeuseÂ : peau foncÃ©e, peau foncÃ©e
ğŸ¤¹ğŸ»	personne qui jongleÂ : peau claire
ğŸ¤¹ğŸ¼	jongler, jongleur, multitÃ¢che, peau modÃ©rÃ©ment claire, personne qui jongle, personne qui jongleÂ : peau modÃ©rÃ©ment claire
ğŸ¤¹ğŸ½	personne qui jongleÂ : peau lÃ©gÃ¨rement mate
ğŸ¤¹ğŸ¾	jongler, jongleur, multitÃ¢che, peau modÃ©rÃ©ment foncÃ©e, personne qui jongle, personne qui jongleÂ : peau modÃ©rÃ©ment foncÃ©e
ğŸ¤¹ğŸ¿	personne qui jongleÂ : peau foncÃ©e
ğŸ¤¹ğŸ»â€â™‚	jongleurÂ : peau claire
ğŸ¤¹ğŸ¼â€â™‚	homme, jonglage, jongleur, jongleurÂ : peau modÃ©rÃ©ment claire, multitÃ¢che, peau modÃ©rÃ©ment claire
ğŸ¤¹ğŸ½â€â™‚	jongleurÂ : peau lÃ©gÃ¨rement mate
ğŸ¤¹ğŸ¾â€â™‚	homme, jonglage, jongleur, jongleurÂ : peau modÃ©rÃ©ment foncÃ©e, multitÃ¢che, peau modÃ©rÃ©ment foncÃ©e
ğŸ¤¹ğŸ¿â€â™‚	jongleurÂ : peau foncÃ©e
ğŸ¤¹ğŸ»â€â™€	jongleuseÂ : peau claire
ğŸ¤¹ğŸ¼â€â™€	femme, jonglage, jongleuse, jongleuseÂ : peau modÃ©rÃ©ment claire, multitÃ¢che, peau modÃ©rÃ©ment claire
ğŸ¤¹ğŸ½â€â™€	jongleuseÂ : peau lÃ©gÃ¨rement mate
ğŸ¤¹ğŸ¾â€â™€	femme, jonglage, jongleuse, jongleuseÂ : peau modÃ©rÃ©ment foncÃ©e, multitÃ¢che, peau modÃ©rÃ©ment foncÃ©e
ğŸ¤¹ğŸ¿â€â™€	jongleuseÂ : peau foncÃ©e
ğŸ§˜ğŸ»	personne dans la posture du lotusÂ : peau claire
ğŸ§˜ğŸ¼	mÃ©ditation, peau modÃ©rÃ©ment claire, personne dans la posture du lotus, personne dans la posture du lotusÂ : peau modÃ©rÃ©ment claire, position du lotus, yoga
ğŸ§˜ğŸ½	personne dans la posture du lotusÂ : peau lÃ©gÃ¨rement mate
ğŸ§˜ğŸ¾	mÃ©ditation, peau modÃ©rÃ©ment foncÃ©e, personne dans la posture du lotus, personne dans la posture du lotusÂ : peau modÃ©rÃ©ment foncÃ©e, position du lotus, yoga
ğŸ§˜ğŸ¿	personne dans la posture du lotusÂ : peau foncÃ©e
ğŸ§˜ğŸ»â€â™‚	homme dans la posture du lotusÂ : peau claire
ğŸ§˜ğŸ¼â€â™‚	homme dans la posture du lotus, homme dans la posture du lotusÂ : peau modÃ©rÃ©ment claire, mÃ©ditation, peau modÃ©rÃ©ment claire, position du lotus, yoga
ğŸ§˜ğŸ½â€â™‚	homme dans la posture du lotusÂ : peau lÃ©gÃ¨rement mate
ğŸ§˜ğŸ¾â€â™‚	homme dans la posture du lotus, homme dans la posture du lotusÂ : peau modÃ©rÃ©ment foncÃ©e, mÃ©ditation, peau modÃ©rÃ©ment foncÃ©e, position du lotus, yoga
ğŸ§˜ğŸ¿â€â™‚	homme dans la posture du lotusÂ : peau foncÃ©e
ğŸ§˜ğŸ»â€â™€	femme dans la posture du lotusÂ : peau claire
ğŸ§˜ğŸ¼â€â™€	femme dans la posture du lotus, femme dans la posture du lotusÂ : peau modÃ©rÃ©ment claire, mÃ©ditation, peau modÃ©rÃ©ment claire, position du lotus, yoga
ğŸ§˜ğŸ½â€â™€	femme dans la posture du lotusÂ : peau lÃ©gÃ¨rement mate
ğŸ§˜ğŸ¾â€â™€	femme dans la posture du lotus, femme dans la posture du lotusÂ : peau modÃ©rÃ©ment foncÃ©e, mÃ©ditation, peau modÃ©rÃ©ment foncÃ©e, position du lotus, yoga
ğŸ§˜ğŸ¿â€â™€	femme dans la posture du lotusÂ : peau foncÃ©e
ğŸ›€ğŸ»	personne prenant un bainÂ : peau claire
ğŸ›€ğŸ¼	baignoire, bain, peau modÃ©rÃ©ment claire, personne prenant un bain, personne prenant un bainÂ : peau modÃ©rÃ©ment claire
ğŸ›€ğŸ½	personne prenant un bainÂ : peau lÃ©gÃ¨rement mate
ğŸ›€ğŸ¾	baignoire, bain, peau modÃ©rÃ©ment foncÃ©e, personne prenant un bain, personne prenant un bainÂ : peau modÃ©rÃ©ment foncÃ©e
ğŸ›€ğŸ¿	personne prenant un bainÂ : peau foncÃ©e
ğŸ›ŒğŸ»	personne au litÂ : peau claire
ğŸ›ŒğŸ¼	lit, peau modÃ©rÃ©ment claire, personne au lit, personne au litÂ : peau modÃ©rÃ©ment claire
ğŸ›ŒğŸ½	personne au litÂ : peau lÃ©gÃ¨rement mate
ğŸ›ŒğŸ¾	lit, peau modÃ©rÃ©ment foncÃ©e, personne au lit, personne au litÂ : peau modÃ©rÃ©ment foncÃ©e
ğŸ›ŒğŸ¿	personne au litÂ : peau foncÃ©e
ğŸ§‘â€ğŸ¤â€ğŸ§‘	personnes se tenant par la main
ğŸ§‘ğŸ»â€ğŸ¤â€ğŸ§‘ğŸ»	peau claire, personnes se tenant par la main, personnes se tenant par la mainÂ : peau claire
ğŸ§‘ğŸ¼â€ğŸ¤â€ğŸ§‘ğŸ»	peau claire, peau modÃ©rÃ©ment claire, personnes se tenant par la main, personnes se tenant par la mainÂ : peau modÃ©rÃ©ment claire et peau claire
ğŸ§‘ğŸ¼â€ğŸ¤â€ğŸ§‘ğŸ¼	peau modÃ©rÃ©ment claire, personnes se tenant par la main, personnes se tenant par la mainÂ : peau modÃ©rÃ©ment claire
ğŸ§‘ğŸ½â€ğŸ¤â€ğŸ§‘ğŸ»	peau claire, peau lÃ©gÃ¨rement mate, personnes se tenant par la main, personnes se tenant par la mainÂ : peau lÃ©gÃ¨rement mate et peau claire
ğŸ§‘ğŸ½â€ğŸ¤â€ğŸ§‘ğŸ¼	peau lÃ©gÃ¨rement mate, peau modÃ©rÃ©ment claire, personnes se tenant par la main, personnes se tenant par la mainÂ : peau lÃ©gÃ¨rement mate et peau modÃ©rÃ©ment claire
ğŸ§‘ğŸ½â€ğŸ¤â€ğŸ§‘ğŸ½	peau lÃ©gÃ¨rement mate, personnes se tenant par la main, personnes se tenant par la mainÂ : peau lÃ©gÃ¨rement mate
ğŸ§‘ğŸ¾â€ğŸ¤â€ğŸ§‘ğŸ»	peau claire, peau modÃ©rÃ©ment foncÃ©e, personnes se tenant par la main, personnes se tenant par la mainÂ : peau modÃ©rÃ©ment foncÃ©e et peau claire
ğŸ§‘ğŸ¾â€ğŸ¤â€ğŸ§‘ğŸ¼	peau modÃ©rÃ©ment claire, peau modÃ©rÃ©ment foncÃ©e, personnes se tenant par la main, personnes se tenant par la mainÂ : peau modÃ©rÃ©ment foncÃ©e et peau modÃ©rÃ©ment claire
ğŸ§‘ğŸ¾â€ğŸ¤â€ğŸ§‘ğŸ½	peau lÃ©gÃ¨rement mate, peau modÃ©rÃ©ment foncÃ©e, personnes se tenant par la main, personnes se tenant par la mainÂ : peau modÃ©rÃ©ment foncÃ©e et peau lÃ©gÃ¨rement mate
ğŸ§‘ğŸ¾â€ğŸ¤â€ğŸ§‘ğŸ¾	peau modÃ©rÃ©ment foncÃ©e, personnes se tenant par la main, personnes se tenant par la mainÂ : peau modÃ©rÃ©ment foncÃ©e
ğŸ§‘ğŸ¿â€ğŸ¤â€ğŸ§‘ğŸ»	peau claire, peau foncÃ©e, personnes se tenant par la main, personnes se tenant par la mainÂ : peau foncÃ©e et peau claire
ğŸ§‘ğŸ¿â€ğŸ¤â€ğŸ§‘ğŸ¼	peau foncÃ©e, peau modÃ©rÃ©ment claire, personnes se tenant par la main, personnes se tenant par la mainÂ : peau foncÃ©e et peau modÃ©rÃ©ment claire
ğŸ§‘ğŸ¿â€ğŸ¤â€ğŸ§‘ğŸ½	peau foncÃ©e, peau lÃ©gÃ¨rement mate, personnes se tenant par la main, personnes se tenant par la mainÂ : peau foncÃ©e et peau lÃ©gÃ¨rement mate
ğŸ§‘ğŸ¿â€ğŸ¤â€ğŸ§‘ğŸ¾	peau foncÃ©e, peau modÃ©rÃ©ment foncÃ©e, personnes se tenant par la main, personnes se tenant par la mainÂ : peau foncÃ©e et peau modÃ©rÃ©ment foncÃ©e
ğŸ§‘ğŸ¿â€ğŸ¤â€ğŸ§‘ğŸ¿	peau foncÃ©e, personnes se tenant par la main, personnes se tenant par la mainÂ : peau foncÃ©e
ğŸ‘­	couple, deux femmes se tenant par la main, ensemble, femmes, jumelles, main, main dans la main, se tenant par la main, union
ğŸ‘­ğŸ»	couple, deux femmes se tenant par la main, deux femmes se tenant par la mainÂ : peau claire, ensemble, femmes, jumelles, main, main dans la main, peau claire, se tenant par la main, union
ğŸ‘©ğŸ¼â€ğŸ¤â€ğŸ‘©ğŸ»	couple, deux femmes se tenant par la main, deux femmes se tenant par la mainÂ : peau modÃ©rÃ©ment claire et peau claire, ensemble, femmes, jumelles, main, main dans la main, peau claire, peau modÃ©rÃ©ment claire, se tenant par la main, union
ğŸ‘­ğŸ¼	couple, deux femmes se tenant par la main, deux femmes se tenant par la mainÂ : peau modÃ©rÃ©ment claire, ensemble, femmes, jumelles, main, main dans la main, peau modÃ©rÃ©ment claire, se tenant par la main, union
ğŸ‘©ğŸ½â€ğŸ¤â€ğŸ‘©ğŸ»	couple, deux femmes se tenant par la main, deux femmes se tenant par la mainÂ : peau lÃ©gÃ¨rement mate et peau claire, ensemble, femmes, jumelles, main, main dans la main, peau claire, peau lÃ©gÃ¨rement mate, se tenant par la main, union
ğŸ‘©ğŸ½â€ğŸ¤â€ğŸ‘©ğŸ¼	couple, deux femmes se tenant par la main, deux femmes se tenant par la mainÂ : peau lÃ©gÃ¨rement mate et peau modÃ©rÃ©ment claire, ensemble, femmes, jumelles, main, main dans la main, peau lÃ©gÃ¨rement mate, peau modÃ©rÃ©ment claire, se tenant par la main, union
ğŸ‘­ğŸ½	couple, deux femmes se tenant par la main, deux femmes se tenant par la mainÂ : peau lÃ©gÃ¨rement mate, ensemble, femmes, jumelles, main, main dans la main, peau lÃ©gÃ¨rement mate, se tenant par la main, union
ğŸ‘©ğŸ¾â€ğŸ¤â€ğŸ‘©ğŸ»	couple, deux femmes se tenant par la main, deux femmes se tenant par la mainÂ : peau modÃ©rÃ©ment foncÃ©e et peau claire, ensemble, femmes, jumelles, main, main dans la main, peau claire, peau modÃ©rÃ©ment foncÃ©e, se tenant par la main, union
ğŸ‘©ğŸ¾â€ğŸ¤â€ğŸ‘©ğŸ¼	couple, deux femmes se tenant par la main, deux femmes se tenant par la mainÂ : peau modÃ©rÃ©ment foncÃ©e et peau modÃ©rÃ©ment claire, ensemble, femmes, jumelles, main, main dans la main, peau modÃ©rÃ©ment claire, peau modÃ©rÃ©ment foncÃ©e, se tenant par la main, union
ğŸ‘©ğŸ¾â€ğŸ¤â€ğŸ‘©ğŸ½	couple, deux femmes se tenant par la main, deux femmes se tenant par la mainÂ : peau modÃ©rÃ©ment foncÃ©e et peau lÃ©gÃ¨rement mate, ensemble, femmes, jumelles, main, main dans la main, peau lÃ©gÃ¨rement mate, peau modÃ©rÃ©ment foncÃ©e, se tenant par la main, union
ğŸ‘­ğŸ¾	couple, deux femmes se tenant par la main, deux femmes se tenant par la mainÂ : peau modÃ©rÃ©ment foncÃ©e, ensemble, femmes, jumelles, main, main dans la main, peau modÃ©rÃ©ment foncÃ©e, se tenant par la main, union
ğŸ‘©ğŸ¿â€ğŸ¤â€ğŸ‘©ğŸ»	couple, deux femmes se tenant par la main, deux femmes se tenant par la mainÂ : peau foncÃ©e et peau claire, ensemble, femmes, jumelles, main, main dans la main, peau claire, peau foncÃ©e, se tenant par la main, union
ğŸ‘©ğŸ¿â€ğŸ¤â€ğŸ‘©ğŸ¼	couple, deux femmes se tenant par la main, deux femmes se tenant par la mainÂ : peau foncÃ©e et peau modÃ©rÃ©ment claire, ensemble, femmes, jumelles, main, main dans la main, peau foncÃ©e, peau modÃ©rÃ©ment claire, se tenant par la main, union
ğŸ‘©ğŸ¿â€ğŸ¤â€ğŸ‘©ğŸ½	couple, deux femmes se tenant par la main, deux femmes se tenant par la mainÂ : peau foncÃ©e et peau lÃ©gÃ¨rement mate, ensemble, femmes, jumelles, main, main dans la main, peau foncÃ©e, peau lÃ©gÃ¨rement mate, se tenant par la main, union
ğŸ‘©ğŸ¿â€ğŸ¤â€ğŸ‘©ğŸ¾	couple, deux femmes se tenant par la main, deux femmes se tenant par la mainÂ : peau foncÃ©e et peau modÃ©rÃ©ment foncÃ©e, ensemble, femmes, jumelles, main, main dans la main, peau foncÃ©e, peau modÃ©rÃ©ment foncÃ©e, se tenant par la main, union
ğŸ‘­ğŸ¿	couple, deux femmes se tenant par la main, deux femmes se tenant par la mainÂ : peau foncÃ©e, ensemble, femmes, jumelles, main, main dans la main, peau foncÃ©e, se tenant par la main, union
ğŸ‘«	couple, ensemble, femme, homme, homme et femme se tenant par la main, main, main dans la main, se tenant par la main, union
ğŸ‘«ğŸ»	couple, ensemble, femme, homme, homme et femme se tenant par la main, homme et femme se tenant par la mainÂ : peau claire, main, main dans la main, peau claire, se tenant par la main, union
ğŸ‘©ğŸ»â€ğŸ¤â€ğŸ‘¨ğŸ¼	couple, ensemble, femme, homme, homme et femme se tenant par la main, homme et femme se tenant par la mainÂ : peau claire et peau modÃ©rÃ©ment claire, main, main dans la main, peau claire, peau modÃ©rÃ©ment claire, se tenant par la main, union
ğŸ‘©ğŸ»â€ğŸ¤â€ğŸ‘¨ğŸ½	couple, ensemble, femme, homme, homme et femme se tenant par la main, homme et femme se tenant par la mainÂ : peau claire et peau lÃ©gÃ¨rement mate, main, main dans la main, peau claire, peau lÃ©gÃ¨rement mate, se tenant par la main, union
ğŸ‘©ğŸ»â€ğŸ¤â€ğŸ‘¨ğŸ¾	couple, ensemble, femme, homme, homme et femme se tenant par la main, homme et femme se tenant par la mainÂ : peau claire et peau modÃ©rÃ©ment foncÃ©e, main, main dans la main, peau claire, peau modÃ©rÃ©ment foncÃ©e, se tenant par la main, union
ğŸ‘©ğŸ»â€ğŸ¤â€ğŸ‘¨ğŸ¿	couple, ensemble, femme, homme, homme et femme se tenant par la main, homme et femme se tenant par la mainÂ : peau claire et peau foncÃ©e, main, main dans la main, peau claire, peau foncÃ©e, se tenant par la main, union
ğŸ‘©ğŸ¼â€ğŸ¤â€ğŸ‘¨ğŸ»	couple, ensemble, femme, homme, homme et femme se tenant par la main, homme et femme se tenant par la mainÂ : peau modÃ©rÃ©ment claire et peau claire, main, main dans la main, peau claire, peau modÃ©rÃ©ment claire, se tenant par la main, union
ğŸ‘«ğŸ¼	couple, ensemble, femme, homme, homme et femme se tenant par la main, homme et femme se tenant par la mainÂ : peau modÃ©rÃ©ment claire, main, main dans la main, peau modÃ©rÃ©ment claire, se tenant par la main, union
ğŸ‘©ğŸ¼â€ğŸ¤â€ğŸ‘¨ğŸ½	couple, ensemble, femme, homme, homme et femme se tenant par la main, homme et femme se tenant par la mainÂ : peau modÃ©rÃ©ment claire et peau lÃ©gÃ¨rement mate, main, main dans la main, peau lÃ©gÃ¨rement mate, peau modÃ©rÃ©ment claire, se tenant par la main, union
ğŸ‘©ğŸ¼â€ğŸ¤â€ğŸ‘¨ğŸ¾	couple, ensemble, femme, homme, homme et femme se tenant par la main, homme et femme se tenant par la mainÂ : peau modÃ©rÃ©ment claire et peau modÃ©rÃ©ment foncÃ©e, main, main dans la main, peau modÃ©rÃ©ment claire, peau modÃ©rÃ©ment foncÃ©e, se tenant par la main, union
ğŸ‘©ğŸ¼â€ğŸ¤â€ğŸ‘¨ğŸ¿	couple, ensemble, femme, homme, homme et femme se tenant par la main, homme et femme se tenant par la mainÂ : peau modÃ©rÃ©ment claire et peau foncÃ©e, main, main dans la main, peau foncÃ©e, peau modÃ©rÃ©ment claire, se tenant par la main, union
ğŸ‘©ğŸ½â€ğŸ¤â€ğŸ‘¨ğŸ»	couple, ensemble, femme, homme, homme et femme se tenant par la main, homme et femme se tenant par la mainÂ : peau lÃ©gÃ¨rement mate et peau claire, main, main dans la main, peau claire, peau lÃ©gÃ¨rement mate, se tenant par la main, union
ğŸ‘©ğŸ½â€ğŸ¤â€ğŸ‘¨ğŸ¼	couple, ensemble, femme, homme, homme et femme se tenant par la main, homme et femme se tenant par la mainÂ : peau lÃ©gÃ¨rement mate et peau modÃ©rÃ©ment claire, main, main dans la main, peau lÃ©gÃ¨rement mate, peau modÃ©rÃ©ment claire, se tenant par la main, union
ğŸ‘«ğŸ½	couple, ensemble, femme, homme, homme et femme se tenant par la main, homme et femme se tenant par la mainÂ : peau lÃ©gÃ¨rement mate, main, main dans la main, peau lÃ©gÃ¨rement mate, se tenant par la main, union
ğŸ‘©ğŸ½â€ğŸ¤â€ğŸ‘¨ğŸ¾	couple, ensemble, femme, homme, homme et femme se tenant par la main, homme et femme se tenant par la mainÂ : peau lÃ©gÃ¨rement mate et peau modÃ©rÃ©ment foncÃ©e, main, main dans la main, peau lÃ©gÃ¨rement mate, peau modÃ©rÃ©ment foncÃ©e, se tenant par la main, union
ğŸ‘©ğŸ½â€ğŸ¤â€ğŸ‘¨ğŸ¿	couple, ensemble, femme, homme, homme et femme se tenant par la main, homme et femme se tenant par la mainÂ : peau lÃ©gÃ¨rement mate et peau foncÃ©e, main, main dans la main, peau foncÃ©e, peau lÃ©gÃ¨rement mate, se tenant par la main, union
ğŸ‘©ğŸ¾â€ğŸ¤â€ğŸ‘¨ğŸ»	couple, ensemble, femme, homme, homme et femme se tenant par la main, homme et femme se tenant par la mainÂ : peau modÃ©rÃ©ment foncÃ©e et peau claire, main, main dans la main, peau claire, peau modÃ©rÃ©ment foncÃ©e, se tenant par la main, union
ğŸ‘©ğŸ¾â€ğŸ¤â€ğŸ‘¨ğŸ¼	couple, ensemble, femme, homme, homme et femme se tenant par la main, homme et femme se tenant par la mainÂ : peau modÃ©rÃ©ment foncÃ©e et peau modÃ©rÃ©ment claire, main, main dans la main, peau modÃ©rÃ©ment claire, peau modÃ©rÃ©ment foncÃ©e, se tenant par la main, union
ğŸ‘©ğŸ¾â€ğŸ¤â€ğŸ‘¨ğŸ½	couple, ensemble, femme, homme, homme et femme se tenant par la main, homme et femme se tenant par la mainÂ : peau modÃ©rÃ©ment foncÃ©e et peau lÃ©gÃ¨rement mate, main, main dans la main, peau lÃ©gÃ¨rement mate, peau modÃ©rÃ©ment foncÃ©e, se tenant par la main, union
ğŸ‘«ğŸ¾	couple, ensemble, femme, homme, homme et femme se tenant par la main, homme et femme se tenant par la mainÂ : peau modÃ©rÃ©ment foncÃ©e, main, main dans la main, peau modÃ©rÃ©ment foncÃ©e, se tenant par la main, union
ğŸ‘©ğŸ¾â€ğŸ¤â€ğŸ‘¨ğŸ¿	couple, ensemble, femme, homme, homme et femme se tenant par la main, homme et femme se tenant par la mainÂ : peau modÃ©rÃ©ment foncÃ©e et peau foncÃ©e, main, main dans la main, peau foncÃ©e, peau modÃ©rÃ©ment foncÃ©e, se tenant par la main, union
ğŸ‘©ğŸ¿â€ğŸ¤â€ğŸ‘¨ğŸ»	couple, ensemble, femme, homme, homme et femme se tenant par la main, homme et femme se tenant par la mainÂ : peau foncÃ©e et peau claire, main, main dans la main, peau claire, peau foncÃ©e, se tenant par la main, union
ğŸ‘©ğŸ¿â€ğŸ¤â€ğŸ‘¨ğŸ¼	couple, ensemble, femme, homme, homme et femme se tenant par la main, homme et femme se tenant par la mainÂ : peau foncÃ©e et peau modÃ©rÃ©ment claire, main, main dans la main, peau foncÃ©e, peau modÃ©rÃ©ment claire, se tenant par la main, union
ğŸ‘©ğŸ¿â€ğŸ¤â€ğŸ‘¨ğŸ½	couple, ensemble, femme, homme, homme et femme se tenant par la main, homme et femme se tenant par la mainÂ : peau foncÃ©e et peau lÃ©gÃ¨rement mate, main, main dans la main, peau foncÃ©e, peau lÃ©gÃ¨rement mate, se tenant par la main, union
ğŸ‘©ğŸ¿â€ğŸ¤â€ğŸ‘¨ğŸ¾	couple, ensemble, femme, homme, homme et femme se tenant par la main, homme et femme se tenant par la mainÂ : peau foncÃ©e et peau modÃ©rÃ©ment foncÃ©e, main, main dans la main, peau foncÃ©e, peau modÃ©rÃ©ment foncÃ©e, se tenant par la main, union
ğŸ‘«ğŸ¿	couple, ensemble, femme, homme, homme et femme se tenant par la main, homme et femme se tenant par la mainÂ : peau foncÃ©e, main, main dans la main, peau foncÃ©e, se tenant par la main, union
ğŸ‘¬	couple, deux hommes se tenant par la main, ensemble, gÃ©meaux, hommes, jumeaux, main, main dans la main, se tenant par la main, union, zodiaque
ğŸ‘¬ğŸ»	couple, deux hommes se tenant par la main, deux hommes se tenant par la mainÂ : peau claire, ensemble, gÃ©meaux, hommes, jumeaux, main, main dans la main, peau claire, se tenant par la main, union, zodiaque
ğŸ‘¨ğŸ¼â€ğŸ¤â€ğŸ‘¨ğŸ»	couple, deux hommes se tenant par la main, deux hommes se tenant par la mainÂ : peau modÃ©rÃ©ment claire et peau claire, ensemble, gÃ©meaux, hommes, jumeaux, main, main dans la main, peau claire, peau modÃ©rÃ©ment claire, se tenant par la main, union, zodiaque
ğŸ‘¬ğŸ¼	couple, deux hommes se tenant par la main, deux hommes se tenant par la mainÂ : peau modÃ©rÃ©ment claire, ensemble, gÃ©meaux, hommes, jumeaux, main, main dans la main, peau modÃ©rÃ©ment claire, se tenant par la main, union, zodiaque
ğŸ‘¨ğŸ½â€ğŸ¤â€ğŸ‘¨ğŸ»	couple, deux hommes se tenant par la main, deux hommes se tenant par la mainÂ : peau lÃ©gÃ¨rement mate et peau claire, ensemble, gÃ©meaux, hommes, jumeaux, main, main dans la main, peau claire, peau lÃ©gÃ¨rement mate, se tenant par la main, union, zodiaque
ğŸ‘¨ğŸ½â€ğŸ¤â€ğŸ‘¨ğŸ¼	couple, deux hommes se tenant par la main, deux hommes se tenant par la mainÂ : peau lÃ©gÃ¨rement mate et peau modÃ©rÃ©ment claire, ensemble, gÃ©meaux, hommes, jumeaux, main, main dans la main, peau lÃ©gÃ¨rement mate, peau modÃ©rÃ©ment claire, se tenant par la main, union, zodiaque
ğŸ‘¬ğŸ½	couple, deux hommes se tenant par la main, deux hommes se tenant par la mainÂ : peau lÃ©gÃ¨rement mate, ensemble, gÃ©meaux, hommes, jumeaux, main, main dans la main, peau lÃ©gÃ¨rement mate, se tenant par la main, union, zodiaque
ğŸ‘¨ğŸ¾â€ğŸ¤â€ğŸ‘¨ğŸ»	couple, deux hommes se tenant par la main, deux hommes se tenant par la mainÂ : peau modÃ©rÃ©ment foncÃ©e et peau claire, ensemble, gÃ©meaux, hommes, jumeaux, main, main dans la main, peau claire, peau modÃ©rÃ©ment foncÃ©e, se tenant par la main, union, zodiaque
ğŸ‘¨ğŸ¾â€ğŸ¤â€ğŸ‘¨ğŸ¼	couple, deux hommes se tenant par la main, deux hommes se tenant par la mainÂ : peau modÃ©rÃ©ment foncÃ©e et peau modÃ©rÃ©ment claire, ensemble, gÃ©meaux, hommes, jumeaux, main, main dans la main, peau modÃ©rÃ©ment claire, peau modÃ©rÃ©ment foncÃ©e, se tenant par la main, union, zodiaque
ğŸ‘¨ğŸ¾â€ğŸ¤â€ğŸ‘¨ğŸ½	couple, deux hommes se tenant par la main, deux hommes se tenant par la mainÂ : peau modÃ©rÃ©ment foncÃ©e et peau lÃ©gÃ¨rement mate, ensemble, gÃ©meaux, hommes, jumeaux, main, main dans la main, peau lÃ©gÃ¨rement mate, peau modÃ©rÃ©ment foncÃ©e, se tenant par la main, union, zodiaque
ğŸ‘¬ğŸ¾	couple, deux hommes se tenant par la main, deux hommes se tenant par la mainÂ : peau modÃ©rÃ©ment foncÃ©e, ensemble, gÃ©meaux, hommes, jumeaux, main, main dans la main, peau modÃ©rÃ©ment foncÃ©e, se tenant par la main, union, zodiaque
ğŸ‘¨ğŸ¿â€ğŸ¤â€ğŸ‘¨ğŸ»	couple, deux hommes se tenant par la main, deux hommes se tenant par la mainÂ : peau foncÃ©e et peau claire, ensemble, gÃ©meaux, hommes, jumeaux, main, main dans la main, peau claire, peau foncÃ©e, se tenant par la main, union, zodiaque
ğŸ‘¨ğŸ¿â€ğŸ¤â€ğŸ‘¨ğŸ¼	couple, deux hommes se tenant par la main, deux hommes se tenant par la mainÂ : peau foncÃ©e et peau modÃ©rÃ©ment claire, ensemble, gÃ©meaux, hommes, jumeaux, main, main dans la main, peau foncÃ©e, peau modÃ©rÃ©ment claire, se tenant par la main, union, zodiaque
ğŸ‘¨ğŸ¿â€ğŸ¤â€ğŸ‘¨ğŸ½	couple, deux hommes se tenant par la main, deux hommes se tenant par la mainÂ : peau foncÃ©e et peau lÃ©gÃ¨rement mate, ensemble, gÃ©meaux, hommes, jumeaux, main, main dans la main, peau foncÃ©e, peau lÃ©gÃ¨rement mate, se tenant par la main, union, zodiaque
ğŸ‘¨ğŸ¿â€ğŸ¤â€ğŸ‘¨ğŸ¾	couple, deux hommes se tenant par la main, deux hommes se tenant par la mainÂ : peau foncÃ©e et peau modÃ©rÃ©ment foncÃ©e, ensemble, gÃ©meaux, hommes, jumeaux, main, main dans la main, peau foncÃ©e, peau modÃ©rÃ©ment foncÃ©e, se tenant par la main, union, zodiaque
ğŸ‘¬ğŸ¿	couple, deux hommes se tenant par la main, deux hommes se tenant par la mainÂ : peau foncÃ©e, ensemble, gÃ©meaux, hommes, jumeaux, main, main dans la main, peau foncÃ©e, se tenant par la main, union, zodiaque
ğŸ‘©â€â¤â€ğŸ’‹â€ğŸ‘¨	bisouÂ : femme et homme
ğŸ‘¨â€â¤â€ğŸ’‹â€ğŸ‘¨	bisouÂ : homme et homme
ğŸ‘©â€â¤â€ğŸ’‹â€ğŸ‘©	bisouÂ : femme et femme
ğŸ’‘	amour, couple, cÅ“ur
ğŸ‘©â€â¤â€ğŸ‘¨	amour, couple, couple avec cÅ“urÂ : femme et homme, cÅ“ur, femme, homme
ğŸ‘¨â€â¤â€ğŸ‘¨	amour, couple, couple avec cÅ“urÂ : homme et homme, cÅ“ur, homme
ğŸ‘©â€â¤â€ğŸ‘©	amour, couple, couple avec cÅ“urÂ : femme et femme, cÅ“ur, femme
ğŸ‘¨â€ğŸ‘©â€ğŸ‘¦	familleÂ : homme, femme et garÃ§on
ğŸ‘¨â€ğŸ‘©â€ğŸ‘§	familleÂ : homme, femme et fille
ğŸ‘¨â€ğŸ‘©â€ğŸ‘§â€ğŸ‘¦	familleÂ : homme, femme, fille et garÃ§on
ğŸ‘¨â€ğŸ‘©â€ğŸ‘¦â€ğŸ‘¦	familleÂ : homme, femme, garÃ§on et garÃ§on
ğŸ‘¨â€ğŸ‘©â€ğŸ‘§â€ğŸ‘§	familleÂ : homme, femme, fille et fille
ğŸ‘¨â€ğŸ‘¨â€ğŸ‘¦	familleÂ : homme, homme et garÃ§on
ğŸ‘¨â€ğŸ‘¨â€ğŸ‘§	familleÂ : homme, homme et fille
ğŸ‘¨â€ğŸ‘¨â€ğŸ‘§â€ğŸ‘¦	familleÂ : homme, homme, fille et garÃ§on
ğŸ‘¨â€ğŸ‘¨â€ğŸ‘¦â€ğŸ‘¦	familleÂ : homme, homme, garÃ§on et garÃ§on
ğŸ‘¨â€ğŸ‘¨â€ğŸ‘§â€ğŸ‘§	familleÂ : homme, homme, fille et fille
ğŸ‘©â€ğŸ‘©â€ğŸ‘¦	familleÂ : femme, femme et garÃ§on
ğŸ‘©â€ğŸ‘©â€ğŸ‘§	familleÂ : femme, femme et fille
ğŸ‘©â€ğŸ‘©â€ğŸ‘§â€ğŸ‘¦	familleÂ : femme, femme, fille et garÃ§on
ğŸ‘©â€ğŸ‘©â€ğŸ‘¦â€ğŸ‘¦	familleÂ : femme, femme, garÃ§on et garÃ§on
ğŸ‘©â€ğŸ‘©â€ğŸ‘§â€ğŸ‘§	familleÂ : femme, femme, fille et fille
ğŸ‘¨â€ğŸ‘¦	familleÂ : homme et garÃ§on
ğŸ‘¨â€ğŸ‘¦â€ğŸ‘¦	familleÂ : homme, garÃ§on et garÃ§on
ğŸ‘¨â€ğŸ‘§	familleÂ : homme et fille
ğŸ‘¨â€ğŸ‘§â€ğŸ‘¦	familleÂ : homme, fille et garÃ§on
ğŸ‘¨â€ğŸ‘§â€ğŸ‘§	familleÂ : homme, fille et fille
ğŸ‘©â€ğŸ‘¦	familleÂ : femme et garÃ§on
ğŸ‘©â€ğŸ‘¦â€ğŸ‘¦	familleÂ : femme, garÃ§on et garÃ§on
ğŸ‘©â€ğŸ‘§	familleÂ : femme et fille
ğŸ‘©â€ğŸ‘§â€ğŸ‘¦	familleÂ : femme, fille et garÃ§on
ğŸ‘©â€ğŸ‘§â€ğŸ‘§	familleÂ : femme, fille et fille
ğŸ—£ï¸	parler, parole, silhouette, visage
ğŸ‘¤	buste, silhouette
ğŸ‘¥	bustes, silhouettes
ğŸ‘£	empreinte, pas, pied, trace
ğŸµ	singe, tÃªte
ğŸ’	singe
ğŸ¦	gorille
ğŸ¦§	singe
ğŸ¶	animal, chien, compagnie, domestique, tÃªte
ğŸ•ï¸	animal, chien, compagnie, domestique
ğŸ¦®	chien-guide
ğŸ•â€ğŸ¦º	accessibilitÃ©, aide, assistance, chien
ğŸ©	animal, caniche, compagnie, domestique
ğŸº	loup, tÃªte
ğŸ¦Š	renard, tÃªte
ğŸ±	animal, chat, compagnie, domestique, tÃªte
ğŸˆï¸	animal, chat, compagnie, domestique
ğŸ¦	lion, tÃªte, zodiaque
ğŸ¯	tigre, tÃªte
ğŸ…	tigre
ğŸ†	lÃ©opard
ğŸ´	cheval, tÃªte
ğŸ	cheval, course, hippique, Ã©questre
ğŸ¦„	licorne, tÃªte
ğŸ¦Œ	cerf
ğŸ®	tÃªte, vache
ğŸ‚	bÅ“uf, taureau, zodiaque
ğŸƒ	buffle
ğŸ„	vache
ğŸ·	cochon, tÃªte
ğŸ–	cochon, porc
ğŸ—	sanglier
ğŸ½	cochon, groin, nez, nez de cochon, porc
ğŸ	bÃ©lier, zodiaque
ğŸ‘	brebis
ğŸ	capricorne, chÃ¨vre, zodiaque
ğŸª	bosse, dromadaire
ğŸ«	bosses, chameau
ğŸ˜	Ã©lÃ©phant
ğŸ¦	rhinocÃ©ros
ğŸ­	souris, tÃªte
ğŸ	souris
ğŸ€	rat
ğŸ¹	animal, compagnie, domestique, hamster, tÃªte, tÃªte de hamster
ğŸ°	lapin, tÃªte
ğŸ‡	animal, compagnie, domestique, lapin
ğŸ¿ï¸	tamia
ğŸ¦‡	chauve-souris, vampire
ğŸ»	ours, tÃªte
ğŸ¨	koala
ğŸ¼	panda, tÃªte, tÃªte de panda
ğŸ¦¥	endormi, lent
ğŸ¦¦	joueur, pÃªcheur
ğŸ¦¨	animal, bÃªte puante, odeur, puer, putois
ğŸ¦˜	Australie, bÃ©bÃ© kangourou, marsupial, saut
ğŸ¦¡	blaireau, ratel
ğŸ¾	empreintes, foulÃ©es, marques, pas, pattes, traces
ğŸ¦ƒ	dinde, oiseau
ğŸ”	oiseau, poule
ğŸ“	coq, oiseau
ğŸ£	oiseau, poussin, Ã©closion
ğŸ¤	oiseau, poussin
ğŸ¥	oiseau, poussin de face
ğŸ¦ï¸	oiseau
ğŸ§	oiseau, pingouin
ğŸ¦†	canard, oiseau
ğŸ¦¢	jeune cygne, oiseau, vilain petit canard
ğŸ¦©	rose, tropical
ğŸ¸	grenouille, tÃªte, tÃªte de grenouille
ğŸŠ	crocodile
ğŸ¢	tortue
ğŸ	serpent, serpentaire, zodiaque
ğŸ²	dragon, tÃªte
ğŸ‰	contes, dragon, fantastique, fÃ©es, merveilleux
ğŸ¦–	T. rex, Tyrannosaurus Rex
ğŸ³	baleine, baleine qui expulse de lâ€™eau, expulse de lâ€™eau
ğŸ‹	baleine
ğŸ¬	dauphin, flipper
ğŸ 	poisson, tropical
ğŸ¡	poisson, poisson-globe
ğŸ™	pieuvre
ğŸš	coquille, spirale
ğŸŒ	escargot
ğŸ›	chenille, insecte
ğŸœ	fourmi, insecte
ğŸ	abeille, insecte
ğŸ	bÃªte Ã  bon dieu, catherine, coccinelle, colÃ©optÃ¨re, insecte
ğŸ•·ï¸	araignÃ©e
ğŸ•¸ï¸	araignÃ©e, toile
ğŸ¦‚	scorpion, zodiaque
ğŸŒ¸	cerisier, fleur
ğŸ’®	blanche, fleur
ğŸŒ²	arbre, conifÃ¨re, feuillage persistant
ğŸŒ¾	plant, riz
â˜˜ï¸	plante, trois feuilles, trÃ¨fle, trÃ¨fle Ã  trois feuilles
ğŸ€	chance, quatre feuilles, trÃ¨fle
ğŸ	feuille, Ã©rable
ğŸ‚	feuille, morte
ğŸƒ	feuille, virevoltante
ğŸ‰	fruit, melon dâ€™eau
ğŸŠ	fruit, orange, tangerine
ğŸ	fruit, pomme, rouge
ğŸ	fruit, pomme, verte
ğŸŒ½	blÃ© dâ€™Inde, maÃ¯s, Ã©pi de blÃ© dâ€™Inde, Ã©pi de maÃ¯s
ğŸ¥¬	chinois, chou, frisÃ©, laitue, pommÃ©
ğŸ¥¦	brocoli, chou sauvage
ğŸ§„	aromatisant, assaisonnement, condiment
ğŸ§…	aromatisant, assaisonnement, condiment
ğŸ„	champignon, vÃ©nÃ©neux
ğŸ¥œ	arachide, arachides, cacahuÃ¨te, noisette
ğŸ	baguette, pain
ğŸ¥	crÃªpe, crÃªpes, pancake
ğŸ§€	fromage, morceau, morceau de fromage
ğŸ–	os, viande, viande sur son os
ğŸ—	cuisse, os, poulet, volaille
ğŸ¥©	bifteck, bÅ“uf, coupe, morceau, morceau de viande, steak, tranche, viande
ğŸ¥“	bacon
ğŸ”	burger, hambourgeois, hamburger
ğŸŸ	frites, patate
ğŸŒ­	Francfort, chien chaud, hot dog, saucisse
ğŸ¥™	chichekÃ©bab, doner, falafel, gyro, kÃ©bab, pain plat garni, pita
ğŸ¥š	aliment, nourriture, Å“uf
ğŸ³	cuisine, friture, poÃªle, Å“uf
ğŸ¥˜	casserole, nourriture, paella, poÃªle, repas
ğŸ²	bol de nourriture, marmite, ragoÃ»t
ğŸ¿	pop-corn, popcorn
ğŸ§ˆ	produit laitier
ğŸ§‚	condiment, mÃ©langeur
ğŸ±	bento, boÃ®te, boÃ®te Ã  bento, dÃ©jeuner
ğŸ˜	craquelin, craquelin de riz, riz
ğŸ™	boulette, riz
ğŸš	bol, riz
ğŸ›	curry, riz
ğŸ 	douce, grillÃ©e, patate, patate douce grillÃ©e
ğŸ¢	brochette, fruits de mer, oden
ğŸ¤	crevette, crevette frite
ğŸ¥	gÃ¢teau au poisson, narutomaki, pÃ¢tÃ© de poisson, surimi, surimi avec dÃ©coration
ğŸ¡	Brochette, dango, dessert, japonais, sucrÃ©
ğŸ¥Ÿ	dumpling, empanada, gyÅza, jiaozi, pierogi, potsticker
ğŸ¦€	cancer, crabe, zodiaque
ğŸ¦	crevette, crustacÃ©, nourriture
ğŸ¦	cornet, crÃ¨me glacÃ©e, crÃ¨me glacÃ©e molle, dessert, glace
ğŸ§	glace, glace pilÃ©e, pilÃ©e
ğŸ¨	crÃ¨me, crÃ¨me glacÃ©e, dessert, glace, sucrÃ©
ğŸ©	beigne, beignet, dessert, sucrÃ©
ğŸª	biscuit, dessert, sucrÃ©
ğŸ‚	anniversaire, dessert, fÃªte, gÃ¢teau, gÃ¢teau de fÃªte, pÃ¢tisserie
ğŸ°	dessert, gÃ¢teau, part, pÃ¢tisserie, sucrerie
ğŸ§	cupcake, petit gÃ¢teau, pÃ¢tisserie, sucrerie
ğŸ«	barre, chocolat, dessert, sucrÃ©, tablette de chocolat
ğŸ¬	bonbon, dessert, sucrerie, sucrÃ©
ğŸ­	dessert, sucrerie, sucrÃ©, suÃ§on
ğŸ®	crÃ¨me caramel, dessert, pudding, sucrÃ©
â˜•ï¸	boisson chaude, cafÃ©, thÃ©
ğŸµ	boisson, tasse, thÃ©
ğŸ¶	bar, boisson, bouteille, sakÃ©, tasse
ğŸ·	bar, boisson, verre, vin
ğŸ¹	cocktail, tropical, verre
ğŸº	bar, biÃ¨re, boisson, chope, chope de biÃ¨re
ğŸ»	bar, biÃ¨re, boisson, chope, chopes de biÃ¨re qui tintent, trinquer
ğŸ¥‚	boisson, cÃ©lÃ©brer, trinquer, verre, verres qui tintent
ğŸ¥ƒ	Verre, bourbon, liqueur, spiritueux, verre, whisky
ğŸ¥¤	jus de fruits, paille, soda, verre, verre avec paille
ğŸ§ƒ	boÃ®te Ã  boire, carton, jus de fruits
ğŸ½ï¸	assiette, couteau, couverts, fourchette
ğŸ´	couteau, couverts, fourchette, repas
ğŸº	amphore, cuisine, vase, verseau, zodiaque
ğŸŒ	afrique, europe, globe, globe qui montre lâ€™Europe et lâ€™Afrique, monde
ğŸŒï¸	amÃ©rique, globe, globe qui montre lâ€™AmÃ©rique, monde
ğŸŒ	asie, australie, globe, globe qui montre lâ€™Asie et lâ€™Australie, monde
ğŸŒ	globe, globe qui montre les mÃ©ridiens, monde, mÃ©ridiens, terre
ğŸ—ºï¸	carte, monde
ğŸ—¾	carte, japon
ğŸ§­	magnÃ©tique, navigation, orientation
ğŸ”ï¸	enneigÃ©e, montagne, neige
ğŸŒ‹	montagne, volcan, Ã©ruption
ğŸ—»	Fuji, mont, montagne
ğŸ–ï¸	parasol, plage, plage et parasol
ğŸï¸	dÃ©serte, Ã®le
ğŸï¸	national, parc
ğŸ›ï¸	classique, monument
ğŸ—ï¸	bÃ¢timent, construction
ğŸšï¸	abandonnÃ©e, maison, ruine
ğŸ¡	jardin, logement, maison
ğŸ¢	bureaux, immeuble
ğŸ£	bÃ¢timent, japon, poste, poste japonaise
ğŸ¤	bureau, poste
ğŸ¥	bÃ¢timent, docteur, hÃ´pital
ğŸ©	couples, hÃ´tel, hÃ´tel pour couples
ğŸª	dÃ©panneur, magasin, Ã©picerie
ğŸ¯	chÃ¢teau, japonais
ğŸ°	chÃ¢teau, europÃ©en
ğŸ’’	amour, chapelle, idylle, mariage
ğŸ—½	statue de la LibertÃ©
ğŸ›•	hindou, temple
â›©ï¸	sanctuaire, shinto
ğŸŒƒ	nuit, Ã©toiles, Ã©toilÃ©e
ğŸ™ï¸	bÃ¢timent, paysage urbain, ville
ğŸŒ„	lever, lever de soleil sur les montagnes, montagnes, soleil
ğŸŒ…	levant, matin, soleil
ğŸŒ†	coucher, crÃ©puscule, soir, soleil, ville
ğŸŒ‡	coucher, soleil
ğŸŒ‰	nuit, pont, pont de nuit
â™¨ï¸	source, sources thermales, thermale
ğŸ 	carrousel, cheval, cheval de carrousel, manÃ¨ge
ğŸ¡	grande roue, parc dâ€™attractions
ğŸ¢	montagnes, parc dâ€™attractions, russes
ğŸ’ˆ	barbier, coiffure, enseigne
ğŸš‚	chemin de fer, locomotive, moteur, train, vapeur
ğŸšƒ	chemin de fer, train, tram, trolley, voiture, Ã©lectrique
ğŸš„	TGV, chemin de fer, grande vitesse, shinkansen, train, train Ã  grande vitesse
ğŸš…	chemin de fer, shinkansen, superexpress, train, train superexpress, vitesse
ğŸšˆ	chemin de fer, mÃ©tro lÃ©ger, train de banlieue
ğŸš‰	chemin de fer, gare, train
ğŸšŠ	tram, trolley, trolleybus
ğŸš	chemin de fer, montagne, train, voiture, wagon
ğŸš‹	tram, trolley, trolleybus, voiture
ğŸšŒ	autobus, bus, vÃ©hicule
ğŸšï¸	autobus, bus, de face, Ã  lâ€™arrivÃ©e
ğŸš	bus, tram, trolley, trolleybus
ğŸš’	autopompe, camion, incendie, pompier
ğŸš“	patrouille, police, voiture
ğŸš”ï¸	de face, police, voiture
ğŸš–	de face, taxi
ğŸš—	automobile, char, voiture
ğŸš˜ï¸	automobile, char, de face, voiture
ğŸš™	loisirs, sport, utilitaire, vÃ©hicule
ğŸšš	camion, livraison
ğŸš›	camion semi-remorque
ğŸï¸	course, voiture
ğŸš²ï¸	bicyclette, vÃ©lo
ğŸš	arrÃªt, autobus, bus
ğŸ›£ï¸	autoroute, route, voie publique
ğŸ›¤ï¸	chemin de fer, train, voie ferrÃ©e
ğŸ›¢ï¸	baril, pÃ©trole
â›½ï¸	carburant, diesel, essence, pompe, station
ğŸš¥	circulation, feu, feu de circulation horizontal, horizontal, tricolore
ğŸš¦	circulation, feu, feu de circulation vertical, tricolore, vertical
ğŸ›‘	octogonal, signe, stop
â›µï¸	bateau, mer, voile, voilier, yacht
â›´ï¸	bateau, passager, traversier
ğŸ›¥ï¸	bateau, moteur
ğŸš¢	bateau, navire, passager
âœˆï¸	avion
ğŸ›©ï¸	avion, petit
ğŸ›«	avion, avion au dÃ©collage, dÃ©collage, dÃ©part, embarquement
ğŸ›¬	arrivÃ©e, atterrissage, avion, avion Ã  lâ€™atterissage, dÃ©barquement
ğŸª‚	chute libre, parachute ascensionnel, parapente
ğŸšŸ	suspendu, train
ğŸš 	tÃ©lÃ©cabine
ğŸš¡	funiculaire, tramway, tÃ©lÃ©phÃ©rique, voiture, wagon
ğŸ›ï¸	cloche, comptoir, hÃ´tel
â³ï¸	en cours, minuteur, sable, sablier
â²ï¸	heure, minuteur
ğŸ•°ï¸	horloge, pendule de cheminÃ©e
ğŸ•›ï¸	0 h, 12 h, midi, minuit
ğŸ•§	00 h 30, 12 h 30, midi et demie, minuit et demie
ğŸŒ‘	lune, nouvelle
ğŸŒ’	lune, premier croissant, premier croissant de lune
ğŸŒ“	premier quartier de lune
ğŸŒ”	gibbeuse croissante, lune
ğŸŒ•ï¸	lune, pleine
ğŸŒ–	gibbeuse dÃ©croissante, lune
ğŸŒ—	dernier quartier, dernier quartier de lune, lune
ğŸŒ˜	dernier croissant, dernier croissant de lune, lune
ğŸŒ™	croissant, lune
ğŸŒš	lune, nouvelle, nouvelle lune avec visage, visage
ğŸŒ›	lune, premier quartier, premier quartier de lune avec visage, visage
ğŸŒœï¸	dernier quartier, dernier quartier de lune avec visage, lune, visage
ğŸŒ	lune, pleine, pleine lune avec visage, visage
ğŸŒ	soleil, soleil avec visage, visage
ğŸª	saturne, saturnien, saturnienne
â­ï¸	Ã©toile, Ã©toile blanche moyenne
ğŸŒŸ	brillante, Ã©toile
ğŸŒ 	filante, Ã©toile
ğŸŒŒ	Voie lactÃ©e, espace
â›…ï¸	nuage, nuageux, soleil, soleil derriÃ¨re un nuage
â›ˆï¸	nuage, nuage avec Ã©clair et pluie, pluie, Ã©clair
ğŸŒ¤ï¸	nuage, petit nuage, soleil, soleil derriÃ¨re un petit nuage
ğŸŒ¥ï¸	gros nuage, nuage, soleil, soleil derriÃ¨re un gros nuage
ğŸŒ¦ï¸	nuage, nuage de pluie, soleil, soleil derriÃ¨re un nuage de pluie
ğŸŒ§ï¸	nuage, nuage de pluie, pluie
ğŸŒ¨ï¸	flocons, neige, nuage, nuage avec de la neige
ğŸŒ©ï¸	nuage, nuage avec un Ã©clair, Ã©clair
ğŸŒªï¸	nuage, tornade, tourbillon
ğŸŒ«ï¸	brouillard, nuage
ğŸŒ¬ï¸	mÃ©tÃ©o, souffle, vent, visage, visage qui souffle du vent
ğŸŒ€	cyclone, ouragan, tourbillon, typhon
ğŸŒˆ	arc-en-ciel, pluie
ğŸŒ‚	fermÃ©, parapluie, pluie, vÃªtement
â˜‚ï¸	parapluie, pluie, vÃªtement
â˜”ï¸	gouttes, parapluie, parapluie avec gouttes de pluie, pluie
â›±ï¸	mÃ©tÃ©o, parapluie, parasol, pluie, soleil
âš¡ï¸	danger, haute tension, Ã©lectricitÃ©
â„ï¸	flocon, flocon de neige, froid, neige
â˜ƒï¸	bonhomme de neige, bonhomme de neige avec flocons, flocons, froid, neige
â›„ï¸	bonhomme de neige, froid, neige, sans
ğŸ”¥	feu, flamme, outil
ğŸ’§	bande dessinÃ©e, eau, goutte, goutte dâ€™eau, gouttelette, sueur
ğŸŒŠ	eau, mer, ocÃ©an, vague
ğŸ„	cÃ©lÃ©bration, noÃ«l, sapin de NoÃ«l
ğŸ†	artifice, cÃ©lÃ©bration, feu
ğŸ‡	artifice, bengale, cÃ©lÃ©bration, feu, feu de Bengale
âœ¨	Ã©tincelles, Ã©toile
ğŸˆ	ballon, ballon de fÃªte, fÃªte
ğŸ‰	confettis, cornet, cornet Ã  confettis, cÃ©lÃ©bration, fÃªte
ğŸŠ	boule, boule de confetti, confettis, cÃ©lÃ©bration, fÃªte
ğŸ‹	arbre, arbre Ã  priÃ¨res, japonais, tanabata
ğŸ	bambou, composition florale, composition florale japonaise, cÃ©lÃ©bration, japonais
ğŸ	festival, japonais, japonaises, poupÃ©es
ğŸ	carillon, carillon Ã  vent, clochette, fÃªte, vent
ğŸ‘	cÃ©rÃ©monie, cÃ©rÃ©monie dâ€™observation de la lune, lune
ğŸ	anniversaire, cadeau, cÃ©lÃ©bration, fÃªte, prÃ©sent
ğŸ—ï¸	commÃ©moratif, ruban, ruban commÃ©moratif, souvenir
ğŸŸï¸	billet, entrÃ©e, spectacle
ğŸ–ï¸	dÃ©coration, militaire, mÃ©daille
ğŸ…	mÃ©daille, sportive
ğŸ¥‡	1er, 1re, mÃ©daille, or, premiÃ¨re place
ğŸ¥ˆ	2e, argent, deuxiÃ¨me, deuxiÃ¨me place, mÃ©daille
ğŸ¥‰	3e, bronze, mÃ©daille, troisiÃ¨me, troisiÃ¨me place
âš½ï¸	ballon, ballon de soccer, foot, football, soccer
âš¾ï¸	balle, baseball
ğŸ¥	balle, balle molle, gant, molle, softball
ğŸ€	ballon, ballon de basket, basket, basketball, panier
ğŸ	ballon, ballon de volley, volley
ğŸˆ	ballon, ballon de football, football
ğŸ‰	ballon, ballon de rugby, rugby
ğŸ¾	balle, raquette, tennis
ğŸ¥	disque dâ€™Ã©quipe, disque volant
ğŸ³	boule, bowling, jeu de quilles, quilles
ğŸ	balle, bÃ¢ton, cricket
ğŸ‘	balle, bÃ¢ton, gazon, hockey
ğŸ’	bÃ¢ton, disque, glace, hockey, rondelle
ğŸ“	balle, ping-pong, raquette, table, tennis, tennis de table
ğŸ¸	badminton, moineau, raquette, volant
ğŸ¥Š	boxe, gant
ğŸ¥‹	arts martiaux, judo, karatÃ©, kimono, taekwondo, uniforme dâ€™arts martiaux
ğŸ¥…	but, cage, filet
â›³ï¸	drapeau, golf, trou
â›¸ï¸	glace, patin
ğŸ£	canne, ligne, pÃªche
ğŸ½	athlÃ©tisme, banderole, course, maillot, maillot de course, t-shirt
ğŸ¿	neige, ski, skis
ğŸ¯	cible, dans le mille, flÃ©chette
ğŸ”®	boule, cristal
ğŸ§¿	amulette, mauvais Å“il, nazar, talisman
ğŸ²	dÃ©, jeu
ğŸ§©	casse-tÃªte, piÃ¨ce
â™¥ï¸	carte, couleur, cÅ“ur, jeu
â™£ï¸	carte, couleur, jeu, trÃ¨fle
â™Ÿï¸	duper, pion, sacrifiable, Ã©chec
ğŸƒ	carte, jeu, joker
ğŸ€„ï¸	dragon, mahjong, rouge
ğŸ´	jeu des fleurs
ğŸ­ï¸	art, arts du spectacle, masque, spectacle, thÃ©Ã¢tre
ğŸ¨	art, musÃ©e, palette, peinture
ğŸ¥½	natation, protection des yeux, soudage, soudure
ğŸ¥¼	docteur, expÃ©rience, scientifique
ğŸ¦º	veste de sÃ©curitÃ©
ğŸ‘•	T-shirt, chandail, gaminet, tee-shirt, vÃªtements
ğŸ§¦	bas, chaussettes, pieds
ğŸ¥»	robe, vÃªtement
ğŸ©²	bobettes, maillot de bain, sous-vÃªtement, une piÃ¨ce
ğŸ‘™	bikini, maillot de bain, vÃªtements
ğŸ‘š	femme, vÃªtements
ğŸ›ï¸	hÃ´tel, magasinage, sac, sacs de magasinage, shopping
ğŸ’	sac, sac dâ€™Ã©cole, sac Ã  dos, Ã©cole
ğŸ‘	chaussure, homme, vÃªtements
ğŸ‘Ÿ	chaussure, course, espadrille, sport
ğŸ¥¿	ballerine, chaussure sans lacets, pantoufle
ğŸ‘ 	chaussure, femme, talon, vÃªtements
ğŸ‘¡	chaussure, femme, sandale, sandale Ã  talon, talon, vÃªtements
ğŸ‘¢	botte, chaussure, femme, vÃªtements
ğŸ‘’	chapeau, femme, vÃªtements
ğŸ©	chapeau, haut-de-forme, vÃªtements
ğŸ“ï¸	chapeau, chapeau de diplÃ´mÃ©, diplÃ´mÃ©, mortier, remise de diplÃ´mes, vÃªtements
ğŸ§¢	casquette de baseball
â›‘ï¸	casque, casque avec une croix blanche, chapeau, croix, secours, visage
ğŸ’	bague, diamant
ğŸ”‡	enceinte, haut-parleur, silence, son, son coupÃ©
ğŸ”ˆï¸	son bas, volume bas, volume faible
ğŸ”‰	son moyen, volume moyen
ğŸ”Š	son fort, son puissant, son Ã©levÃ©, volume fort, volume Ã©levÃ©
ğŸ“¢	bruyant, discours, haut-parleur, porte-voix
ğŸ“¯	cor de facteur, facteur, poste
ğŸ”•	barrÃ©e, cloche, cloche barrÃ©e, silence, silencieux
ğŸ§ï¸	casque dâ€™Ã©coute, Ã©couteur
ğŸª•	cordes, instrument, musique
ğŸ“±	tÃ©lÃ©phone, tÃ©lÃ©phone cellulaire
ğŸ“²	appel, tÃ©lÃ©phone cellulaire prÃ©cÃ©dÃ© par une flÃ¨che
ğŸ“	rÃ©cepteur tÃ©lÃ©phonique, tÃ©lÃ©phone
ğŸ“Ÿï¸	pager, tÃ©lÃ©avertisseur
ğŸ“ 	tÃ©lÃ©copieur
ğŸ”‹	batterie, pile
ğŸ”Œ	prise, prise Ã©lectrique
ğŸ–²ï¸	boule de commande
ğŸ’½	disque, disque dur, optique, ordinateur
ğŸ’¿ï¸	CD, disque, ordinateur
ğŸ“€	DVD, blu-ray, disque, ordinateur
ğŸ“½ï¸	cinÃ©ma, film, projecteur, vidÃ©o
ğŸ“ºï¸	TV, tÃ©lÃ©, tÃ©lÃ©viseur, tÃ©lÃ©vision, vidÃ©o
ğŸ“¸	appareil photo, flash
ğŸ“¼	cassette, vhs, vidÃ©o
ğŸ”	agrandir, loupe, outil, rechercher
ğŸ”	agrandir, loupe, outil, rechercher
ğŸ’¡	ampoule, idÃ©e, lumiÃ¨re
ğŸ”¦	lampe de poche, lumiÃ¨re
ğŸ®	japonais, lanterne, lanterne dâ€™izakaya, lumiÃ¨re, rouge
ğŸ“”	bloc-notes, carnet avec couverture dÃ©corative, couverture, livre
ğŸ““	cahier, carnet
ğŸ“’	carnet de compte
ğŸ“‘	marque, marqueur, onglets, signet
ğŸ’´	billet, yen, yens
ğŸ’µ	billet, dollar, dollars
ğŸ’¶	billet, euro, euros
ğŸ’·	billet, livre, livres
ğŸ’³ï¸	argent, carte, carte de crÃ©dit, crÃ©dit
ğŸ’¹	courbe, courbe croissante prÃ©cÃ©dÃ©e du symbole du yen, croissance, graphique, monnaie, yen
ğŸ’±	argent, banque, change, devise
ğŸ’²	argent, devise, dollar, symbole du dollar en gras
âœ‰ï¸	courriel, courrier, enveloppe, lettre
ğŸ“§	courriel, courrier, lettre
ğŸ“©	courriel, enveloppe, envoi, flÃ¨che
ğŸ“«ï¸	boÃ®te aux lettres, boÃ®te aux lettres fermÃ©e, boÃ®te aux lettres fermÃ©e avec drapeau levÃ©, courrier, drapeau levÃ©
ğŸ“ªï¸	boÃ®te aux lettres, boÃ®te aux lettres fermÃ©e, boÃ®te aux lettres fermÃ©e avec drapeau baissÃ©, courrier, drapeau baissÃ©
ğŸ“¬ï¸	boÃ®te aux lettres, boÃ®te aux lettres ouverte, boÃ®te aux lettres ouverte avec drapeau levÃ©, courrier, drapeau levÃ©
ğŸ“­ï¸	boÃ®te aux lettres, boÃ®te aux lettres ouverte, boÃ®te aux lettres ouverte avec drapeau baissÃ©, courrier, drapeau baissÃ©
ğŸ“®	boÃ®te aux lettres, boÃ®te postale, courrier
âœ’ï¸	plume noire, stylo
ğŸ–‹ï¸	stylo, stylo-plume
ğŸ–ï¸	crayon de cire, crayon pastel
ğŸ“†	calendrier, calendrier Ã  effeuiller, Ã©phÃ©mÃ©ride
ğŸ“‡	carte, fiche, index, rolodex
ğŸ“ˆ	graphique, hausse
ğŸ“‰	baisse, graphique
ğŸ“Š	barres, graphique
ğŸ“‹ï¸	fournitures, presse-papiers
ğŸ“Œ	fournitures, Ã©pingle
ğŸ“	fournitures, Ã©pingle Ã  tÃªte ronde
ğŸ–‡ï¸	fournitures, trombones accrochÃ©s
ğŸ—„ï¸	classeur, dossier
ğŸ—‘ï¸	corbeille
ğŸ”’ï¸	cadenas, fermÃ©, verrouiller, verrouillÃ©
ğŸ”“ï¸	cadenas, dÃ©verrouiller, dÃ©verrouillÃ©, ouvert
ğŸ”	cadenas, confidentialitÃ©, encre, stylo
ğŸ”	cadenas, cadenas avec clÃ©, clÃ©, fermÃ©, sÃ»r, verrouillÃ©
â›ï¸	mine, outil, pic
âš’ï¸	marteau, marteau et pic, pic
ğŸ› ï¸	clÃ© Ã  molette, marteau
ğŸ¹	arc, flÃ¨che, sagittaire, zodiaque
ğŸ”§	clÃ©, outil
ğŸ”©	outil, vis, Ã©crou
âš™ï¸	engrenage, outil
ğŸ—œï¸	serre-joint
âš–ï¸	balance, balance Ã  poids, zodiaque
ğŸ”—	chaÃ®nons
ğŸ”¬	microscope, outi, science
ğŸ›‹ï¸	canapÃ©, divan, lampe, sofa, sofa et lampe
ğŸš½	cabinet de toilette, siÃ¨ge de toilette, toilettes
ğŸ§»	essuie-mai, essuie-tout, papier hygiÃ©nique, papier toilette
ğŸ§¼	bain, mousse, pain, savon, savonnette
ğŸ›’	chariot, panier, panier dâ€™Ã©picerie, shopping
ğŸ—¿	moaÃ¯, statue
ğŸ§	bancaire, banque, gab, guichet, guichet automatique bancaire
â™¿ï¸	accÃ¨s handicapÃ©s, symbole de fauteuil roulant
ğŸš¹ï¸	sanitaires, toilettes, toilettes pour hommes
ğŸšºï¸	sanitaires, toilettes, toilettes pour femmes
ğŸš»	toilettes
ğŸš¼ï¸	symbole bÃ©bÃ©
ğŸš¾	symbole Toilettes, toilettes
ğŸ›‚	contrÃ´le, douane, passeport
ğŸ›„	bagages, retrait des bagages, tapis Ã  bagages
ğŸ›…	bagages, consigne Ã  bagages
âš ï¸	avertissement
ğŸš¸	attention, enfants, circulation, enfant, passage dâ€™enfants, piÃ©tons
ğŸš«	interdit
ğŸš­ï¸	fumer, interdiction, interdit, non fumeur
ğŸš¯	dÃ©chet, interdiction, interdit, ordure
ğŸš±	eau, non potable
ğŸ“µ	cellulaire, interdiction, interdit, mobile, portable, tÃ©lÃ©phones cellulaires interdits
ğŸ”	18, dix-huit, interdiction
â˜£ï¸	biologique, danger
â¬†ï¸	direction, en haut, flÃ¨che, flÃ¨che pointant vers le haut, nord, point cardinal
â†—ï¸	direction, en haut Ã  droite, flÃ¨che, flÃ¨che pointant vers le haut Ã  droite, nord-est, point intercardinal
â¡ï¸	direction, est, flÃ¨che, flÃ¨che pointant vers la droite, point cardinal, Ã  droite
â†˜ï¸	direction, en bas Ã  droite, flÃ¨che pointant vers le bas Ã  droite, lÃ¨che, point intercardinal, sud-est
â¬‡ï¸	direction, en bas, flÃ¨che, flÃ¨che pointant vers le bas, point cardinal, sud
â†™ï¸	direction, en bas Ã  gauche, flÃ¨che, flÃ¨che pointant vers le bas Ã  gauche, point intercardinal, sud-ouest
â¬…ï¸	direction, flÃ¨che, flÃ¨che pointant vers la gauche, ouest, point cardinal, Ã  gauche
â†–ï¸	direction, en haut Ã  gauche, flÃ¨che, flÃ¨che pointant vers le haut Ã  gauche, nord-ouest, point intercardinal
â†•ï¸	bas haut, en bas et en haut, en haut et en bas, flÃ¨che, flÃ¨che pointant vers le haut et vers le bas, haut bas
â†”ï¸	droite gauche, flÃ¨che, flÃ¨che pointant Ã  gauche et Ã  droite, gauche droite, Ã  droite et Ã  gauche, Ã  gauche et Ã  droite
â†©ï¸	courbe vers la gauche, flÃ¨che, flÃ¨che courbe vers la gauche
â†ªï¸	courbe vers la droite, flÃ¨che, flÃ¨che courbe vers la droite
â¤´ï¸	courbe vers le haut, flÃ¨che, flÃ¨che courbe vers le haut
â¤µï¸	courbe vers le bas, flÃ¨che, flÃ¨che courbe vers le bas
ğŸ”ƒ	flÃ¨che, flÃ¨ches verticales dans le sens horaire, horaire, recharger, sens des aiguilles dâ€™une montre, vertical
ğŸ”„	antihoraire, flÃ¨che, flÃ¨ches verticales dans le sens antihoraire, sens inverse des aiguilles dâ€™une montre
ğŸ”™	back, flÃ¨che, retour, Ã©tiquette Â«Â BACKÂ Â» et flÃ¨che
ğŸ”š	end, fin, flÃ¨che, Ã©tiquette Â« END Â» et flÃ¨che
ğŸ”›	en marche, flÃ¨che, on, Ã©tiquette Â« ON! Â» et flÃ¨che
ğŸ”œ	bientÃ´t, flÃ¨che, soon, Ã©tiquette Â« SOON Â» et flÃ¨che
ğŸ”	dessus, flÃ¨che, haut, top, Ã©tiquette Â« TOP Â» et flÃ¨che
â˜¦ï¸	chrÃ©tien, croix, orthodoxe, rÃ©ligion
â˜ªï¸	croissant, islam, musulman, religion, Ã©toile, Ã©toile et croissant de lune
ğŸ•	chandelier, menora, religion
ğŸ”¯	6 branches, fortune, six branches, Ã©toile, Ã©toile Ã  6 branches et point au milieu
â™ˆï¸	BÃ©lier zodiaque, bÃ©lier, zodiaque
â™‰ï¸	Taureau, zodiaque
â™Šï¸	GÃ©meaux, zodiaque
â™‹ï¸	Cancer, zodiaque
â™Œï¸	Lion, zodiaque
â™ï¸	Vierge, zodiaque
â™ï¸	Balance, zodiaque
â™ï¸	Scorpion, Scorpion zodiaque, zodiaque
â™ï¸	Sagittaire, zodiaque
â™‘ï¸	Capricorne, zodiaque
â™’ï¸	Verseau, zodiaque
â™“ï¸	Poissons, zodiaque
â›	Serpentaire, zodiaque
ğŸ”€	alÃ©atoire, bouton de lecture alÃ©atoire, croisÃ©es, flÃ¨ches
ğŸ”	bouton de rÃ©pÃ©tition, flÃ¨ches, horaire, rÃ©pÃ©ter, rÃ©pÃ©tition, sens des aiguilles dâ€™une montre
ğŸ”‚	bouton de rÃ©pÃ©tition unique, flÃ¨ches, horaire, rÃ©pÃ©ter une fois, rÃ©pÃ©tition unique, sens des aiguilles dâ€™une montre
â–¶	bouton de lecture
â©	avance rapide, bouton dâ€™avance rapide, double, flÃ¨ches, rapide
â­	flÃ¨ches, piste suivante, suivant, triangle
â¯	droite, flÃ¨che, lecture, pause, triangle
â—€	bouton de retour
âª	bouton de retour rapide, double, flÃ¨ches, rapide, rembobiner, retour rapide
â®	flÃ¨ches, piste prÃ©cÃ©dente, prÃ©cÃ©dent, triangle
ğŸ”¼	bouton vers le haut, flÃ¨che, haut, triangle
â«	accÃ¨s rapide vers le haut, bouton dâ€™accÃ¨s rapide vers le haut, double, flÃ¨che, triangle
ğŸ”½	bas, bouton vers le bas, flÃ¨che, triangle
â¬	accÃ¨s rapide vers le bas, bouton dâ€™accÃ¨s rapide vers le bas, double, flÃ¨che, triangle
â¸ï¸	barres, double, pause, vertical
â¹ï¸	bouton, carrÃ©, stop
âºï¸	bouton, cercle, enregistrement
ğŸ”…	faible, luminositÃ©
ğŸ”†	luminositÃ©, Ã©levÃ©e
ğŸ“¶	barres de signal
ğŸ“³	cellulaire, mobile, mode, mode vibration, tÃ©lÃ©phone, vibration
ğŸ“´	cellulaire, mobile, tÃ©lÃ©phone, tÃ©lÃ©phone cellulaire Ã©teint, Ã©teint
âš•ï¸	symbole la mÃ©decine
â™»ï¸	recyclage, symbole de recyclage
ğŸ”°	chevron, dÃ©butant, feuille, japonais, symbole, symbole japonais du dÃ©butant
â­•ï¸	cercle, grand, o, rouge
âœ”ï¸	coche, coche noire, marque
âœ–ï¸	*, annuler, multiplier, non, signe de multiplication, x, Ã—
âŒ	annuler, croix, multiplication, multiplier, x
â•	+, addition, arithmÃ©tique, mathÃ©matiques, plus, signe dâ€™addition
â–	-, arithmÃ©tique, mathÃ©matiques, moins, signe de soustraction, soustraction, âˆ’
â—	/, arithmÃ©tique, division, mathÃ©matiques, signe de division, Ã·
ã€½ï¸	dÃ©but de la musique, japonais, marque, partition, symbole, symbole japonais indiquant le dÃ©but de la musique
âœ³ï¸	astÃ©rique, astÃ©rique Ã  huit branches, huit branches
âœ´ï¸	huit branches, Ã©toile, Ã©toile Ã  huit branches
â€¼ï¸	double, point dâ€™exclamation, ponctuation
â‰ï¸	point dâ€™exclamation, point dâ€™interrogation, ponctuation, question
â“ï¸	point dâ€™interrogation, ponctuation, question
â”	point dâ€™interrogation, point dâ€™interrogation blanc, ponctuation, question
â•	point dâ€™exclamation, point dâ€™exclamation blanc, ponctuation, question
Â©ï¸	copyright
â„¢ï¸	marque de commerce, marque dÃ©posÃ©e, md
#âƒ£	dessus de touche, dessus de toucheÂ : #
*âƒ£	dessus de touche, dessus de toucheÂ : *
0âƒ£	dessus de touche, dessus de toucheÂ : 0
1âƒ£	dessus de touche, dessus de toucheÂ : 1
2âƒ£	dessus de touche, dessus de toucheÂ : 2
3âƒ£	dessus de touche, dessus de toucheÂ : 3
4âƒ£	dessus de touche, dessus de toucheÂ : 4
5âƒ£	dessus de touche, dessus de toucheÂ : 5
6âƒ£	dessus de touche, dessus de toucheÂ : 6
7âƒ£	dessus de touche, dessus de toucheÂ : 7
8âƒ£	dessus de touche, dessus de toucheÂ : 8
9âƒ£	dessus de touche, dessus de toucheÂ : 9
ğŸ”Ÿ	dessus de touche, dessus de toucheÂ : 10
ğŸ” 	ABCD, latin, lettres, majuscules, saisie
ğŸ”¡	abcd, latin, lettres, minuscules, saisie
ğŸ”¢	1234, chiffres, nombres, saisie
ğŸ”£	saisie, symboles, ã€’â™ª&%
ğŸ”¤	abc, alphabet, latin, lettres, saisie
ğŸ…°ï¸	a, groupe sanguin
ğŸ†	ab, groupe sanguin
ğŸ…±ï¸	ab, groupe sanguin
ğŸ†‘	cl, effacer
ğŸ†’	cool
ğŸ†“	free
â„¹ï¸	i, informations
ğŸ†”	id, identitfiant, identitÃ©
ğŸ†•	new, nouveau
ğŸ†–	NG, interdit, no go, not good, pas bon
ğŸ…¾ï¸	groupe sanguin, o
ğŸ†—	OK
ğŸ…¿ï¸	icÃ´ne Stationnement, parking, stationnement
ğŸ†˜	SOS, aide, secours
ğŸ†™	icÃ´ne UP!, nouveau, nouveautÃ©, up
ğŸ†š	c., contre, vs
ğŸˆ	ici, japonais, katakana, symbole japonais signifiant Â«Â iciÂ Â», ã‚³ã‚³
ğŸˆ‚ï¸	japonais, katakana, payant, service, symbole japonais signifiant Â«Â serviceÂ Â» ou Â«Â service payantÂ Â», ã‚µ
ğŸˆ·	idÃ©ogramme, japonais, montant mensuel, symbole japonais signifiant Â«Â montant mensuelÂ Â», æœˆ
ğŸˆ¶	idÃ©ogramme, japonais, payant, symbole japonais signifiant Â«Â payantÂ Â», æœ‰
ğŸˆ¯	idÃ©ogramme, japonais, rÃ©servÃ©, symbole japonais signifiant Â«Â rÃ©servÃ©Â Â», æŒ‡
ğŸ‰	aubaine, idÃ©ogramme, japonais, symbole japonais signifiant Â«Â aubaineÂ Â», æŒ‡
ğŸˆ¹	idÃ©ogramme, japonais, rabais, symbole japonais signifiant Â«Â rabaisÂ Â», å‰²
ğŸˆš	gratuit, idÃ©ogramme, japonais, symbole japonais signifiant Â«Â gratuitÂ Â», ç„¡
ğŸˆ²	idÃ©ogramme, interdit, japonais, symbole japonais signifiant Â«Â interditÂ Â», ç¦
ğŸ‰‘	acceptable, idÃ©ogramme, japonais, symbole japonais signifiant Â«Â acceptableÂ Â», å¯
ğŸˆ¸	application, idÃ©ogramme, japonais, symbole japonais signifiant Â«Â applicationÂ Â», ç”³
ğŸˆ´	idÃ©ogramme, japonais, note de passage, symbole japonais signifiant Â«Â note de passageÂ Â», åˆ
ğŸˆ³	idÃ©ogramme, japonais, places disponibles, symbole japonais signifiant Â«Â places disponiblesÂ Â», ç©º
ãŠ—ï¸	fÃ©licitations, idÃ©ogramme, japonais, symbole japonais signifiant Â«Â fÃ©licitationsÂ Â», ç¥
ãŠ™ï¸	idÃ©ogramme, japonais, secret, symbole japonais signifiant Â«Â secretÂ Â», ç§˜
ğŸˆº	idÃ©ogramme, japonais, ouvert, symbole japonais signifiant Â«Â ouvertÂ Â», å–¶
ğŸˆµ	complet, idÃ©ogramme, japonais, symbole japonais signifiant Â«Â completÂ Â», æº€
ğŸ”´	cercle, gÃ©omÃ©trie, rond, rouge, sphÃ¨re
ğŸŸ 	cercle orange
ğŸŸ¡	cercle jaune
ğŸŸ¢	cercle vert
ğŸ”µ	rond bleu
ğŸŸ£	cercle violet
ğŸŸ¤	cercle brun
âš«ï¸	rond noir
âšªï¸	rond blanc
ğŸŸ¥	carrÃ©, rouge
ğŸŸ§	carrÃ©, orange
ğŸŸ¨	carrÃ©, jaune
ğŸŸ©	carrÃ©, vert
ğŸŸ¦	bleu, carrÃ©
ğŸŸª	carrÃ©, violet
ğŸŸ«	carrÃ© brun
â—¼ï¸	carrÃ© noir de taille moyenne, forme, gÃ©omÃ©trie
â—»ï¸	carrÃ© blanc de taille moyenne, forme, gÃ©omÃ©trie
â—¾ï¸	carrÃ© noir de taille intermÃ©diaire, forme, gÃ©omÃ©trie
â—½ï¸	carrÃ© blanc de taille intermÃ©diaire, forme, gÃ©omÃ©trie
ğŸ”¶	grand losange, gÃ©omÃ©trie, orange
ğŸ”·	bleu, grand losange, gÃ©omÃ©trie
ğŸ”¸	gÃ©omÃ©trie, orange, petit losange
ğŸ”¹	bleu, gÃ©omÃ©trie, petit losange
ğŸ”º	gÃ©omÃ©trie, rouge, triangle qui pointe vers le haut, triangle rouge qui pointe vers le haut
ğŸ”»	gÃ©omÃ©trie, rouge, triangle qui pointe vers le bas, triangle rouge qui pointe vers le bas
ğŸ”³	bouton, bouton reprÃ©sentant un carrÃ© blanc, carrÃ© blanc, gÃ©omÃ©trie
ğŸ”²	bouton, bouton reprÃ©sentant un carrÃ© noir, carrÃ© noir, gÃ©omÃ©trie
ğŸ‡¦ğŸ‡¨	drapeauÂ : Ã®le de lâ€™Ascension
ğŸ‡¦ğŸ‡©	drapeauÂ : Andorre
ğŸ‡¦ğŸ‡ª	drapeauÂ : Ã‰mirats arabes unis
ğŸ‡¦ğŸ‡«	drapeauÂ : Afghanistan
ğŸ‡¦ğŸ‡¬	drapeauÂ : Antigua-et-Barbuda
ğŸ‡¦ğŸ‡®	drapeauÂ : Anguilla
ğŸ‡¦ğŸ‡±	drapeauÂ : Albanie
ğŸ‡¦ğŸ‡²	drapeauÂ : ArmÃ©nie
ğŸ‡¦ğŸ‡´	drapeauÂ : Angola
ğŸ‡¦ğŸ‡¶	drapeauÂ : Antarctique
ğŸ‡¦ğŸ‡·	drapeauÂ : Argentine
ğŸ‡¦ğŸ‡¸	drapeauÂ : Samoa amÃ©ricaines
ğŸ‡¦ğŸ‡¹	drapeauÂ : Autriche
ğŸ‡¦ğŸ‡º	drapeauÂ : Australie
ğŸ‡¦ğŸ‡¼	drapeauÂ : Aruba
ğŸ‡¦ğŸ‡½	drapeauÂ : Ã®les dâ€™Ã…land
ğŸ‡¦ğŸ‡¿	drapeauÂ : AzerbaÃ¯djan
ğŸ‡§ğŸ‡¦	drapeauÂ : Bosnie-HerzÃ©govine
ğŸ‡§ğŸ‡§	drapeauÂ : Barbade
ğŸ‡§ğŸ‡©	drapeauÂ : Bangladesh
ğŸ‡§ğŸ‡ª	drapeauÂ : Belgique
ğŸ‡§ğŸ‡«	drapeauÂ : Burkina Faso
ğŸ‡§ğŸ‡¬	drapeauÂ : Bulgarie
ğŸ‡§ğŸ‡­	drapeauÂ : BahreÃ¯n
ğŸ‡§ğŸ‡®	drapeauÂ : Burundi
ğŸ‡§ğŸ‡¯	drapeauÂ : BÃ©nin
ğŸ‡§ğŸ‡±	drapeauÂ : Saint-BarthÃ©lemy
ğŸ‡§ğŸ‡²	drapeauÂ : Bermudes
ğŸ‡§ğŸ‡³	drapeauÂ : Brunei
ğŸ‡§ğŸ‡´	drapeauÂ : Bolivie
ğŸ‡§ğŸ‡¶	drapeauÂ : Pays-Bas caribÃ©ens
ğŸ‡§ğŸ‡·	drapeauÂ : BrÃ©sil
ğŸ‡§ğŸ‡¸	drapeauÂ : Bahamas
ğŸ‡§ğŸ‡¹	drapeauÂ : Bhoutan
ğŸ‡§ğŸ‡»	drapeauÂ : Ã®le Bouvet
ğŸ‡§ğŸ‡¼	drapeauÂ : Botswana
ğŸ‡§ğŸ‡¾	drapeauÂ : BÃ©larus
ğŸ‡§ğŸ‡¿	drapeauÂ : Belize
ğŸ‡¨ğŸ‡¦	drapeauÂ : Canada
ğŸ‡¨ğŸ‡¨	drapeauÂ : Ã®les Cocos (Keeling)
ğŸ‡¨ğŸ‡©	drapeauÂ : Congo-Kinshasa
ğŸ‡¨ğŸ‡«	drapeauÂ : RÃ©publique centrafricaine
ğŸ‡¨ğŸ‡¬	drapeauÂ : Congo-Brazzaville
ğŸ‡¨ğŸ‡­	drapeauÂ : Suisse
ğŸ‡¨ğŸ‡®	drapeauÂ : CÃ´te dâ€™Ivoire
ğŸ‡¨ğŸ‡°	drapeauÂ : Ã®les Cook
ğŸ‡¨ğŸ‡±	drapeauÂ : Chili
ğŸ‡¨ğŸ‡²	drapeauÂ : Cameroun
ğŸ‡¨ğŸ‡³	drapeauÂ : Chine
ğŸ‡¨ğŸ‡´	drapeauÂ : Colombie
ğŸ‡¨ğŸ‡µ	drapeauÂ : Ãle Clipperton
ğŸ‡¨ğŸ‡·	drapeauÂ : Costa Rica
ğŸ‡¨ğŸ‡º	drapeauÂ : Cuba
ğŸ‡¨ğŸ‡»	drapeauÂ : Cap-Vert
ğŸ‡¨ğŸ‡¼	drapeauÂ : CuraÃ§ao
ğŸ‡¨ğŸ‡½	drapeauÂ : Ã®le Christmas
ğŸ‡¨ğŸ‡¾	drapeauÂ : Chypre
ğŸ‡¨ğŸ‡¿	drapeauÂ : TchÃ©quie
ğŸ‡©ğŸ‡ª	drapeauÂ : Allemagne
ğŸ‡©ğŸ‡¬	drapeauÂ : Diego Garcia
ğŸ‡©ğŸ‡¯	drapeauÂ : Djibouti
ğŸ‡©ğŸ‡°	drapeauÂ : Danemark
ğŸ‡©ğŸ‡²	drapeauÂ : Dominique
ğŸ‡©ğŸ‡´	drapeauÂ : RÃ©publique dominicaine
ğŸ‡©ğŸ‡¿	drapeauÂ : AlgÃ©rie
ğŸ‡ªğŸ‡¦	drapeauÂ : Ceuta et Melilla
ğŸ‡ªğŸ‡¨	drapeauÂ : Ã‰quateur
ğŸ‡ªğŸ‡ª	drapeauÂ : Estonie
ğŸ‡ªğŸ‡¬	drapeauÂ : Ã‰gypte
ğŸ‡ªğŸ‡­	drapeauÂ : Sahara occidental
ğŸ‡ªğŸ‡·	drapeauÂ : Ã‰rythrÃ©e
ğŸ‡ªğŸ‡¸	drapeauÂ : Espagne
ğŸ‡ªğŸ‡¹	drapeauÂ : Ã‰thiopie
ğŸ‡ªğŸ‡º	drapeauÂ : Union europÃ©enne
ğŸ‡«ğŸ‡®	drapeauÂ : Finlande
ğŸ‡«ğŸ‡¯	drapeauÂ : Fidji
ğŸ‡«ğŸ‡°	drapeauÂ : Ã®les Malouines
ğŸ‡«ğŸ‡²	drapeauÂ : MicronÃ©sie
ğŸ‡«ğŸ‡´	drapeauÂ : Ã®les FÃ©roÃ©
ğŸ‡«ğŸ‡·	drapeauÂ : France
ğŸ‡¬ğŸ‡¦	drapeauÂ : Gabon
ğŸ‡¬ğŸ‡§	drapeauÂ : Royaume-Uni
ğŸ‡¬ğŸ‡©	drapeauÂ : Grenade
ğŸ‡¬ğŸ‡ª	drapeauÂ : GÃ©orgie
ğŸ‡¬ğŸ‡«	drapeauÂ : Guyane franÃ§aise
ğŸ‡¬ğŸ‡¬	drapeauÂ : Guernesey
ğŸ‡¬ğŸ‡­	drapeauÂ : Ghana
ğŸ‡¬ğŸ‡®	drapeauÂ : Gibraltar
ğŸ‡¬ğŸ‡±	drapeauÂ : Groenland
ğŸ‡¬ğŸ‡²	drapeauÂ : Gambie
ğŸ‡¬ğŸ‡³	drapeauÂ : GuinÃ©e
ğŸ‡¬ğŸ‡µ	drapeauÂ : Guadeloupe
ğŸ‡¬ğŸ‡¶	drapeauÂ : GuinÃ©e Ã©quatoriale
ğŸ‡¬ğŸ‡·	drapeauÂ : GrÃ¨ce
ğŸ‡¬ğŸ‡¸	drapeauÂ : GÃ©orgie du Sud et Ã®les Sandwich du Sud
ğŸ‡¬ğŸ‡¹	drapeauÂ : Guatemala
ğŸ‡¬ğŸ‡º	drapeauÂ : Guam
ğŸ‡¬ğŸ‡¼	drapeauÂ : GuinÃ©e-Bissau
ğŸ‡¬ğŸ‡¾	drapeauÂ : Guyana
ğŸ‡­ğŸ‡°	drapeauÂ : R.A.S. chinoise de Hong Kong
ğŸ‡­ğŸ‡²	drapeauÂ : Ã®les Heard et McDonald
ğŸ‡­ğŸ‡³	drapeauÂ : Honduras
ğŸ‡­ğŸ‡·	drapeauÂ : Croatie
ğŸ‡­ğŸ‡¹	drapeauÂ : HaÃ¯ti
ğŸ‡­ğŸ‡º	drapeauÂ : Hongrie
ğŸ‡®ğŸ‡¨	drapeauÂ : Ã®les Canaries
ğŸ‡®ğŸ‡©	drapeauÂ : IndonÃ©sie
ğŸ‡®ğŸ‡ª	drapeauÂ : Irlande
ğŸ‡®ğŸ‡±	drapeauÂ : IsraÃ«l
ğŸ‡®ğŸ‡²	drapeauÂ : Ã®le de Man
ğŸ‡®ğŸ‡³	drapeauÂ : Inde
ğŸ‡®ğŸ‡´	drapeauÂ : territoire britannique de lâ€™ocÃ©an Indien
ğŸ‡®ğŸ‡¶	drapeauÂ : Irak
ğŸ‡®ğŸ‡·	drapeauÂ : Iran
ğŸ‡®ğŸ‡¸	drapeauÂ : Islande
ğŸ‡®ğŸ‡¹	drapeauÂ : Italie
ğŸ‡¯ğŸ‡ª	drapeauÂ : Jersey
ğŸ‡¯ğŸ‡²	drapeauÂ : JamaÃ¯que
ğŸ‡¯ğŸ‡´	drapeauÂ : Jordanie
ğŸ‡¯ğŸ‡µ	drapeauÂ : Japon
ğŸ‡°ğŸ‡ª	drapeauÂ : Kenya
ğŸ‡°ğŸ‡¬	drapeauÂ : Kirghizistan
ğŸ‡°ğŸ‡­	drapeauÂ : Cambodge
ğŸ‡°ğŸ‡®	drapeauÂ : Kiribati
ğŸ‡°ğŸ‡²	drapeauÂ : Comores
ğŸ‡°ğŸ‡³	drapeauÂ : Saint-Christophe-et-NiÃ©vÃ¨s
ğŸ‡°ğŸ‡µ	drapeauÂ : CorÃ©e du Nord
ğŸ‡°ğŸ‡·	drapeauÂ : CorÃ©e du Sud
ğŸ‡°ğŸ‡¼	drapeauÂ : KoweÃ¯t
ğŸ‡°ğŸ‡¾	drapeauÂ : Ãles CaÃ¯mans
ğŸ‡°ğŸ‡¿	drapeauÂ : Kazakhstan
ğŸ‡±ğŸ‡¦	drapeauÂ : Laos
ğŸ‡±ğŸ‡§	drapeauÂ : Liban
ğŸ‡±ğŸ‡¨	drapeauÂ : Sainte-Lucie
ğŸ‡±ğŸ‡®	drapeauÂ : Liechtenstein
ğŸ‡±ğŸ‡°	drapeauÂ : Sri Lanka
ğŸ‡±ğŸ‡·	drapeauÂ : LibÃ©ria
ğŸ‡±ğŸ‡¸	drapeauÂ : Lesotho
ğŸ‡±ğŸ‡¹	drapeauÂ : Lituanie
ğŸ‡±ğŸ‡º	drapeauÂ : Luxembourg
ğŸ‡±ğŸ‡»	drapeauÂ : Lettonie
ğŸ‡±ğŸ‡¾	drapeauÂ : Libye
ğŸ‡²ğŸ‡¦	drapeauÂ : Maroc
ğŸ‡²ğŸ‡¨	drapeauÂ : Monaco
ğŸ‡²ğŸ‡©	drapeauÂ : Moldavie
ğŸ‡²ğŸ‡ª	drapeauÂ : MontÃ©nÃ©gro
ğŸ‡²ğŸ‡«	drapeauÂ : Saint-Martin (France)
ğŸ‡²ğŸ‡¬	drapeauÂ : Madagascar
ğŸ‡²ğŸ‡­	drapeauÂ : Ãles Marshall
ğŸ‡²ğŸ‡°	drapeauÂ : MacÃ©doine
ğŸ‡²ğŸ‡±	drapeauÂ : Mali
ğŸ‡²ğŸ‡²	drapeauÂ : Myanmar
ğŸ‡²ğŸ‡³	drapeauÂ : Mongolie
ğŸ‡²ğŸ‡´	drapeauÂ : R.A.S. chinoise de Macao
ğŸ‡²ğŸ‡µ	drapeauÂ : Mariannes du Nord
ğŸ‡²ğŸ‡¶	drapeauÂ : Martinique
ğŸ‡²ğŸ‡·	drapeauÂ : Mauritanie
ğŸ‡²ğŸ‡¸	drapeauÂ : Montserrat
ğŸ‡²ğŸ‡¹	drapeauÂ : Malte
ğŸ‡²ğŸ‡º	drapeauÂ : Maurice
ğŸ‡²ğŸ‡»	drapeauÂ : Maldives
ğŸ‡²ğŸ‡¼	drapeauÂ : Malawi
ğŸ‡²ğŸ‡½	drapeauÂ : Mexique
ğŸ‡²ğŸ‡¾	drapeauÂ : Malaisie
ğŸ‡²ğŸ‡¿	drapeauÂ : Mozambique
ğŸ‡³ğŸ‡¦	drapeauÂ : Namibie
ğŸ‡³ğŸ‡¨	drapeauÂ : Nouvelle-CalÃ©donie
ğŸ‡³ğŸ‡ª	drapeauÂ : Niger
ğŸ‡³ğŸ‡«	drapeauÂ : Ã®le Norfolk
ğŸ‡³ğŸ‡¬	drapeauÂ : NigÃ©ria
ğŸ‡³ğŸ‡®	drapeauÂ : Nicaragua
ğŸ‡³ğŸ‡±	drapeauÂ : Pays-Bas
ğŸ‡³ğŸ‡´	drapeauÂ : NorvÃ¨ge
ğŸ‡³ğŸ‡µ	drapeauÂ : NÃ©pal
ğŸ‡³ğŸ‡·	drapeauÂ : Nauru
ğŸ‡³ğŸ‡º	drapeauÂ : Niue
ğŸ‡³ğŸ‡¿	drapeauÂ : Nouvelle-ZÃ©lande
ğŸ‡´ğŸ‡²	drapeauÂ : Oman
ğŸ‡µğŸ‡¦	drapeauÂ : Panama
ğŸ‡µğŸ‡ª	drapeauÂ : PÃ©rou
ğŸ‡µğŸ‡«	drapeauÂ : PolynÃ©sie franÃ§aise
ğŸ‡µğŸ‡¬	drapeauÂ : Papouasie-Nouvelle-GuinÃ©e
ğŸ‡µğŸ‡­	drapeauÂ : Philippines
ğŸ‡µğŸ‡°	drapeauÂ : Pakistan
ğŸ‡µğŸ‡±	drapeauÂ : Pologne
ğŸ‡µğŸ‡²	drapeauÂ : Saint-Pierre-et-Miquelon
ğŸ‡µğŸ‡³	drapeauÂ : Ã®les Pitcairn
ğŸ‡µğŸ‡·	drapeauÂ : Porto Rico
ğŸ‡µğŸ‡¸	drapeauÂ : Territoires palestiniens
ğŸ‡µğŸ‡¹	drapeauÂ : Portugal
ğŸ‡µğŸ‡¼	drapeauÂ : Palaos
ğŸ‡µğŸ‡¾	drapeauÂ : Paraguay
ğŸ‡¶ğŸ‡¦	drapeauÂ : Qatar
ğŸ‡·ğŸ‡ª	drapeauÂ : la RÃ©union
ğŸ‡·ğŸ‡´	drapeauÂ : Roumanie
ğŸ‡·ğŸ‡¸	drapeauÂ : Serbie
ğŸ‡·ğŸ‡º	drapeauÂ : Russie
ğŸ‡·ğŸ‡¼	drapeauÂ : Rwanda
ğŸ‡¸ğŸ‡¦	drapeauÂ : Arabie saoudite
ğŸ‡¸ğŸ‡§	drapeauÂ : Ãles Salomon
ğŸ‡¸ğŸ‡¨	drapeauÂ : Seychelles
ğŸ‡¸ğŸ‡©	drapeauÂ : Soudan
ğŸ‡¸ğŸ‡ª	drapeauÂ : SuÃ¨de
ğŸ‡¸ğŸ‡¬	drapeauÂ : Singapour
ğŸ‡¸ğŸ‡­	drapeauÂ : Sainte-HÃ©lÃ¨ne
ğŸ‡¸ğŸ‡®	drapeauÂ : SlovÃ©nie
ğŸ‡¸ğŸ‡¯	drapeauÂ : Svalbard et Jan Mayen
ğŸ‡¸ğŸ‡°	drapeauÂ : Slovaquie
ğŸ‡¸ğŸ‡±	drapeauÂ : Sierra Leone
ğŸ‡¸ğŸ‡²	drapeauÂ : Saint-Marin
ğŸ‡¸ğŸ‡³	drapeauÂ : SÃ©nÃ©gal
ğŸ‡¸ğŸ‡´	drapeauÂ : Somalie
ğŸ‡¸ğŸ‡·	drapeauÂ : Suriname
ğŸ‡¸ğŸ‡¸	drapeauÂ : Soudan du Sud
ğŸ‡¸ğŸ‡¹	drapeauÂ : Sao TomÃ©-et-Principe
ğŸ‡¸ğŸ‡»	drapeauÂ : Salvador
ğŸ‡¸ğŸ‡½	drapeauÂ : Saint-Martin (Pays-Bas)
ğŸ‡¸ğŸ‡¾	drapeauÂ : Syrie
ğŸ‡¸ğŸ‡¿	drapeauÂ : Eswatini
ğŸ‡¹ğŸ‡¦	drapeauÂ : Tristan da Cunha
ğŸ‡¹ğŸ‡¨	drapeauÂ : Ãles Turques-et-CaÃ¯ques
ğŸ‡¹ğŸ‡©	drapeauÂ : Tchad
ğŸ‡¹ğŸ‡«	drapeauÂ : Terres australes franÃ§aises
ğŸ‡¹ğŸ‡¬	drapeauÂ : Togo
ğŸ‡¹ğŸ‡­	drapeauÂ : ThaÃ¯lande
ğŸ‡¹ğŸ‡¯	drapeauÂ : Tadjikistan
ğŸ‡¹ğŸ‡°	drapeauÂ : Tokelau
ğŸ‡¹ğŸ‡±	drapeauÂ : Timor-Leste
ğŸ‡¹ğŸ‡²	drapeauÂ : TurkmÃ©nistan
ğŸ‡¹ğŸ‡³	drapeauÂ : Tunisie
ğŸ‡¹ğŸ‡´	drapeauÂ : Tonga
ğŸ‡¹ğŸ‡·	drapeauÂ : Turquie
ğŸ‡¹ğŸ‡¹	drapeauÂ : TrinitÃ©-et-Tobago
ğŸ‡¹ğŸ‡»	drapeauÂ : Tuvalu
ğŸ‡¹ğŸ‡¼	drapeauÂ : TaÃ¯wan
ğŸ‡¹ğŸ‡¿	drapeauÂ : Tanzanie
ğŸ‡ºğŸ‡¦	drapeauÂ : Ukraine
ğŸ‡ºğŸ‡¬	drapeauÂ : Ouganda
ğŸ‡ºğŸ‡²	drapeauÂ : Ã®les mineures Ã©loignÃ©es des Ã‰tats-Unis
ğŸ‡ºğŸ‡³	drapeauÂ : Nations Unies
ğŸ‡ºğŸ‡¸	drapeauÂ : Ã‰tats-Unis
ğŸ‡ºğŸ‡¾	drapeauÂ : Uruguay
ğŸ‡ºğŸ‡¿	drapeauÂ : OuzbÃ©kistan
ğŸ‡»ğŸ‡¦	drapeauÂ : CitÃ© du Vatican
ğŸ‡»ğŸ‡¨	drapeauÂ : Saint-Vincent-et-les Grenadines
ğŸ‡»ğŸ‡ª	drapeauÂ : Venezuela
ğŸ‡»ğŸ‡¬	drapeauÂ : Ã®les Vierges britanniques
ğŸ‡»ğŸ‡®	drapeauÂ : Ã®les Vierges amÃ©ricaines
ğŸ‡»ğŸ‡³	drapeauÂ : Vietnam
ğŸ‡»ğŸ‡º	drapeauÂ : Vanuatu
ğŸ‡¼ğŸ‡«	drapeauÂ : Wallis-et-Futuna
ğŸ‡¼ğŸ‡¸	drapeauÂ : Samoa
ğŸ‡½ğŸ‡°	drapeauÂ : Kosovo
ğŸ‡¾ğŸ‡ª	drapeauÂ : YÃ©men
ğŸ‡¾ğŸ‡¹	drapeauÂ : Mayotte
ğŸ‡¿ğŸ‡¦	drapeauÂ : Afrique du Sud
ğŸ‡¿ğŸ‡²	drapeauÂ : Zambie
ğŸ‡¿ğŸ‡¼	drapeauÂ : Zimbabwe
ğŸ´ó §ó ¢ó ¥ó ®ó §ó ¿	drapeauÂ : Angleterre
ğŸ´ó §ó ¢ó ³ó £ó ´ó ¿	drapeauÂ : Ã‰cosse
ğŸ´ó §ó ¢ó ·ó ¬ó ³ó ¿	drapeauÂ : Pays de Galles
ğŸ»	peau claire
ğŸ¼	peau, peau modÃ©rÃ©ment claire, type 3
ğŸ½	peau lÃ©gÃ¨rement mate
ğŸ¾	peau, peau modÃ©rÃ©ment foncÃ©e, type 5
ğŸ¿	peau foncÃ©e
