ğŸ˜€	fjes, glis, glisefjes
ğŸ˜ƒ	fjes, glisende fjes med vidÃ¥pne Ã¸yne, latter, munn, smil, smilefjes, smilefjes med Ã¥pen munn, Ã¥pen
ğŸ˜„	latter, med tenner, morsomt, smil, smilefjes, smilefjes med Ã¥pen munn og smilende Ã¸yne
ğŸ˜	fjes, glis, glisefjes med smilende Ã¸yne, latter, lol, smil, smilefjes
ğŸ˜†	fjes, latter, smil med sammenknepne Ã¸yne, Ã¥pen munn
ğŸ˜…	glisende fjes som svetter, kaldsvette, munn, smil med svette, svett smil med Ã¥pen munn, Ã¥pen
ğŸ¤£	fjes, gulv, latter, ruller, ruller rundt pÃ¥ gulvet i latter
ğŸ˜‚	fjes, fjes med gledestÃ¥rer, glede, gledestÃ¥rer, tÃ¥rer
ğŸ™‚	fjes, smil, smiler litt
ğŸ™ƒ	fjes, fjes som er opp-ned, opp-ned
ğŸ˜‰	blunk, blunkende ansikt, fjes
ğŸ˜Š	fjes, rÃ¸dme, smil, smil med smilende Ã¸yne, smilende Ã¸yne
ğŸ˜‡	engel, fjes, glorie, smil, smil med glorie, uskyldig
ğŸ¥°	elsker, forelsket, kjÃ¦rlighet, smilefjes med hjerter
ğŸ˜	fjes, hjerte, hjerteÃ¸yne, kjÃ¦rlighet, smilefjes med hjerteÃ¸yne, Ã¸yne
ğŸ¤©	fjes, gliser, smil, stjerner, stjerner i Ã¸ynene
ğŸ˜˜	elsker deg, fjes, glad i deg, hjerte, kyss, slengkyss
ğŸ˜—	elsker deg, fjes, glad i deg, kyss, kyssefjes, slengkyss
â˜ºï¸	fjes, omriss, smil, smilefjes
ğŸ˜š	elsker deg, fjes, glad i deg, kyss, kyss med lukkede Ã¸yne, lukkede Ã¸yne, trutmunn
ğŸ˜™	fjes, kyss, kyss med smilende Ã¸yne, slengkyss, smil, smilende Ã¸yne
ğŸ˜‹	deilig mat, fjes, mmm, nam, nam-nam, sulten
ğŸ˜›	fjes, fjes som rekker tunge, rekker tunge, tungen ut
ğŸ˜œ	blunk, blunker og rekker tunge, erte, fjes, rekke tunge med blunk, spÃ¸k
ğŸ¤ª	fjes, gal, lite Ã¸ye, sinnssyk, stort Ã¸ye
ğŸ˜	fjes, fÃ¸lt, lukkende Ã¸yne, rekke tunge, tungen ut med Ã¸ynene lukket, Ã¦sj
ğŸ¤‘	fjes, munn, pengegal, penger
ğŸ¤—	fjes, fjes som gir klem, klem
ğŸ¤­	flire, hÃ¥nden over munnen, ops
ğŸ¤«	hysj, stillhet, vÃ¦r stille
ğŸ¤”	fjes, tankefull, tenkefjes, tenker
ğŸ¤	fjes, fjes med glidelÃ¥smunn, glidelÃ¥s, munn
ğŸ¤¨	hevet Ã¸yenbryn, skeptisk, tvil
ğŸ˜ï¸	fjes, ingen kommentar, nÃ¸ytral, stum
ğŸ˜‘	fjes, ingen kommentar, nÃ¸ytral, stum, uttrykkslÃ¸s
ğŸ˜¶	fjes, ingen munn, uten munn
ğŸ˜	fjes, lurt smil, selvtilfreds
ğŸ˜’	fjes, misfornÃ¸yd, sur
ğŸ™„	fjes, himler med Ã¸ynene, ruller, Ã¸yne
ğŸ˜¬	fjes, grimase
ğŸ¤¥	fjes, lyver, lÃ¸gn, pinocchio
ğŸ˜Œ	fjes, lettet
ğŸ˜”	alvorlig, fjes, lei seg, tankefull
ğŸ˜ª	fjes, sÃ¸vnig
ğŸ¤¤	fjes, sikle, sikler
ğŸ˜´	fjes, sovende fjes, sover, zzz
ğŸ˜·	bakteriemaske, fjes, fjes med munnbind, sykdom
ğŸ¤’	fjes, fjes med termometer, syk, termometer
ğŸ¤•	bandasje, bandasjert hode, fjes, skade, skadet
ğŸ¤¢	fjes, kvalm, oppkast, spy
ğŸ¤®	fjes, kaster opp, kvalm, oppkast, spy
ğŸ¤§	fjes, nys, nyser
ğŸ¥µ	feber, heteslag, rÃ¸d, svetter, varm, varmt fjes
ğŸ¥¶	blÃ¥, frost, fryser, istapper, kald, kaldt fjes
ğŸ¥´	brisen, bÃ¸lgete munn, full, svimmel, svimmelt fjes, ujevne Ã¸yne
ğŸ˜µ	fjes, svimmel, Ã¸r
ğŸ¤¯	eksploderende hode, forblÃ¸ffet, overrasket, sjokkert
ğŸ¤ 	cowboy, cowgirl, fjes, fjes med cowboyhatt, hatt
ğŸ¥³	feiring, fest, flÃ¸yte, hatt, party, partyfjes
ğŸ˜	fjes, kul, lyst, smilefjes med solbriller, sol, solbriller
ğŸ¤“	fjes, nerd, nerdefjes
ğŸ§	fjes, fjes med monokkel, formell, monokkel, stiv
ğŸ˜•	fjes, forvirret
ğŸ˜Ÿ	bekymret, fjes
ğŸ™	fjes, litt surt fjes, trist
â˜¹ï¸	fjes, surt fjes, trist
ğŸ˜®	fjes, forbauset, Ã¥pen munn
ğŸ˜¯	fjes, overrasket, stum
ğŸ˜²	fjes, overrasket, sjokkert, stum
ğŸ˜³	fjes, rÃ¸d, rÃ¸dmer
ğŸ¥º	bedende fjes, nÃ¥de, trygler, valpeÃ¸yne
ğŸ˜¦	fjes, oppgitt, overrasket, sjokkert med Ã¥pen munn
ğŸ˜§	fjes, lider, pine, smerte
ğŸ˜¨	fjes, frykt, redd, skremt
ğŸ˜°	engstelig og svetter, fjes, kaldsvette, syk, Ã¥pen munn
ğŸ˜¥	fjes, lettet, puh!, skuffet
ğŸ˜¢	fjes, grÃ¥ter, trist, tÃ¥rer
ğŸ˜­	fjes, grÃ¥t, strigrÃ¥ter, tÃ¥rer
ğŸ˜±	fjes, frykt, livredd, munch, redd, skremt, skrik
ğŸ˜–	fjes, fortvilet, sint, skuffet
ğŸ˜£	bommert, fjes, skuffet, utholdende
ğŸ˜	fjes, skuffelse, skuffet
ğŸ˜“	ansikt, kaldsvette, kaldsvetter
ğŸ˜©	fjes, sliten, trÃ¸tt
ğŸ˜«	fjes, overtrÃ¸tt, sliten, sÃ¸vnig, trÃ¸tt fjes
ğŸ¥±	gjesp, gjespende fjes, kjedelig, sliten
ğŸ˜¤	fjes, jeg vant, triumf, triumferende
ğŸ˜¡	fjes, rasende, raseri, rÃ¸dt, sinna, sint, sur
ğŸ˜ 	fjes, raseri, sinna, sint, sur
ğŸ¤¬	banner, fjes, fjes med symboler over munnen, rasende, sensur
ğŸ˜ˆ	fjes, horn, smil, smilende djevel
ğŸ‘¿	djevel, fjes, sint djevel
ğŸ’€	dÃ¸d, dÃ¸dninghode, fjes, hodeskalle
â˜ ï¸	bein, dÃ¸d, dÃ¸dningehode, fjes, hodeskalle, monster
ğŸ’©	bÃ¦sj, bÃ¦sjeklatt, hundebÃ¦sj, kuruke
ğŸ¤¡	fjes, klovn, klovnefjes
ğŸ‘¹	eventyr, japansk ogre, japansk troll, ogre
ğŸ‘º	ansikt, eventyr, japansk troll, tengu
ğŸ‘»	eventyr, fjes, skapning, spÃ¸kelse
ğŸ‘½ï¸	UFO, fjes, romvesen, sci-fi, utenomjordisk
ğŸ‘¾	UFO, fjes, rommonster, sci-fi, utenomjordisk
ğŸ¤–	fjes, monster, robot
ğŸ˜º	fjes, katt, smil, smilende katt med Ã¥pen munn, Ã¥pen munn
ğŸ˜¸	fjes, flirende katt med smilende Ã¸yne, katt, smil
ğŸ˜¹	fjes, glede, gledestÃ¥rer, katt, katt med gledestÃ¥rer, kattefjes med gledestÃ¥rer, tÃ¥rer
ğŸ˜»	fjes, forelsket, hjerter, katt, kjÃ¦rlighet, smilende katt med hjerteÃ¸yne, Ã¸yne
ğŸ˜¼	fjes, ironisk, katt, katt med ironisk smil, smil
ğŸ˜½	fjes, katt, kyss, kyssende, kyssende katt, lukkede Ã¸yne
ğŸ™€	fjes, jÃ¸sses, katt, overrasket, sliten katt, slitent kattefjes
ğŸ˜¿	fjes, grÃ¥t, grÃ¥tende katt, trist katt, tÃ¥re
ğŸ˜¾	fjes, katt, sint, sur, surmulende katt
ğŸ™ˆ	ape, fjes, forbudt, ikke, ser ikke, ser ingenting ondt
ğŸ™‰	ape, fjes, forbudt, hÃ¸rer ikke, hÃ¸rer ingenting ondt, ikke
ğŸ™Š	ape, fjes, forbudt, holder munn, ikke, sier ikke, sier ingenting ondt
ğŸ’‹	kyss, kyssemerke, lepper, romantikk
ğŸ’Œ	brev, brev med hjerte, hjerte, kjÃ¦rlighesbrev, romantikk
ğŸ’˜	fÃ¸lelser, hjerte, hjerte med pil, kjÃ¦rlighet, pil
ğŸ’	bÃ¥nd, fÃ¸lelser, hjerte, hjerte med bÃ¥nd, valentine
ğŸ’–	fÃ¸lelser, kjÃ¦rlighet, skinnende, skinnende hjerte
ğŸ’—	fÃ¸lelser, kjÃ¦rlighet, nervÃ¸s, spent, voksende hjerte
ğŸ’“	bankende, bankende hjerte, fÃ¸lelser, hjerte, kjÃ¦rlighet
ğŸ’	fÃ¸lelser, hjerter, kjÃ¦rlighet, snurrende, snurrende hjerter, sÃ¸tt
ğŸ’•	elskere, fÃ¸lelser, kjÃ¦rlighet, to hjerter
ğŸ’Ÿ	hjerte, hjertedekorasjon
â£ï¸	tegn, tegnsetting, utrop, utropstegn, utropstegn med hjerte
ğŸ’”	brudd, fÃ¸lelser, hjerte, knust hjerte
â¤ï¸	hjerte, rÃ¸dt hjerte
ğŸ§¡	fÃ¸lelser, hjerte, oransje, oransje hjerte
ğŸ’›	fÃ¸lelser, gul, gult hjerte, hjerte
ğŸ’š	fÃ¸lelser, grÃ¸nn, grÃ¸nt hjerte, hjerte
ğŸ’™	blÃ¥, blÃ¥tt hjerte, fÃ¸lelser, hjerte
ğŸ’œ	fÃ¸lelser, hjerte, lilla, lilla hjerte
ğŸ¤	brun, brunt hjerte, hjerte
ğŸ–¤	hjerte, ond, svart, svart hjerte
ğŸ¤	hjerte, hvit, hvitt hjerte
ğŸ’¯	100, full pott, hundre poeng, poeng
ğŸ’¢	fÃ¸lelse, sinne, sinnesymbol, sint, tegneserie
ğŸ’¥	fÃ¸lelse, kollisjon, krasj, smell, tegneserie
ğŸ’«	se stjerner, stjerner, svimmel, tegneserie
ğŸ’¦	drÃ¥per, sprut, sprutende, svette, svettedrÃ¥per, tegneserie
ğŸ’¨	forsvinne, lÃ¸pe, stikker av, tegneserie
ğŸ•³ï¸	hull, hull i bakken
ğŸ’£ï¸	bombe, fÃ¸lelse, tegneserie
ğŸ’¬	ballong, boble, dialog, dialogboble, snakkeboble, tegneserie
ğŸ‘â€ğŸ—¨	snakkeboble, Ã¸ye, Ã¸ye i snakkeboble
ğŸ—¨ï¸	dialog, snakkeboble mot venstre, tale
ğŸ—¯ï¸	ballong, boble, sint, sint snakkeboble mot hÃ¸yre, sur
ğŸ’­	boble, tanke, tankeboble, tegneserie
ğŸ’¤	fÃ¸lelse, snorker, sover, soving, tegneserie, zzz
ğŸ‘‹	hÃ¥nd, vinke, vinkende hÃ¥nd, vinking
ğŸ‘‹ğŸ»	hudtype 1â€“2, hÃ¥nd, vinke, vinkende hÃ¥nd, vinkende hÃ¥nd: hudtype 1â€“2, vinking
ğŸ‘‹ğŸ¼	hudtype 3, hÃ¥nd, vinke, vinkende hÃ¥nd, vinkende hÃ¥nd: hudtype 3, vinking
ğŸ‘‹ğŸ½	hudtype 4, hÃ¥nd, vinke, vinkende hÃ¥nd, vinkende hÃ¥nd: hudtype 4, vinking
ğŸ‘‹ğŸ¾	hudtype 5, hÃ¥nd, vinke, vinkende hÃ¥nd, vinkende hÃ¥nd: hudtype 5, vinking
ğŸ‘‹ğŸ¿	hudtype 6, hÃ¥nd, vinke, vinkende hÃ¥nd, vinkende hÃ¥nd: hudtype 6, vinking
ğŸ¤š	hÃ¥nd, hÃ¥ndbak, lÃ¸ftet, lÃ¸ftet hÃ¥ndbak
ğŸ¤šğŸ»	hudtype 1â€“2, hÃ¥nd, hÃ¥ndbak, lÃ¸ftet, lÃ¸ftet hÃ¥ndbak: hudtype 1â€“2
ğŸ¤šğŸ¼	hudtype 3, hÃ¥nd, hÃ¥ndbak, lÃ¸ftet, lÃ¸ftet hÃ¥ndbak: hudtype 3
ğŸ¤šğŸ½	hudtype 4, hÃ¥nd, hÃ¥ndbak, lÃ¸ftet, lÃ¸ftet hÃ¥ndbak: hudtype 4
ğŸ¤šğŸ¾	hudtype 5, hÃ¥nd, hÃ¥ndbak, lÃ¸ftet, lÃ¸ftet hÃ¥ndbak: hudtype 5
ğŸ¤šğŸ¿	hudtype 6, hÃ¥nd, hÃ¥ndbak, lÃ¸ftet, lÃ¸ftet hÃ¥ndbak: hudtype 6
ğŸ–ï¸	finger, flat hÃ¥nd med spredte fingre, hÃ¥nd, spredt
ğŸ–ğŸ»	finger, flat hÃ¥nd med spredte fingre, flat hÃ¥nd med spredte fingre: hudtype 1â€“2, hudtype 1â€“2, hÃ¥nd, spredt
ğŸ–ğŸ¼	finger, flat hÃ¥nd med spredte fingre, flat hÃ¥nd med spredte fingre: hudtype 3, hudtype 3, hÃ¥nd, spredt
ğŸ–ğŸ½	finger, flat hÃ¥nd med spredte fingre, flat hÃ¥nd med spredte fingre: hudtype 4, hudtype 4, hÃ¥nd, spredt
ğŸ–ğŸ¾	finger, flat hÃ¥nd med spredte fingre, flat hÃ¥nd med spredte fingre: hudtype 5, hudtype 5, hÃ¥nd, spredt
ğŸ–ğŸ¿	finger, flat hÃ¥nd med spredte fingre, flat hÃ¥nd med spredte fingre: hudtype 6, hudtype 6, hÃ¥nd, spredt
âœ‹	flat hÃ¥nd, hevet hÃ¥nd, hÃ¥ndflate
âœ‹ğŸ»	flat hÃ¥nd, hevet hÃ¥nd, hevet hÃ¥nd: hudtype 1â€“2, hudtype 1â€“2, hÃ¥ndflate
âœ‹ğŸ¼	flat hÃ¥nd, hevet hÃ¥nd, hevet hÃ¥nd: hudtype 3, hudtype 3, hÃ¥ndflate
âœ‹ğŸ½	flat hÃ¥nd, hevet hÃ¥nd, hevet hÃ¥nd: hudtype 4, hudtype 4, hÃ¥ndflate
âœ‹ğŸ¾	flat hÃ¥nd, hevet hÃ¥nd, hevet hÃ¥nd: hudtype 5, hudtype 5, hÃ¥ndflate
âœ‹ğŸ¿	flat hÃ¥nd, hevet hÃ¥nd, hevet hÃ¥nd: hudtype 6, hudtype 6, hÃ¥ndflate
ğŸ––	Vulcan-hilsen, finger, hÃ¥nd, spock, vulcan
ğŸ––ğŸ»	Vulcan-hilsen, Vulcan-hilsen: hudtype 1â€“2, finger, hudtype 1â€“2, hÃ¥nd, spock, vulcan
ğŸ––ğŸ¼	Vulcan-hilsen, Vulcan-hilsen: hudtype 3, finger, hudtype 3, hÃ¥nd, spock, vulcan
ğŸ––ğŸ½	Vulcan-hilsen, Vulcan-hilsen: hudtype 4, finger, hudtype 4, hÃ¥nd, spock, vulcan
ğŸ––ğŸ¾	Vulcan-hilsen, Vulcan-hilsen: hudtype 5, finger, hudtype 5, hÃ¥nd, spock, vulcan
ğŸ––ğŸ¿	Vulcan-hilsen, Vulcan-hilsen: hudtype 6, finger, hudtype 6, hÃ¥nd, spock, vulcan
ğŸ‘Œ	OK, OK-hÃ¥nd, hÃ¥nd, tegn
ğŸ‘ŒğŸ»	OK, OK-hÃ¥nd, OK-hÃ¥nd: hudtype 1â€“2, hudtype 1â€“2, hÃ¥nd, tegn
ğŸ‘ŒğŸ¼	OK, OK-hÃ¥nd, OK-hÃ¥nd: hudtype 3, hudtype 3, hÃ¥nd, tegn
ğŸ‘ŒğŸ½	OK, OK-hÃ¥nd, OK-hÃ¥nd: hudtype 4, hudtype 4, hÃ¥nd, tegn
ğŸ‘ŒğŸ¾	OK, OK-hÃ¥nd, OK-hÃ¥nd: hudtype 5, hudtype 5, hÃ¥nd, tegn
ğŸ‘ŒğŸ¿	OK, OK-hÃ¥nd, OK-hÃ¥nd: hudtype 6, hudtype 6, hÃ¥nd, tegn
ğŸ¤	hÃ¥nd som klyper
ğŸ¤ğŸ»	hudtype 1â€“2, hÃ¥nd som klyper, hÃ¥nd som klyper: hudtype 1â€“2
ğŸ¤ğŸ¼	hudtype 3, hÃ¥nd som klyper, hÃ¥nd som klyper: hudtype 3
ğŸ¤ğŸ½	hudtype 4, hÃ¥nd som klyper, hÃ¥nd som klyper: hudtype 4
ğŸ¤ğŸ¾	hudtype 5, hÃ¥nd som klyper, hÃ¥nd som klyper: hudtype 5
ğŸ¤ğŸ¿	hudtype 6, hÃ¥nd som klyper, hÃ¥nd som klyper: hudtype 6
âœŒï¸	hÃ¥nd, peace-tegn, seierstegn
âœŒğŸ»	hudtype 1â€“2, hÃ¥nd, peace-tegn, seierstegn, seierstegn: hudtype 1â€“2
âœŒğŸ¼	hudtype 3, hÃ¥nd, peace-tegn, seierstegn, seierstegn: hudtype 3
âœŒğŸ½	hudtype 4, hÃ¥nd, peace-tegn, seierstegn, seierstegn: hudtype 4
âœŒğŸ¾	hudtype 5, hÃ¥nd, peace-tegn, seierstegn, seierstegn: hudtype 5
âœŒğŸ¿	hudtype 6, hÃ¥nd, peace-tegn, seierstegn, seierstegn: hudtype 6
ğŸ¤	finger, hell, hÃ¥nd, kryss, kryssede fingre
ğŸ¤ğŸ»	finger, hell, hudtype 1â€“2, hÃ¥nd, kryss, kryssede fingre, kryssede fingre: hudtype 1â€“2
ğŸ¤ğŸ¼	finger, hell, hudtype 3, hÃ¥nd, kryss, kryssede fingre, kryssede fingre: hudtype 3
ğŸ¤ğŸ½	finger, hell, hudtype 4, hÃ¥nd, kryss, kryssede fingre, kryssede fingre: hudtype 4
ğŸ¤ğŸ¾	finger, hell, hudtype 5, hÃ¥nd, kryss, kryssede fingre, kryssede fingre: hudtype 5
ğŸ¤ğŸ¿	finger, hell, hudtype 6, hÃ¥nd, kryss, kryssede fingre, kryssede fingre: hudtype 6
ğŸ¤Ÿ	ILY, glad i deg, glad i deg-tegn, hÃ¥nd, tegnsprÃ¥k
ğŸ¤ŸğŸ»	ILY, glad i deg, glad i deg-tegn, glad i deg-tegn: hudtype 1â€“2, hudtype 1â€“2, hÃ¥nd, tegnsprÃ¥k
ğŸ¤ŸğŸ¼	ILY, glad i deg, glad i deg-tegn, glad i deg-tegn: hudtype 3, hudtype 3, hÃ¥nd, tegnsprÃ¥k
ğŸ¤ŸğŸ½	ILY, glad i deg, glad i deg-tegn, glad i deg-tegn: hudtype 4, hudtype 4, hÃ¥nd, tegnsprÃ¥k
ğŸ¤ŸğŸ¾	ILY, glad i deg, glad i deg-tegn, glad i deg-tegn: hudtype 5, hudtype 5, hÃ¥nd, tegnsprÃ¥k
ğŸ¤ŸğŸ¿	ILY, glad i deg, glad i deg-tegn, glad i deg-tegn: hudtype 6, hudtype 6, hÃ¥nd, tegnsprÃ¥k
ğŸ¤˜	finger, horn, hÃ¥nd, rockâ€™nâ€™roll
ğŸ¤˜ğŸ»	finger, horn, hudtype 1â€“2, hÃ¥nd, rockâ€™nâ€™roll, rockâ€™nâ€™roll: hudtype 1â€“2
ğŸ¤˜ğŸ¼	finger, horn, hudtype 3, hÃ¥nd, rockâ€™nâ€™roll, rockâ€™nâ€™roll: hudtype 3
ğŸ¤˜ğŸ½	finger, horn, hudtype 4, hÃ¥nd, rockâ€™nâ€™roll, rockâ€™nâ€™roll: hudtype 4
ğŸ¤˜ğŸ¾	finger, horn, hudtype 5, hÃ¥nd, rockâ€™nâ€™roll, rockâ€™nâ€™roll: hudtype 5
ğŸ¤˜ğŸ¿	finger, horn, hudtype 6, hÃ¥nd, rockâ€™nâ€™roll, rockâ€™nâ€™roll: hudtype 6
ğŸ¤™	hÃ¥nd, ring meg-hÃ¥nd, ringe
ğŸ¤™ğŸ»	hudtype 1â€“2, hÃ¥nd, ring meg-hÃ¥nd, ring meg-hÃ¥nd: hudtype 1â€“2, ringe
ğŸ¤™ğŸ¼	hudtype 3, hÃ¥nd, ring meg-hÃ¥nd, ring meg-hÃ¥nd: hudtype 3, ringe
ğŸ¤™ğŸ½	hudtype 4, hÃ¥nd, ring meg-hÃ¥nd, ring meg-hÃ¥nd: hudtype 4, ringe
ğŸ¤™ğŸ¾	hudtype 5, hÃ¥nd, ring meg-hÃ¥nd, ring meg-hÃ¥nd: hudtype 5, ringe
ğŸ¤™ğŸ¿	hudtype 6, hÃ¥nd, ring meg-hÃ¥nd, ring meg-hÃ¥nd: hudtype 6, ringe
ğŸ‘ˆï¸	finger, hÃ¥nd, pekende finger, peker mot venstre â€“ bakhÃ¥nd, peker venstre
ğŸ‘ˆğŸ»	finger, hudtype 1â€“2, hÃ¥nd, pekende finger, peker mot venstre â€“ bakhÃ¥nd, peker mot venstre â€“ bakhÃ¥nd: hudtype 1â€“2, peker venstre
ğŸ‘ˆğŸ¼	finger, hudtype 3, hÃ¥nd, pekende finger, peker mot venstre â€“ bakhÃ¥nd, peker mot venstre â€“ bakhÃ¥nd: hudtype 3, peker venstre
ğŸ‘ˆğŸ½	finger, hudtype 4, hÃ¥nd, pekende finger, peker mot venstre â€“ bakhÃ¥nd, peker mot venstre â€“ bakhÃ¥nd: hudtype 4, peker venstre
ğŸ‘ˆğŸ¾	finger, hudtype 5, hÃ¥nd, pekende finger, peker mot venstre â€“ bakhÃ¥nd, peker mot venstre â€“ bakhÃ¥nd: hudtype 5, peker venstre
ğŸ‘ˆğŸ¿	finger, hudtype 6, hÃ¥nd, pekende finger, peker mot venstre â€“ bakhÃ¥nd, peker mot venstre â€“ bakhÃ¥nd: hudtype 6, peker venstre
ğŸ‘‰ï¸	finger, hÃ¥nd, pekende finger, peker mot hÃ¸yre â€“ bakhÃ¥nd, peker opp
ğŸ‘‰ğŸ»	finger, hudtype 1â€“2, hÃ¥nd, pekende finger, peker mot hÃ¸yre â€“ bakhÃ¥nd, peker mot hÃ¸yre â€“ bakhÃ¥nd: hudtype 1â€“2, peker opp
ğŸ‘‰ğŸ¼	finger, hudtype 3, hÃ¥nd, pekende finger, peker mot hÃ¸yre â€“ bakhÃ¥nd, peker mot hÃ¸yre â€“ bakhÃ¥nd: hudtype 3, peker opp
ğŸ‘‰ğŸ½	finger, hudtype 4, hÃ¥nd, pekende finger, peker mot hÃ¸yre â€“ bakhÃ¥nd, peker mot hÃ¸yre â€“ bakhÃ¥nd: hudtype 4, peker opp
ğŸ‘‰ğŸ¾	finger, hudtype 5, hÃ¥nd, pekende finger, peker mot hÃ¸yre â€“ bakhÃ¥nd, peker mot hÃ¸yre â€“ bakhÃ¥nd: hudtype 5, peker opp
ğŸ‘‰ğŸ¿	finger, hudtype 6, hÃ¥nd, pekende finger, peker mot hÃ¸yre â€“ bakhÃ¥nd, peker mot hÃ¸yre â€“ bakhÃ¥nd: hudtype 6, peker opp
ğŸ‘†ï¸	finger, hÃ¥nd, pekende finger, peker opp, peker opp â€“ bakhÃ¥nd
ğŸ‘†ğŸ»	finger, hudtype 1â€“2, hÃ¥nd, pekende finger, peker opp, peker opp â€“ bakhÃ¥nd, peker opp â€“ bakhÃ¥nd: hudtype 1â€“2
ğŸ‘†ğŸ¼	finger, hudtype 3, hÃ¥nd, pekende finger, peker opp, peker opp â€“ bakhÃ¥nd, peker opp â€“ bakhÃ¥nd: hudtype 3
ğŸ‘†ğŸ½	finger, hudtype 4, hÃ¥nd, pekende finger, peker opp, peker opp â€“ bakhÃ¥nd, peker opp â€“ bakhÃ¥nd: hudtype 4
ğŸ‘†ğŸ¾	finger, hudtype 5, hÃ¥nd, pekende finger, peker opp, peker opp â€“ bakhÃ¥nd, peker opp â€“ bakhÃ¥nd: hudtype 5
ğŸ‘†ğŸ¿	finger, hudtype 6, hÃ¥nd, pekende finger, peker opp, peker opp â€“ bakhÃ¥nd, peker opp â€“ bakhÃ¥nd: hudtype 6
ğŸ–•	finger, hÃ¥nd, kropp, langfinger, vise fingeren
ğŸ–•ğŸ»	finger, hudtype 1â€“2, hÃ¥nd, kropp, langfinger, langfinger: hudtype 1â€“2, vise fingeren
ğŸ–•ğŸ¼	finger, hudtype 3, hÃ¥nd, kropp, langfinger, langfinger: hudtype 3, vise fingeren
ğŸ–•ğŸ½	finger, hudtype 4, hÃ¥nd, kropp, langfinger, langfinger: hudtype 4, vise fingeren
ğŸ–•ğŸ¾	finger, hudtype 5, hÃ¥nd, kropp, langfinger, langfinger: hudtype 5, vise fingeren
ğŸ–•ğŸ¿	finger, hudtype 6, hÃ¥nd, kropp, langfinger, langfinger: hudtype 6, vise fingeren
ğŸ‘‡ï¸	finger, hÃ¥nd, pekende finger, peker ned, peker ned â€“ bakhÃ¥nd
ğŸ‘‡ğŸ»	finger, hudtype 1â€“2, hÃ¥nd, pekende finger, peker ned, peker ned â€“ bakhÃ¥nd, peker ned â€“ bakhÃ¥nd: hudtype 1â€“2
ğŸ‘‡ğŸ¼	finger, hudtype 3, hÃ¥nd, pekende finger, peker ned, peker ned â€“ bakhÃ¥nd, peker ned â€“ bakhÃ¥nd: hudtype 3
ğŸ‘‡ğŸ½	finger, hudtype 4, hÃ¥nd, pekende finger, peker ned, peker ned â€“ bakhÃ¥nd, peker ned â€“ bakhÃ¥nd: hudtype 4
ğŸ‘‡ğŸ¾	finger, hudtype 5, hÃ¥nd, pekende finger, peker ned, peker ned â€“ bakhÃ¥nd, peker ned â€“ bakhÃ¥nd: hudtype 5
ğŸ‘‡ğŸ¿	finger, hudtype 6, hÃ¥nd, pekende finger, peker ned, peker ned â€“ bakhÃ¥nd, peker ned â€“ bakhÃ¥nd: hudtype 6
â˜ï¸	finger, hÃ¥nd, kropp, opp, peke, pekefinger, peker opp
â˜ğŸ»	finger, hudtype 1â€“2, hÃ¥nd, kropp, opp, peke, pekefinger, peker opp, peker opp: hudtype 1â€“2
â˜ğŸ¼	finger, hudtype 3, hÃ¥nd, kropp, opp, peke, pekefinger, peker opp, peker opp: hudtype 3
â˜ğŸ½	finger, hudtype 4, hÃ¥nd, kropp, opp, peke, pekefinger, peker opp, peker opp: hudtype 4
â˜ğŸ¾	finger, hudtype 5, hÃ¥nd, kropp, opp, peke, pekefinger, peker opp, peker opp: hudtype 5
â˜ğŸ¿	finger, hudtype 6, hÃ¥nd, kropp, opp, peke, pekefinger, peker opp, peker opp: hudtype 6
ğŸ‘ï¸	hÃ¥nd, tegn, tommel, tommel opp
ğŸ‘ğŸ»	hudtype 1â€“2, hÃ¥nd, tegn, tommel, tommel opp, tommel opp: hudtype 1â€“2
ğŸ‘ğŸ¼	hudtype 3, hÃ¥nd, tegn, tommel, tommel opp, tommel opp: hudtype 3
ğŸ‘ğŸ½	hudtype 4, hÃ¥nd, tegn, tommel, tommel opp, tommel opp: hudtype 4
ğŸ‘ğŸ¾	hudtype 5, hÃ¥nd, tegn, tommel, tommel opp, tommel opp: hudtype 5
ğŸ‘ğŸ¿	hudtype 6, hÃ¥nd, tegn, tommel, tommel opp, tommel opp: hudtype 6
ğŸ‘ï¸	hÃ¥nd, tegn, tommel, tommel ned
ğŸ‘ğŸ»	hudtype 1â€“2, hÃ¥nd, tegn, tommel, tommel ned, tommel ned: hudtype 1â€“2
ğŸ‘ğŸ¼	hudtype 3, hÃ¥nd, tegn, tommel, tommel ned, tommel ned: hudtype 3
ğŸ‘ğŸ½	hudtype 4, hÃ¥nd, tegn, tommel, tommel ned, tommel ned: hudtype 4
ğŸ‘ğŸ¾	hudtype 5, hÃ¥nd, tegn, tommel, tommel ned, tommel ned: hudtype 5
ğŸ‘ğŸ¿	hudtype 6, hÃ¥nd, tegn, tommel, tommel ned, tommel ned: hudtype 6
âœŠ	hevet knyttneve, hÃ¥nd, knyttet neve, neve
âœŠğŸ»	hevet knyttneve, hevet knyttneve: hudtype 1â€“2, hudtype 1â€“2, hÃ¥nd, knyttet neve, neve
âœŠğŸ¼	hevet knyttneve, hevet knyttneve: hudtype 3, hudtype 3, hÃ¥nd, knyttet neve, neve
âœŠğŸ½	hevet knyttneve, hevet knyttneve: hudtype 4, hudtype 4, hÃ¥nd, knyttet neve, neve
âœŠğŸ¾	hevet knyttneve, hevet knyttneve: hudtype 5, hudtype 5, hÃ¥nd, knyttet neve, neve
âœŠğŸ¿	hevet knyttneve, hevet knyttneve: hudtype 6, hudtype 6, hÃ¥nd, knyttet neve, neve
ğŸ‘Š	hÃ¥nd, knyttneve, neve
ğŸ‘ŠğŸ»	hudtype 1â€“2, hÃ¥nd, knyttneve, knyttneve: hudtype 1â€“2, neve
ğŸ‘ŠğŸ¼	hudtype 3, hÃ¥nd, knyttneve, knyttneve: hudtype 3, neve
ğŸ‘ŠğŸ½	hudtype 4, hÃ¥nd, knyttneve, knyttneve: hudtype 4, neve
ğŸ‘ŠğŸ¾	hudtype 5, hÃ¥nd, knyttneve, knyttneve: hudtype 5, neve
ğŸ‘ŠğŸ¿	hudtype 6, hÃ¥nd, knyttneve, knyttneve: hudtype 6, neve
ğŸ¤›	hÃ¥nd, knyttneve mot venstre, neve, venstre, venstrevendt
ğŸ¤›ğŸ»	hudtype 1â€“2, hÃ¥nd, knyttneve mot venstre, knyttneve mot venstre: hudtype 1â€“2, neve, venstre, venstrevendt
ğŸ¤›ğŸ¼	hudtype 3, hÃ¥nd, knyttneve mot venstre, knyttneve mot venstre: hudtype 3, neve, venstre, venstrevendt
ğŸ¤›ğŸ½	hudtype 4, hÃ¥nd, knyttneve mot venstre, knyttneve mot venstre: hudtype 4, neve, venstre, venstrevendt
ğŸ¤›ğŸ¾	hudtype 5, hÃ¥nd, knyttneve mot venstre, knyttneve mot venstre: hudtype 5, neve, venstre, venstrevendt
ğŸ¤›ğŸ¿	hudtype 6, hÃ¥nd, knyttneve mot venstre, knyttneve mot venstre: hudtype 6, neve, venstre, venstrevendt
ğŸ¤œ	hÃ¥nd, hÃ¸yre, hÃ¸yrevendt, knyttneve mot hÃ¸yre, neve
ğŸ¤œğŸ»	hudtype 1â€“2, hÃ¥nd, hÃ¸yre, hÃ¸yrevendt, knyttneve mot hÃ¸yre, knyttneve mot hÃ¸yre: hudtype 1â€“2, neve
ğŸ¤œğŸ¼	hudtype 3, hÃ¥nd, hÃ¸yre, hÃ¸yrevendt, knyttneve mot hÃ¸yre, knyttneve mot hÃ¸yre: hudtype 3, neve
ğŸ¤œğŸ½	hudtype 4, hÃ¥nd, hÃ¸yre, hÃ¸yrevendt, knyttneve mot hÃ¸yre, knyttneve mot hÃ¸yre: hudtype 4, neve
ğŸ¤œğŸ¾	hudtype 5, hÃ¥nd, hÃ¸yre, hÃ¸yrevendt, knyttneve mot hÃ¸yre, knyttneve mot hÃ¸yre: hudtype 5, neve
ğŸ¤œğŸ¿	hudtype 6, hÃ¥nd, hÃ¸yre, hÃ¸yrevendt, knyttneve mot hÃ¸yre, knyttneve mot hÃ¸yre: hudtype 6, neve
ğŸ‘	hender, hÃ¥nd, klappende hender, klapping
ğŸ‘ğŸ»	hender, hudtype 1â€“2, hÃ¥nd, klappende hender, klappende hender: hudtype 1â€“2, klapping
ğŸ‘ğŸ¼	hender, hudtype 3, hÃ¥nd, klappende hender, klappende hender: hudtype 3, klapping
ğŸ‘ğŸ½	hender, hudtype 4, hÃ¥nd, klappende hender, klappende hender: hudtype 4, klapping
ğŸ‘ğŸ¾	hender, hudtype 5, hÃ¥nd, klappende hender, klappende hender: hudtype 5, klapping
ğŸ‘ğŸ¿	hender, hudtype 6, hÃ¥nd, klappende hender, klappende hender: hudtype 6, klapping
ğŸ™Œ	begge hender, feirer, feiring, hevede hender, hÃ¥nd, rekker begge armene i vÃ¦ret
ğŸ™ŒğŸ»	begge hender, feirer, feiring, hevede hender, hevede hender: hudtype 1â€“2, hudtype 1â€“2, hÃ¥nd, rekker begge armene i vÃ¦ret
ğŸ™ŒğŸ¼	begge hender, feirer, feiring, hevede hender, hevede hender: hudtype 3, hudtype 3, hÃ¥nd, rekker begge armene i vÃ¦ret
ğŸ™ŒğŸ½	begge hender, feirer, feiring, hevede hender, hevede hender: hudtype 4, hudtype 4, hÃ¥nd, rekker begge armene i vÃ¦ret
ğŸ™ŒğŸ¾	begge hender, feirer, feiring, hevede hender, hevede hender: hudtype 5, hudtype 5, hÃ¥nd, rekker begge armene i vÃ¦ret
ğŸ™ŒğŸ¿	begge hender, feirer, feiring, hevede hender, hevede hender: hudtype 6, hudtype 6, hÃ¥nd, rekker begge armene i vÃ¦ret
ğŸ‘	hender, hÃ¥nd, Ã¥pne, Ã¥pne hender
ğŸ‘ğŸ»	hender, hudtype 1â€“2, hÃ¥nd, Ã¥pne, Ã¥pne hender: hudtype 1â€“2
ğŸ‘ğŸ¼	hender, hudtype 3, hÃ¥nd, Ã¥pne, Ã¥pne hender: hudtype 3
ğŸ‘ğŸ½	hender, hudtype 4, hÃ¥nd, Ã¥pne, Ã¥pne hender: hudtype 4
ğŸ‘ğŸ¾	hender, hudtype 5, hÃ¥nd, Ã¥pne, Ã¥pne hender: hudtype 5
ğŸ‘ğŸ¿	hender, hudtype 6, hÃ¥nd, Ã¥pne, Ã¥pne hender: hudtype 6
ğŸ¤²	ber, bÃ¸nn, hÃ¥nd, hÃ¥ndflatene sammen
ğŸ¤²ğŸ»	ber, bÃ¸nn, hudtype 1â€“2, hÃ¥nd, hÃ¥ndflatene sammen, hÃ¥ndflatene sammen: hudtype 1â€“2
ğŸ¤²ğŸ¼	ber, bÃ¸nn, hudtype 3, hÃ¥nd, hÃ¥ndflatene sammen, hÃ¥ndflatene sammen: hudtype 3
ğŸ¤²ğŸ½	ber, bÃ¸nn, hudtype 4, hÃ¥nd, hÃ¥ndflatene sammen, hÃ¥ndflatene sammen: hudtype 4
ğŸ¤²ğŸ¾	ber, bÃ¸nn, hudtype 5, hÃ¥nd, hÃ¥ndflatene sammen, hÃ¥ndflatene sammen: hudtype 5
ğŸ¤²ğŸ¿	ber, bÃ¸nn, hudtype 6, hÃ¥nd, hÃ¥ndflatene sammen, hÃ¥ndflatene sammen: hudtype 6
ğŸ¤	avtale, hÃ¥nd, hÃ¥ndhilse, hÃ¥ndtrykk, mÃ¸te
ğŸ™	be, ber, bevegelse, bÃ¸nn, foldede hender, hÃ¥nd
ğŸ™ğŸ»	be, ber, bevegelse, bÃ¸nn, foldede hender, foldede hender: hudtype 1â€“2, hudtype 1â€“2, hÃ¥nd
ğŸ™ğŸ¼	be, ber, bevegelse, bÃ¸nn, foldede hender, foldede hender: hudtype 3, hudtype 3, hÃ¥nd
ğŸ™ğŸ½	be, ber, bevegelse, bÃ¸nn, foldede hender, foldede hender: hudtype 4, hudtype 4, hÃ¥nd
ğŸ™ğŸ¾	be, ber, bevegelse, bÃ¸nn, foldede hender, foldede hender: hudtype 5, hudtype 5, hÃ¥nd
ğŸ™ğŸ¿	be, ber, bevegelse, bÃ¸nn, foldede hender, foldede hender: hudtype 6, hudtype 6, hÃ¥nd
âœï¸	hÃ¥nd, kropp, skrive, skrivende hÃ¥nd
âœğŸ»	hudtype 1â€“2, hÃ¥nd, kropp, skrive, skrivende hÃ¥nd, skrivende hÃ¥nd: hudtype 1â€“2
âœğŸ¼	hudtype 3, hÃ¥nd, kropp, skrive, skrivende hÃ¥nd, skrivende hÃ¥nd: hudtype 3
âœğŸ½	hudtype 4, hÃ¥nd, kropp, skrive, skrivende hÃ¥nd, skrivende hÃ¥nd: hudtype 4
âœğŸ¾	hudtype 5, hÃ¥nd, kropp, skrive, skrivende hÃ¥nd, skrivende hÃ¥nd: hudtype 5
âœğŸ¿	hudtype 6, hÃ¥nd, kropp, skrive, skrivende hÃ¥nd, skrivende hÃ¥nd: hudtype 6
ğŸ’…	kosmetikk, manikyr, negl, neglelakk
ğŸ’…ğŸ»	hudtype 1â€“2, kosmetikk, manikyr, negl, neglelakk, neglelakk: hudtype 1â€“2
ğŸ’…ğŸ¼	hudtype 3, kosmetikk, manikyr, negl, neglelakk, neglelakk: hudtype 3
ğŸ’…ğŸ½	hudtype 4, kosmetikk, manikyr, negl, neglelakk, neglelakk: hudtype 4
ğŸ’…ğŸ¾	hudtype 5, kosmetikk, manikyr, negl, neglelakk, neglelakk: hudtype 5
ğŸ’…ğŸ¿	hudtype 6, kosmetikk, manikyr, negl, neglelakk, neglelakk: hudtype 6
ğŸ¤³	kamera, selfie, telefon
ğŸ¤³ğŸ»	hudtype 1â€“2, kamera, selfie, selfie: hudtype 1â€“2, telefon
ğŸ¤³ğŸ¼	hudtype 3, kamera, selfie, selfie: hudtype 3, telefon
ğŸ¤³ğŸ½	hudtype 4, kamera, selfie, selfie: hudtype 4, telefon
ğŸ¤³ğŸ¾	hudtype 5, kamera, selfie, selfie: hudtype 5, telefon
ğŸ¤³ğŸ¿	hudtype 6, kamera, selfie, selfie: hudtype 6, telefon
ğŸ’ª	biceps, fleks, muskel, muskelfleksing, sterk, tegneserie
ğŸ’ªğŸ»	biceps, biceps: hudtype 1â€“2, fleks, hudtype 1â€“2, muskel, muskelfleksing, sterk, tegneserie
ğŸ’ªğŸ¼	biceps, biceps: hudtype 3, fleks, hudtype 3, muskel, muskelfleksing, sterk, tegneserie
ğŸ’ªğŸ½	biceps, biceps: hudtype 4, fleks, hudtype 4, muskel, muskelfleksing, sterk, tegneserie
ğŸ’ªğŸ¾	biceps, biceps: hudtype 5, fleks, hudtype 5, muskel, muskelfleksing, sterk, tegneserie
ğŸ’ªğŸ¿	biceps, biceps: hudtype 6, fleks, hudtype 6, muskel, muskelfleksing, sterk, tegneserie
ğŸ¦¾	mekanisk arm, protese, tilgjengelighet
ğŸ¦¿	mekanisk bein, protese, tilgjengelighet
ğŸ¦µ	bein, lem, sparke
ğŸ¦µğŸ»	bein, bein: hudtype 1â€“2, hudtype 1â€“2, lem, sparke
ğŸ¦µğŸ¼	bein, bein: hudtype 3, hudtype 3, lem, sparke
ğŸ¦µğŸ½	bein, bein: hudtype 4, hudtype 4, lem, sparke
ğŸ¦µğŸ¾	bein, bein: hudtype 5, hudtype 5, lem, sparke
ğŸ¦µğŸ¿	bein, bein: hudtype 6, hudtype 6, lem, sparke
ğŸ¦¶	fot, sparke, trÃ¥kke
ğŸ¦¶ğŸ»	fot, fot: hudtype 1â€“2, hudtype 1â€“2, sparke, trÃ¥kke
ğŸ¦¶ğŸ¼	fot, fot: hudtype 3, hudtype 3, sparke, trÃ¥kke
ğŸ¦¶ğŸ½	fot, fot: hudtype 4, hudtype 4, sparke, trÃ¥kke
ğŸ¦¶ğŸ¾	fot, fot: hudtype 5, hudtype 5, sparke, trÃ¥kke
ğŸ¦¶ğŸ¿	fot, fot: hudtype 6, hudtype 6, sparke, trÃ¥kke
ğŸ‘‚ï¸	kropp, Ã¸re
ğŸ‘‚ğŸ»	hudtype 1â€“2, kropp, Ã¸re, Ã¸re: hudtype 1â€“2
ğŸ‘‚ğŸ¼	hudtype 3, kropp, Ã¸re, Ã¸re: hudtype 3
ğŸ‘‚ğŸ½	hudtype 4, kropp, Ã¸re, Ã¸re: hudtype 4
ğŸ‘‚ğŸ¾	hudtype 5, kropp, Ã¸re, Ã¸re: hudtype 5
ğŸ‘‚ğŸ¿	hudtype 6, kropp, Ã¸re, Ã¸re: hudtype 6
ğŸ¦»	svak hÃ¸rsel, tilgjengelighet, Ã¸re med hÃ¸reapparat
ğŸ¦»ğŸ»	hudtype 1â€“2, svak hÃ¸rsel, tilgjengelighet, Ã¸re med hÃ¸reapparat, Ã¸re med hÃ¸reapparat: hudtype 1â€“2
ğŸ¦»ğŸ¼	hudtype 3, svak hÃ¸rsel, tilgjengelighet, Ã¸re med hÃ¸reapparat, Ã¸re med hÃ¸reapparat: hudtype 3
ğŸ¦»ğŸ½	hudtype 4, svak hÃ¸rsel, tilgjengelighet, Ã¸re med hÃ¸reapparat, Ã¸re med hÃ¸reapparat: hudtype 4
ğŸ¦»ğŸ¾	hudtype 5, svak hÃ¸rsel, tilgjengelighet, Ã¸re med hÃ¸reapparat, Ã¸re med hÃ¸reapparat: hudtype 5
ğŸ¦»ğŸ¿	hudtype 6, svak hÃ¸rsel, tilgjengelighet, Ã¸re med hÃ¸reapparat, Ã¸re med hÃ¸reapparat: hudtype 6
ğŸ‘ƒ	fjes, kropp, nese
ğŸ‘ƒğŸ»	fjes, hudtype 1â€“2, kropp, nese, nese: hudtype 1â€“2
ğŸ‘ƒğŸ¼	fjes, hudtype 3, kropp, nese, nese: hudtype 3
ğŸ‘ƒğŸ½	fjes, hudtype 4, kropp, nese, nese: hudtype 4
ğŸ‘ƒğŸ¾	fjes, hudtype 5, kropp, nese, nese: hudtype 5
ğŸ‘ƒğŸ¿	fjes, hudtype 6, kropp, nese, nese: hudtype 6
ğŸ§ 	hjerne, intelligent
ğŸ¦·	tann, tannlege
ğŸ¦´	knokkel, skjelett
ğŸ‘€	fjes, Ã¸ye, Ã¸yne
ğŸ‘ï¸	kropp, Ã¸ye
ğŸ‘…	fjes, kropp, tunge
ğŸ‘„	fjes, kropp, lepper, munn
ğŸ‘¶	baby, menneske, ung
ğŸ‘¶ğŸ»	baby, baby: hudtype 1â€“2, hudtype 1â€“2, menneske, ung
ğŸ‘¶ğŸ¼	baby, baby: hudtype 3, hudtype 3, menneske, ung
ğŸ‘¶ğŸ½	baby, baby: hudtype 4, hudtype 4, menneske, ung
ğŸ‘¶ğŸ¾	baby, baby: hudtype 5, hudtype 5, menneske, ung
ğŸ‘¶ğŸ¿	baby, baby: hudtype 6, hudtype 6, menneske, ung
ğŸ§’	barn, kjÃ¸nnsnÃ¸ytral, menneske, ung
ğŸ§’ğŸ»	barn, barn: hudtype 1â€“2, hudtype 1â€“2, kjÃ¸nnsnÃ¸ytral, menneske, ung
ğŸ§’ğŸ¼	barn, barn: hudtype 3, hudtype 3, kjÃ¸nnsnÃ¸ytral, menneske, ung
ğŸ§’ğŸ½	barn, barn: hudtype 4, hudtype 4, kjÃ¸nnsnÃ¸ytral, menneske, ung
ğŸ§’ğŸ¾	barn, barn: hudtype 5, hudtype 5, kjÃ¸nnsnÃ¸ytral, menneske, ung
ğŸ§’ğŸ¿	barn, barn: hudtype 6, hudtype 6, kjÃ¸nnsnÃ¸ytral, menneske, ung
ğŸ‘¦	gutt, menneske, ung
ğŸ‘¦ğŸ»	gutt, gutt: hudtype 1â€“2, hudtype 1â€“2, menneske, ung
ğŸ‘¦ğŸ¼	gutt, gutt: hudtype 3, hudtype 3, menneske, ung
ğŸ‘¦ğŸ½	gutt, gutt: hudtype 4, hudtype 4, menneske, ung
ğŸ‘¦ğŸ¾	gutt, gutt: hudtype 5, hudtype 5, menneske, ung
ğŸ‘¦ğŸ¿	gutt, gutt: hudtype 6, hudtype 6, menneske, ung
ğŸ‘§	Jomfruen, jente, menneske, stjernebilde, stjernetegn, ung
ğŸ‘§ğŸ»	Jomfruen, hudtype 1â€“2, jente, jente: hudtype 1â€“2, menneske, stjernebilde, stjernetegn, ung
ğŸ‘§ğŸ¼	Jomfruen, hudtype 3, jente, jente: hudtype 3, menneske, stjernebilde, stjernetegn, ung
ğŸ‘§ğŸ½	Jomfruen, hudtype 4, jente, jente: hudtype 4, menneske, stjernebilde, stjernetegn, ung
ğŸ‘§ğŸ¾	Jomfruen, hudtype 5, jente, jente: hudtype 5, menneske, stjernebilde, stjernetegn, ung
ğŸ‘§ğŸ¿	Jomfruen, hudtype 6, jente, jente: hudtype 6, menneske, stjernebilde, stjernetegn, ung
ğŸ§‘	kjÃ¸nnsnÃ¸ytral, menneske, voksen
ğŸ§‘ğŸ»	hudtype 1â€“2, kjÃ¸nnsnÃ¸ytral, menneske, voksen, voksen: hudtype 1â€“2
ğŸ§‘ğŸ¼	hudtype 3, kjÃ¸nnsnÃ¸ytral, menneske, voksen, voksen: hudtype 3
ğŸ§‘ğŸ½	hudtype 4, kjÃ¸nnsnÃ¸ytral, menneske, voksen, voksen: hudtype 4
ğŸ§‘ğŸ¾	hudtype 5, kjÃ¸nnsnÃ¸ytral, menneske, voksen, voksen: hudtype 5
ğŸ§‘ğŸ¿	hudtype 6, kjÃ¸nnsnÃ¸ytral, menneske, voksen, voksen: hudtype 6
ğŸ‘±	Person: blond, blond, blond person, menneske
ğŸ‘±ğŸ»	Person: blond, Person: hudtype 1â€“2, blond, blond, blond person, hudtype 1â€“2, menneske
ğŸ‘±ğŸ¼	Person: blond, Person: hudtype 3, blond, blond, blond person, hudtype 3, menneske
ğŸ‘±ğŸ½	Person: blond, Person: hudtype 4, blond, blond, blond person, hudtype 4, menneske
ğŸ‘±ğŸ¾	Person: blond, Person: hudtype 5, blond, blond, blond person, hudtype 5, menneske
ğŸ‘±ğŸ¿	Person: blond, Person: hudtype 6, blond, blond, blond person, hudtype 6, menneske
ğŸ‘¨	mann, menneske
ğŸ‘¨ğŸ»	hudtype 1â€“2, mann, mann: hudtype 1â€“2, menneske
ğŸ‘¨ğŸ¼	hudtype 3, mann, mann: hudtype 3, menneske
ğŸ‘¨ğŸ½	hudtype 4, mann, mann: hudtype 4, menneske
ğŸ‘¨ğŸ¾	hudtype 5, mann, mann: hudtype 5, menneske
ğŸ‘¨ğŸ¿	hudtype 6, mann, mann: hudtype 6, menneske
ğŸ§”	mann, mann med skjegg, mann: skjegg, skjegg
ğŸ§”ğŸ»	hudtype 1â€“2, mann, mann med skjegg, mann: hudtype 1â€“2, skjegg, mann: skjegg, skjegg
ğŸ§”ğŸ¼	hudtype 3, mann, mann med skjegg, mann: hudtype 3, skjegg, mann: skjegg, skjegg
ğŸ§”ğŸ½	hudtype 4, mann, mann med skjegg, mann: hudtype 4, skjegg, mann: skjegg, skjegg
ğŸ§”ğŸ¾	hudtype 5, mann, mann med skjegg, mann: hudtype 5, skjegg, mann: skjegg, skjegg
ğŸ§”ğŸ¿	hudtype 6, mann, mann med skjegg, mann: hudtype 6, skjegg, mann: skjegg, skjegg
ğŸ‘±â€â™‚	blond, mann, mann: blond
ğŸ‘±ğŸ»â€â™‚	blond, hudtype 1â€“2, mann, mann: blond, mann: hudtype 1â€“2, blond
ğŸ‘±ğŸ¼â€â™‚	blond, hudtype 3, mann, mann: blond, mann: hudtype 3, blond
ğŸ‘±ğŸ½â€â™‚	blond, hudtype 4, mann, mann: blond, mann: hudtype 4, blond
ğŸ‘±ğŸ¾â€â™‚	blond, hudtype 5, mann, mann: blond, mann: hudtype 5, blond
ğŸ‘±ğŸ¿â€â™‚	blond, hudtype 6, mann, mann: blond, mann: hudtype 6, blond
ğŸ‘¨â€ğŸ¦°	mann, mann: rÃ¸dt hÃ¥r, menneske, rÃ¸dt hÃ¥r
ğŸ‘¨ğŸ»â€ğŸ¦°	hudtype 1â€“2, mann, mann: hudtype 1â€“2, rÃ¸dt hÃ¥r, menneske, rÃ¸dt hÃ¥r
ğŸ‘¨ğŸ¼â€ğŸ¦°	hudtype 3, mann, mann: hudtype 3, rÃ¸dt hÃ¥r, menneske, rÃ¸dt hÃ¥r
ğŸ‘¨ğŸ½â€ğŸ¦°	hudtype 4, mann, mann: hudtype 4, rÃ¸dt hÃ¥r, menneske, rÃ¸dt hÃ¥r
ğŸ‘¨ğŸ¾â€ğŸ¦°	hudtype 5, mann, mann: hudtype 5, rÃ¸dt hÃ¥r, menneske, rÃ¸dt hÃ¥r
ğŸ‘¨ğŸ¿â€ğŸ¦°	hudtype 6, mann, mann: hudtype 6, rÃ¸dt hÃ¥r, menneske, rÃ¸dt hÃ¥r
ğŸ‘¨â€ğŸ¦±	kruset hÃ¥r, mann, mann: kruset hÃ¥r, menneske
ğŸ‘¨ğŸ»â€ğŸ¦±	hudtype 1â€“2, kruset hÃ¥r, mann, mann: hudtype 1â€“2, kruset hÃ¥r, menneske
ğŸ‘¨ğŸ¼â€ğŸ¦±	hudtype 3, kruset hÃ¥r, mann, mann: hudtype 3, kruset hÃ¥r, menneske
ğŸ‘¨ğŸ½â€ğŸ¦±	hudtype 4, kruset hÃ¥r, mann, mann: hudtype 4, kruset hÃ¥r, menneske
ğŸ‘¨ğŸ¾â€ğŸ¦±	hudtype 5, kruset hÃ¥r, mann, mann: hudtype 5, kruset hÃ¥r, menneske
ğŸ‘¨ğŸ¿â€ğŸ¦±	hudtype 6, kruset hÃ¥r, mann, mann: hudtype 6, kruset hÃ¥r, menneske
ğŸ‘¨â€ğŸ¦³	grÃ¥tt hÃ¥r, mann, mann: grÃ¥tt hÃ¥r, menneske
ğŸ‘¨ğŸ»â€ğŸ¦³	grÃ¥tt hÃ¥r, hudtype 1â€“2, mann, mann: hudtype 1â€“2, grÃ¥tt hÃ¥r, menneske
ğŸ‘¨ğŸ¼â€ğŸ¦³	grÃ¥tt hÃ¥r, hudtype 3, mann, mann: hudtype 3, grÃ¥tt hÃ¥r, menneske
ğŸ‘¨ğŸ½â€ğŸ¦³	grÃ¥tt hÃ¥r, hudtype 4, mann, mann: hudtype 4, grÃ¥tt hÃ¥r, menneske
ğŸ‘¨ğŸ¾â€ğŸ¦³	grÃ¥tt hÃ¥r, hudtype 5, mann, mann: hudtype 5, grÃ¥tt hÃ¥r, menneske
ğŸ‘¨ğŸ¿â€ğŸ¦³	grÃ¥tt hÃ¥r, hudtype 6, mann, mann: hudtype 6, grÃ¥tt hÃ¥r, menneske
ğŸ‘¨â€ğŸ¦²	mann, mann: skallet, menneske, skallet
ğŸ‘¨ğŸ»â€ğŸ¦²	hudtype 1â€“2, mann, mann: hudtype 1â€“2, skallet, menneske, skallet
ğŸ‘¨ğŸ¼â€ğŸ¦²	hudtype 3, mann, mann: hudtype 3, skallet, menneske, skallet
ğŸ‘¨ğŸ½â€ğŸ¦²	hudtype 4, mann, mann: hudtype 4, skallet, menneske, skallet
ğŸ‘¨ğŸ¾â€ğŸ¦²	hudtype 5, mann, mann: hudtype 5, skallet, menneske, skallet
ğŸ‘¨ğŸ¿â€ğŸ¦²	hudtype 6, mann, mann: hudtype 6, skallet, menneske, skallet
ğŸ‘©	kvinne, menneske
ğŸ‘©ğŸ»	hudtype 1â€“2, kvinne, kvinne: hudtype 1â€“2, menneske
ğŸ‘©ğŸ¼	hudtype 3, kvinne, kvinne: hudtype 3, menneske
ğŸ‘©ğŸ½	hudtype 4, kvinne, kvinne: hudtype 4, menneske
ğŸ‘©ğŸ¾	hudtype 5, kvinne, kvinne: hudtype 5, menneske
ğŸ‘©ğŸ¿	hudtype 6, kvinne, kvinne: hudtype 6, menneske
ğŸ‘±â€â™€	blond, blondine, kvinne, kvinne: blond
ğŸ‘±ğŸ»â€â™€	blond, blondine, hudtype 1â€“2, kvinne, kvinne: blond, kvinne: hudtype 1â€“2, blond
ğŸ‘±ğŸ¼â€â™€	blond, blondine, hudtype 3, kvinne, kvinne: blond, kvinne: hudtype 3, blond
ğŸ‘±ğŸ½â€â™€	blond, blondine, hudtype 4, kvinne, kvinne: blond, kvinne: hudtype 4, blond
ğŸ‘±ğŸ¾â€â™€	blond, blondine, hudtype 5, kvinne, kvinne: blond, kvinne: hudtype 5, blond
ğŸ‘±ğŸ¿â€â™€	blond, blondine, hudtype 6, kvinne, kvinne: blond, kvinne: hudtype 6, blond
ğŸ‘©â€ğŸ¦°	kvinne, kvinne: rÃ¸dt hÃ¥r, menneske, rÃ¸dt hÃ¥r
ğŸ‘©ğŸ»â€ğŸ¦°	hudtype 1â€“2, kvinne, kvinne: hudtype 1â€“2, rÃ¸dt hÃ¥r, menneske, rÃ¸dt hÃ¥r
ğŸ‘©ğŸ¼â€ğŸ¦°	hudtype 3, kvinne, kvinne: hudtype 3, rÃ¸dt hÃ¥r, menneske, rÃ¸dt hÃ¥r
ğŸ‘©ğŸ½â€ğŸ¦°	hudtype 4, kvinne, kvinne: hudtype 4, rÃ¸dt hÃ¥r, menneske, rÃ¸dt hÃ¥r
ğŸ‘©ğŸ¾â€ğŸ¦°	hudtype 5, kvinne, kvinne: hudtype 5, rÃ¸dt hÃ¥r, menneske, rÃ¸dt hÃ¥r
ğŸ‘©ğŸ¿â€ğŸ¦°	hudtype 6, kvinne, kvinne: hudtype 6, rÃ¸dt hÃ¥r, menneske, rÃ¸dt hÃ¥r
ğŸ‘©â€ğŸ¦±	kruset hÃ¥r, kvinne, kvinne: kruset hÃ¥r, menneske
ğŸ‘©ğŸ»â€ğŸ¦±	hudtype 1â€“2, kruset hÃ¥r, kvinne, kvinne: hudtype 1â€“2, kruset hÃ¥r, menneske
ğŸ‘©ğŸ¼â€ğŸ¦±	hudtype 3, kruset hÃ¥r, kvinne, kvinne: hudtype 3, kruset hÃ¥r, menneske
ğŸ‘©ğŸ½â€ğŸ¦±	hudtype 4, kruset hÃ¥r, kvinne, kvinne: hudtype 4, kruset hÃ¥r, menneske
ğŸ‘©ğŸ¾â€ğŸ¦±	hudtype 5, kruset hÃ¥r, kvinne, kvinne: hudtype 5, kruset hÃ¥r, menneske
ğŸ‘©ğŸ¿â€ğŸ¦±	hudtype 6, kruset hÃ¥r, kvinne, kvinne: hudtype 6, kruset hÃ¥r, menneske
ğŸ‘©â€ğŸ¦³	grÃ¥tt hÃ¥r, kvinne, kvinne: grÃ¥tt hÃ¥r, menneske
ğŸ‘©ğŸ»â€ğŸ¦³	grÃ¥tt hÃ¥r, hudtype 1â€“2, kvinne, kvinne: hudtype 1â€“2, grÃ¥tt hÃ¥r, menneske
ğŸ‘©ğŸ¼â€ğŸ¦³	grÃ¥tt hÃ¥r, hudtype 3, kvinne, kvinne: hudtype 3, grÃ¥tt hÃ¥r, menneske
ğŸ‘©ğŸ½â€ğŸ¦³	grÃ¥tt hÃ¥r, hudtype 4, kvinne, kvinne: hudtype 4, grÃ¥tt hÃ¥r, menneske
ğŸ‘©ğŸ¾â€ğŸ¦³	grÃ¥tt hÃ¥r, hudtype 5, kvinne, kvinne: hudtype 5, grÃ¥tt hÃ¥r, menneske
ğŸ‘©ğŸ¿â€ğŸ¦³	grÃ¥tt hÃ¥r, hudtype 6, kvinne, kvinne: hudtype 6, grÃ¥tt hÃ¥r, menneske
ğŸ‘©â€ğŸ¦²	kvinne, kvinne: skallet, menneske, skallet
ğŸ‘©ğŸ»â€ğŸ¦²	hudtype 1â€“2, kvinne, kvinne: hudtype 1â€“2, skallet, menneske, skallet
ğŸ‘©ğŸ¼â€ğŸ¦²	hudtype 3, kvinne, kvinne: hudtype 3, skallet, menneske, skallet
ğŸ‘©ğŸ½â€ğŸ¦²	hudtype 4, kvinne, kvinne: hudtype 4, skallet, menneske, skallet
ğŸ‘©ğŸ¾â€ğŸ¦²	hudtype 5, kvinne, kvinne: hudtype 5, skallet, menneske, skallet
ğŸ‘©ğŸ¿â€ğŸ¦²	hudtype 6, kvinne, kvinne: hudtype 6, skallet, menneske, skallet
ğŸ§“	eldre voksen, gammel, kjÃ¸nnsnÃ¸ytral, menneske
ğŸ§“ğŸ»	eldre voksen, eldre voksen: hudtype 1â€“2, gammel, hudtype 1â€“2, kjÃ¸nnsnÃ¸ytral, menneske
ğŸ§“ğŸ¼	eldre voksen, eldre voksen: hudtype 3, gammel, hudtype 3, kjÃ¸nnsnÃ¸ytral, menneske
ğŸ§“ğŸ½	eldre voksen, eldre voksen: hudtype 4, gammel, hudtype 4, kjÃ¸nnsnÃ¸ytral, menneske
ğŸ§“ğŸ¾	eldre voksen, eldre voksen: hudtype 5, gammel, hudtype 5, kjÃ¸nnsnÃ¸ytral, menneske
ğŸ§“ğŸ¿	eldre voksen, eldre voksen: hudtype 6, gammel, hudtype 6, kjÃ¸nnsnÃ¸ytral, menneske
ğŸ‘´	eldre, eldre mann, mann, menneske
ğŸ‘´ğŸ»	eldre, eldre mann: hudtype 1â€“2, hudtype 1â€“2, mann, menneske
ğŸ‘´ğŸ¼	eldre, eldre mann: hudtype 3, hudtype 3, mann, menneske
ğŸ‘´ğŸ½	eldre, eldre mann: hudtype 4, hudtype 4, mann, menneske
ğŸ‘´ğŸ¾	eldre, eldre mann: hudtype 5, hudtype 5, mann, menneske
ğŸ‘´ğŸ¿	eldre, eldre mann: hudtype 6, hudtype 6, mann, menneske
ğŸ‘µ	eldre, eldre kvinne, kvinne, menneske
ğŸ‘µğŸ»	eldre, eldre kvinne: hudtype 1â€“2, hudtype 1â€“2, kvinne, menneske
ğŸ‘µğŸ¼	eldre, eldre kvinne: hudtype 3, hudtype 3, kvinne, menneske
ğŸ‘µğŸ½	eldre, eldre kvinne: hudtype 4, hudtype 4, kvinne, menneske
ğŸ‘µğŸ¾	eldre, eldre kvinne: hudtype 5, hudtype 5, kvinne, menneske
ğŸ‘µğŸ¿	eldre, eldre kvinne: hudtype 6, hudtype 6, kvinne, menneske
ğŸ™	mimikk, rynker brynene, rynker pannen
ğŸ™ğŸ»	hudtype 1â€“2, mimikk, rynker brynene, rynker brynene: hudtype 1â€“2, rynker pannen
ğŸ™ğŸ¼	hudtype 3, mimikk, rynker brynene, rynker brynene: hudtype 3, rynker pannen
ğŸ™ğŸ½	hudtype 4, mimikk, rynker brynene, rynker brynene: hudtype 4, rynker pannen
ğŸ™ğŸ¾	hudtype 5, mimikk, rynker brynene, rynker brynene: hudtype 5, rynker pannen
ğŸ™ğŸ¿	hudtype 6, mimikk, rynker brynene, rynker brynene: hudtype 6, rynker pannen
ğŸ™â€â™‚	mann, mann som rynker brynene, rynker pannen, skeptisk
ğŸ™ğŸ»â€â™‚	hudtype 1â€“2, mann, mann som rynker brynene, mann som rynker brynene: hudtype 1â€“2, rynker pannen, skeptisk
ğŸ™ğŸ¼â€â™‚	hudtype 3, mann, mann som rynker brynene, mann som rynker brynene: hudtype 3, rynker pannen, skeptisk
ğŸ™ğŸ½â€â™‚	hudtype 4, mann, mann som rynker brynene, mann som rynker brynene: hudtype 4, rynker pannen, skeptisk
ğŸ™ğŸ¾â€â™‚	hudtype 5, mann, mann som rynker brynene, mann som rynker brynene: hudtype 5, rynker pannen, skeptisk
ğŸ™ğŸ¿â€â™‚	hudtype 6, mann, mann som rynker brynene, mann som rynker brynene: hudtype 6, rynker pannen, skeptisk
ğŸ™â€â™€	kvinne, kvinne som rynker brynene, rynker pannen, skeptisk
ğŸ™ğŸ»â€â™€	hudtype 1â€“2, kvinne, kvinne som rynker brynene, kvinne som rynker brynene: hudtype 1â€“2, rynker pannen, skeptisk
ğŸ™ğŸ¼â€â™€	hudtype 3, kvinne, kvinne som rynker brynene, kvinne som rynker brynene: hudtype 3, rynker pannen, skeptisk
ğŸ™ğŸ½â€â™€	hudtype 4, kvinne, kvinne som rynker brynene, kvinne som rynker brynene: hudtype 4, rynker pannen, skeptisk
ğŸ™ğŸ¾â€â™€	hudtype 5, kvinne, kvinne som rynker brynene, kvinne som rynker brynene: hudtype 5, rynker pannen, skeptisk
ğŸ™ğŸ¿â€â™€	hudtype 6, kvinne, kvinne som rynker brynene, kvinne som rynker brynene: hudtype 6, rynker pannen, skeptisk
ğŸ™	furter, furting, mimikk, surmuling
ğŸ™ğŸ»	furter, furter: hudtype 1â€“2, furting, hudtype 1â€“2, mimikk, surmuling
ğŸ™ğŸ¼	furter, furter: hudtype 3, furting, hudtype 3, mimikk, surmuling
ğŸ™ğŸ½	furter, furter: hudtype 4, furting, hudtype 4, mimikk, surmuling
ğŸ™ğŸ¾	furter, furter: hudtype 5, furting, hudtype 5, mimikk, surmuling
ğŸ™ğŸ¿	furter, furter: hudtype 6, furting, hudtype 6, mimikk, surmuling
ğŸ™â€â™‚	furting, mann, mann som furter, mimikk, surmuling
ğŸ™ğŸ»â€â™‚	furting, hudtype 1â€“2, mann, mann som furter, mann som furter: hudtype 1â€“2, mimikk, surmuling
ğŸ™ğŸ¼â€â™‚	furting, hudtype 3, mann, mann som furter, mann som furter: hudtype 3, mimikk, surmuling
ğŸ™ğŸ½â€â™‚	furting, hudtype 4, mann, mann som furter, mann som furter: hudtype 4, mimikk, surmuling
ğŸ™ğŸ¾â€â™‚	furting, hudtype 5, mann, mann som furter, mann som furter: hudtype 5, mimikk, surmuling
ğŸ™ğŸ¿â€â™‚	furting, hudtype 6, mann, mann som furter, mann som furter: hudtype 6, mimikk, surmuling
ğŸ™â€â™€	furting, kvinne, kvinne som furter, mimikk, surmuling
ğŸ™ğŸ»â€â™€	furting, hudtype 1â€“2, kvinne, kvinne som furter, kvinne som furter: hudtype 1â€“2, mimikk, surmuling
ğŸ™ğŸ¼â€â™€	furting, hudtype 3, kvinne, kvinne som furter, kvinne som furter: hudtype 3, mimikk, surmuling
ğŸ™ğŸ½â€â™€	furting, hudtype 4, kvinne, kvinne som furter, kvinne som furter: hudtype 4, mimikk, surmuling
ğŸ™ğŸ¾â€â™€	furting, hudtype 5, kvinne, kvinne som furter, kvinne som furter: hudtype 5, mimikk, surmuling
ğŸ™ğŸ¿â€â™€	furting, hudtype 6, kvinne, kvinne som furter, kvinne som furter: hudtype 6, mimikk, surmuling
ğŸ™…	forbudt, gestikulerer NEI, nei
ğŸ™…ğŸ»	forbudt, gestikulerer NEI, gestikulerer NEI: hudtype 1â€“2, hudtype 1â€“2, nei
ğŸ™…ğŸ¼	forbudt, gestikulerer NEI, gestikulerer NEI: hudtype 3, hudtype 3, nei
ğŸ™…ğŸ½	forbudt, gestikulerer NEI, gestikulerer NEI: hudtype 4, hudtype 4, nei
ğŸ™…ğŸ¾	forbudt, gestikulerer NEI, gestikulerer NEI: hudtype 5, hudtype 5, nei
ğŸ™…ğŸ¿	forbudt, gestikulerer NEI, gestikulerer NEI: hudtype 6, hudtype 6, nei
ğŸ™…â€â™‚	avbryt, forbudt, mann, mann som gestikulerer NEI, nei, stopp
ğŸ™…ğŸ»â€â™‚	avbryt, forbudt, hudtype 1â€“2, mann, mann som gestikulerer NEI, mann som gestikulerer NEI: hudtype 1â€“2, nei, stopp
ğŸ™…ğŸ¼â€â™‚	avbryt, forbudt, hudtype 3, mann, mann som gestikulerer NEI, mann som gestikulerer NEI: hudtype 3, nei, stopp
ğŸ™…ğŸ½â€â™‚	avbryt, forbudt, hudtype 4, mann, mann som gestikulerer NEI, mann som gestikulerer NEI: hudtype 4, nei, stopp
ğŸ™…ğŸ¾â€â™‚	avbryt, forbudt, hudtype 5, mann, mann som gestikulerer NEI, mann som gestikulerer NEI: hudtype 5, nei, stopp
ğŸ™…ğŸ¿â€â™‚	avbryt, forbudt, hudtype 6, mann, mann som gestikulerer NEI, mann som gestikulerer NEI: hudtype 6, nei, stopp
ğŸ™…â€â™€	avbryt, forbudt, kvinne, kvinne som gestikulerer NEI, nei, stopp
ğŸ™…ğŸ»â€â™€	avbryt, forbudt, hudtype 1â€“2, kvinne, kvinne som gestikulerer NEI, kvinne som gestikulerer NEI: hudtype 1â€“2, nei, stopp
ğŸ™…ğŸ¼â€â™€	avbryt, forbudt, hudtype 3, kvinne, kvinne som gestikulerer NEI, kvinne som gestikulerer NEI: hudtype 3, nei, stopp
ğŸ™…ğŸ½â€â™€	avbryt, forbudt, hudtype 4, kvinne, kvinne som gestikulerer NEI, kvinne som gestikulerer NEI: hudtype 4, nei, stopp
ğŸ™…ğŸ¾â€â™€	avbryt, forbudt, hudtype 5, kvinne, kvinne som gestikulerer NEI, kvinne som gestikulerer NEI: hudtype 5, nei, stopp
ğŸ™…ğŸ¿â€â™€	avbryt, forbudt, hudtype 6, kvinne, kvinne som gestikulerer NEI, kvinne som gestikulerer NEI: hudtype 6, nei, stopp
ğŸ™†	gestikulerer OK, greit, ok
ğŸ™†ğŸ»	gestikulerer OK, gestikulerer OK: hudtype 1â€“2, greit, hudtype 1â€“2, ok
ğŸ™†ğŸ¼	gestikulerer OK, gestikulerer OK: hudtype 3, greit, hudtype 3, ok
ğŸ™†ğŸ½	gestikulerer OK, gestikulerer OK: hudtype 4, greit, hudtype 4, ok
ğŸ™†ğŸ¾	gestikulerer OK, gestikulerer OK: hudtype 5, greit, hudtype 5, ok
ğŸ™†ğŸ¿	gestikulerer OK, gestikulerer OK: hudtype 6, greit, hudtype 6, ok
ğŸ™†â€â™‚	greit, mann, mann som gestikulerer OK, ok
ğŸ™†ğŸ»â€â™‚	greit, hudtype 1â€“2, mann, mann som gestikulerer OK, mann som gestikulerer OK: hudtype 1â€“2, ok
ğŸ™†ğŸ¼â€â™‚	greit, hudtype 3, mann, mann som gestikulerer OK, mann som gestikulerer OK: hudtype 3, ok
ğŸ™†ğŸ½â€â™‚	greit, hudtype 4, mann, mann som gestikulerer OK, mann som gestikulerer OK: hudtype 4, ok
ğŸ™†ğŸ¾â€â™‚	greit, hudtype 5, mann, mann som gestikulerer OK, mann som gestikulerer OK: hudtype 5, ok
ğŸ™†ğŸ¿â€â™‚	greit, hudtype 6, mann, mann som gestikulerer OK, mann som gestikulerer OK: hudtype 6, ok
ğŸ™†â€â™€	greit, kvinne, kvinne som gestikulerer OK, ok
ğŸ™†ğŸ»â€â™€	greit, hudtype 1â€“2, kvinne, kvinne som gestikulerer OK, kvinne som gestikulerer OK: hudtype 1â€“2, ok
ğŸ™†ğŸ¼â€â™€	greit, hudtype 3, kvinne, kvinne som gestikulerer OK, kvinne som gestikulerer OK: hudtype 3, ok
ğŸ™†ğŸ½â€â™€	greit, hudtype 4, kvinne, kvinne som gestikulerer OK, kvinne som gestikulerer OK: hudtype 4, ok
ğŸ™†ğŸ¾â€â™€	greit, hudtype 5, kvinne, kvinne som gestikulerer OK, kvinne som gestikulerer OK: hudtype 5, ok
ğŸ™†ğŸ¿â€â™€	greit, hudtype 6, kvinne, kvinne som gestikulerer OK, kvinne som gestikulerer OK: hudtype 6, ok
ğŸ’	hjelp, hjelpende person, informasjon, menneske
ğŸ’ğŸ»	hjelp, hjelpende person, hjelpende person: hudtype 1â€“2, hudtype 1â€“2, informasjon, menneske
ğŸ’ğŸ¼	hjelp, hjelpende person, hjelpende person: hudtype 3, hudtype 3, informasjon, menneske
ğŸ’ğŸ½	hjelp, hjelpende person, hjelpende person: hudtype 4, hudtype 4, informasjon, menneske
ğŸ’ğŸ¾	hjelp, hjelpende person, hjelpende person: hudtype 5, hudtype 5, informasjon, menneske
ğŸ’ğŸ¿	hjelp, hjelpende person, hjelpende person: hudtype 6, hudtype 6, informasjon, menneske
ğŸ’â€â™‚	hjelpe, hjelpende mann, informasjon, mann
ğŸ’ğŸ»â€â™‚	hjelpe, hjelpende mann, hjelpende mann: hudtype 1â€“2, hudtype 1â€“2, informasjon, mann
ğŸ’ğŸ¼â€â™‚	hjelpe, hjelpende mann, hjelpende mann: hudtype 3, hudtype 3, informasjon, mann
ğŸ’ğŸ½â€â™‚	hjelpe, hjelpende mann, hjelpende mann: hudtype 4, hudtype 4, informasjon, mann
ğŸ’ğŸ¾â€â™‚	hjelpe, hjelpende mann, hjelpende mann: hudtype 5, hudtype 5, informasjon, mann
ğŸ’ğŸ¿â€â™‚	hjelpe, hjelpende mann, hjelpende mann: hudtype 6, hudtype 6, informasjon, mann
ğŸ’â€â™€	hjelpe, hjelpende kvinne, informasjon, kvinne
ğŸ’ğŸ»â€â™€	hjelpe, hjelpende kvinne, hjelpende kvinne: hudtype 1â€“2, hudtype 1â€“2, informasjon, kvinne
ğŸ’ğŸ¼â€â™€	hjelpe, hjelpende kvinne, hjelpende kvinne: hudtype 3, hudtype 3, informasjon, kvinne
ğŸ’ğŸ½â€â™€	hjelpe, hjelpende kvinne, hjelpende kvinne: hudtype 4, hudtype 4, informasjon, kvinne
ğŸ’ğŸ¾â€â™€	hjelpe, hjelpende kvinne, hjelpende kvinne: hudtype 5, hudtype 5, informasjon, kvinne
ğŸ’ğŸ¿â€â™€	hjelpe, hjelpende kvinne, hjelpende kvinne: hudtype 6, hudtype 6, informasjon, kvinne
ğŸ™‹	hÃ¥nd, person, rekker opp, rekker opp hÃ¥nden
ğŸ™‹ğŸ»	hudtype 1â€“2, hÃ¥nd, person, rekker opp, rekker opp hÃ¥nden, rekker opp hÃ¥nden: hudtype 1â€“2
ğŸ™‹ğŸ¼	hudtype 3, hÃ¥nd, person, rekker opp, rekker opp hÃ¥nden, rekker opp hÃ¥nden: hudtype 3
ğŸ™‹ğŸ½	hudtype 4, hÃ¥nd, person, rekker opp, rekker opp hÃ¥nden, rekker opp hÃ¥nden: hudtype 4
ğŸ™‹ğŸ¾	hudtype 5, hÃ¥nd, person, rekker opp, rekker opp hÃ¥nden, rekker opp hÃ¥nden: hudtype 5
ğŸ™‹ğŸ¿	hudtype 6, hÃ¥nd, person, rekker opp, rekker opp hÃ¥nden, rekker opp hÃ¥nden: hudtype 6
ğŸ™‹â€â™‚	mann, mann som rekker opp hÃ¥nden, rekke opp hÃ¥nden
ğŸ™‹ğŸ»â€â™‚	hudtype 1â€“2, mann, mann som rekker opp hÃ¥nden, mann som rekker opp hÃ¥nden: hudtype 1â€“2, rekke opp hÃ¥nden
ğŸ™‹ğŸ¼â€â™‚	hudtype 3, mann, mann som rekker opp hÃ¥nden, mann som rekker opp hÃ¥nden: hudtype 3, rekke opp hÃ¥nden
ğŸ™‹ğŸ½â€â™‚	hudtype 4, mann, mann som rekker opp hÃ¥nden, mann som rekker opp hÃ¥nden: hudtype 4, rekke opp hÃ¥nden
ğŸ™‹ğŸ¾â€â™‚	hudtype 5, mann, mann som rekker opp hÃ¥nden, mann som rekker opp hÃ¥nden: hudtype 5, rekke opp hÃ¥nden
ğŸ™‹ğŸ¿â€â™‚	hudtype 6, mann, mann som rekker opp hÃ¥nden, mann som rekker opp hÃ¥nden: hudtype 6, rekke opp hÃ¥nden
ğŸ™‹â€â™€	kvinne, kvinne som rekker opp hÃ¥nden, rekke opp hÃ¥nden
ğŸ™‹ğŸ»â€â™€	hudtype 1â€“2, kvinne, kvinne som rekker opp hÃ¥nden, kvinne som rekker opp hÃ¥nden: hudtype 1â€“2, rekke opp hÃ¥nden
ğŸ™‹ğŸ¼â€â™€	hudtype 3, kvinne, kvinne som rekker opp hÃ¥nden, kvinne som rekker opp hÃ¥nden: hudtype 3, rekke opp hÃ¥nden
ğŸ™‹ğŸ½â€â™€	hudtype 4, kvinne, kvinne som rekker opp hÃ¥nden, kvinne som rekker opp hÃ¥nden: hudtype 4, rekke opp hÃ¥nden
ğŸ™‹ğŸ¾â€â™€	hudtype 5, kvinne, kvinne som rekker opp hÃ¥nden, kvinne som rekker opp hÃ¥nden: hudtype 5, rekke opp hÃ¥nden
ğŸ™‹ğŸ¿â€â™€	hudtype 6, kvinne, kvinne som rekker opp hÃ¥nden, kvinne som rekker opp hÃ¥nden: hudtype 6, rekke opp hÃ¥nden
ğŸ§	dÃ¸v person
ğŸ§ğŸ»	dÃ¸v person, dÃ¸v person: hudtype 1â€“2, hudtype 1â€“2
ğŸ§ğŸ¼	dÃ¸v person, dÃ¸v person: hudtype 3, hudtype 3
ğŸ§ğŸ½	dÃ¸v person, dÃ¸v person: hudtype 4, hudtype 4
ğŸ§ğŸ¾	dÃ¸v person, dÃ¸v person: hudtype 5, hudtype 5
ğŸ§ğŸ¿	dÃ¸v person, dÃ¸v person: hudtype 6, hudtype 6
ğŸ§â€â™‚	dÃ¸v mann
ğŸ§ğŸ»â€â™‚	dÃ¸v mann, dÃ¸v mann: hudtype 1â€“2, hudtype 1â€“2
ğŸ§ğŸ¼â€â™‚	dÃ¸v mann, dÃ¸v mann: hudtype 3, hudtype 3
ğŸ§ğŸ½â€â™‚	dÃ¸v mann, dÃ¸v mann: hudtype 4, hudtype 4
ğŸ§ğŸ¾â€â™‚	dÃ¸v mann, dÃ¸v mann: hudtype 5, hudtype 5
ğŸ§ğŸ¿â€â™‚	dÃ¸v mann, dÃ¸v mann: hudtype 6, hudtype 6
ğŸ§â€â™€	dÃ¸v kvinne
ğŸ§ğŸ»â€â™€	dÃ¸v kvinne, dÃ¸v kvinne: hudtype 1â€“2, hudtype 1â€“2
ğŸ§ğŸ¼â€â™€	dÃ¸v kvinne, dÃ¸v kvinne: hudtype 3, hudtype 3
ğŸ§ğŸ½â€â™€	dÃ¸v kvinne, dÃ¸v kvinne: hudtype 4, hudtype 4
ğŸ§ğŸ¾â€â™€	dÃ¸v kvinne, dÃ¸v kvinne: hudtype 5, hudtype 5
ğŸ§ğŸ¿â€â™€	dÃ¸v kvinne, dÃ¸v kvinne: hudtype 6, hudtype 6
ğŸ™‡	beklagelse, beklager, bukk, bukker, unnskyld
ğŸ™‡ğŸ»	beklagelse, beklager, bukk, bukker, bukker: hudtype 1â€“2, hudtype 1â€“2, unnskyld
ğŸ™‡ğŸ¼	beklagelse, beklager, bukk, bukker, bukker: hudtype 3, hudtype 3, unnskyld
ğŸ™‡ğŸ½	beklagelse, beklager, bukk, bukker, bukker: hudtype 4, hudtype 4, unnskyld
ğŸ™‡ğŸ¾	beklagelse, beklager, bukk, bukker, bukker: hudtype 5, hudtype 5, unnskyld
ğŸ™‡ğŸ¿	beklagelse, beklager, bukk, bukker, bukker: hudtype 6, hudtype 6, unnskyld
ğŸ™‡â€â™‚	beklagelse, bukk, bukkende mann, mann, unnskyld
ğŸ™‡ğŸ»â€â™‚	beklagelse, bukk, bukkende mann, bukkende mann: hudtype 1â€“2, hudtype 1â€“2, mann, unnskyld
ğŸ™‡ğŸ¼â€â™‚	beklagelse, bukk, bukkende mann, bukkende mann: hudtype 3, hudtype 3, mann, unnskyld
ğŸ™‡ğŸ½â€â™‚	beklagelse, bukk, bukkende mann, bukkende mann: hudtype 4, hudtype 4, mann, unnskyld
ğŸ™‡ğŸ¾â€â™‚	beklagelse, bukk, bukkende mann, bukkende mann: hudtype 5, hudtype 5, mann, unnskyld
ğŸ™‡ğŸ¿â€â™‚	beklagelse, bukk, bukkende mann, bukkende mann: hudtype 6, hudtype 6, mann, unnskyld
ğŸ™‡â€â™€	beklagelse, bukk, bukkende kvinne, kvinne, unnskyld
ğŸ™‡ğŸ»â€â™€	beklagelse, bukk, bukkende kvinne, bukkende kvinne: hudtype 1â€“2, hudtype 1â€“2, kvinne, unnskyld
ğŸ™‡ğŸ¼â€â™€	beklagelse, bukk, bukkende kvinne, bukkende kvinne: hudtype 3, hudtype 3, kvinne, unnskyld
ğŸ™‡ğŸ½â€â™€	beklagelse, bukk, bukkende kvinne, bukkende kvinne: hudtype 4, hudtype 4, kvinne, unnskyld
ğŸ™‡ğŸ¾â€â™€	beklagelse, bukk, bukkende kvinne, bukkende kvinne: hudtype 5, hudtype 5, kvinne, unnskyld
ğŸ™‡ğŸ¿â€â™€	beklagelse, bukk, bukkende kvinne, bukkende kvinne: hudtype 6, hudtype 6, kvinne, unnskyld
ğŸ¤¦	ansikt, facepalm, fjes, irritasjon, oppgitt, slÃ¥r hÃ¥nden mot pannen, vantro
ğŸ¤¦ğŸ»	ansikt, facepalm, fjes, hudtype 1â€“2, irritasjon, oppgitt, slÃ¥r hÃ¥nden mot pannen, slÃ¥r hÃ¥nden mot pannen: hudtype 1â€“2, vantro
ğŸ¤¦ğŸ¼	ansikt, facepalm, fjes, hudtype 3, irritasjon, oppgitt, slÃ¥r hÃ¥nden mot pannen, slÃ¥r hÃ¥nden mot pannen: hudtype 3, vantro
ğŸ¤¦ğŸ½	ansikt, facepalm, fjes, hudtype 4, irritasjon, oppgitt, slÃ¥r hÃ¥nden mot pannen, slÃ¥r hÃ¥nden mot pannen: hudtype 4, vantro
ğŸ¤¦ğŸ¾	ansikt, facepalm, fjes, hudtype 5, irritasjon, oppgitt, slÃ¥r hÃ¥nden mot pannen, slÃ¥r hÃ¥nden mot pannen: hudtype 5, vantro
ğŸ¤¦ğŸ¿	ansikt, facepalm, fjes, hudtype 6, irritasjon, oppgitt, slÃ¥r hÃ¥nden mot pannen, slÃ¥r hÃ¥nden mot pannen: hudtype 6, vantro
ğŸ¤¦â€â™‚	ansikt, facepalm, fjes, irritasjon, mann, mann som slÃ¥r hÃ¥nden mot pannen, oppgitt, vantro
ğŸ¤¦ğŸ»â€â™‚	ansikt, facepalm, fjes, hudtype 1â€“2, irritasjon, mann, mann som slÃ¥r hÃ¥nden mot pannen, mann som slÃ¥r hÃ¥nden mot pannen: hudtype 1â€“2, oppgitt, vantro
ğŸ¤¦ğŸ¼â€â™‚	ansikt, facepalm, fjes, hudtype 3, irritasjon, mann, mann som slÃ¥r hÃ¥nden mot pannen, mann som slÃ¥r hÃ¥nden mot pannen: hudtype 3, oppgitt, vantro
ğŸ¤¦ğŸ½â€â™‚	ansikt, facepalm, fjes, hudtype 4, irritasjon, mann, mann som slÃ¥r hÃ¥nden mot pannen, mann som slÃ¥r hÃ¥nden mot pannen: hudtype 4, oppgitt, vantro
ğŸ¤¦ğŸ¾â€â™‚	ansikt, facepalm, fjes, hudtype 5, irritasjon, mann, mann som slÃ¥r hÃ¥nden mot pannen, mann som slÃ¥r hÃ¥nden mot pannen: hudtype 5, oppgitt, vantro
ğŸ¤¦ğŸ¿â€â™‚	ansikt, facepalm, fjes, hudtype 6, irritasjon, mann, mann som slÃ¥r hÃ¥nden mot pannen, mann som slÃ¥r hÃ¥nden mot pannen: hudtype 6, oppgitt, vantro
ğŸ¤¦â€â™€	ansikt, facepalm, fjes, irritasjon, kvinne, kvinne som slÃ¥r hÃ¥nden mot pannen, oppgitt, vantro
ğŸ¤¦ğŸ»â€â™€	ansikt, facepalm, fjes, hudtype 1â€“2, irritasjon, kvinne, kvinne som slÃ¥r hÃ¥nden mot pannen, kvinne som slÃ¥r hÃ¥nden mot pannen: hudtype 1â€“2, oppgitt, vantro
ğŸ¤¦ğŸ¼â€â™€	ansikt, facepalm, fjes, hudtype 3, irritasjon, kvinne, kvinne som slÃ¥r hÃ¥nden mot pannen, kvinne som slÃ¥r hÃ¥nden mot pannen: hudtype 3, oppgitt, vantro
ğŸ¤¦ğŸ½â€â™€	ansikt, facepalm, fjes, hudtype 4, irritasjon, kvinne, kvinne som slÃ¥r hÃ¥nden mot pannen, kvinne som slÃ¥r hÃ¥nden mot pannen: hudtype 4, oppgitt, vantro
ğŸ¤¦ğŸ¾â€â™€	ansikt, facepalm, fjes, hudtype 5, irritasjon, kvinne, kvinne som slÃ¥r hÃ¥nden mot pannen, kvinne som slÃ¥r hÃ¥nden mot pannen: hudtype 5, oppgitt, vantro
ğŸ¤¦ğŸ¿â€â™€	ansikt, facepalm, fjes, hudtype 6, irritasjon, kvinne, kvinne som slÃ¥r hÃ¥nden mot pannen, kvinne som slÃ¥r hÃ¥nden mot pannen: hudtype 6, oppgitt, vantro
ğŸ¤·	likegyldighet, skuldertrekning, trekker pÃ¥ skuldrene, tvil
ğŸ¤·ğŸ»	hudtype 1â€“2, likegyldighet, skuldertrekning, trekker pÃ¥ skuldrene, trekker pÃ¥ skuldrene: hudtype 1â€“2, tvil
ğŸ¤·ğŸ¼	hudtype 3, likegyldighet, skuldertrekning, trekker pÃ¥ skuldrene, trekker pÃ¥ skuldrene: hudtype 3, tvil
ğŸ¤·ğŸ½	hudtype 4, likegyldighet, skuldertrekning, trekker pÃ¥ skuldrene, trekker pÃ¥ skuldrene: hudtype 4, tvil
ğŸ¤·ğŸ¾	hudtype 5, likegyldighet, skuldertrekning, trekker pÃ¥ skuldrene, trekker pÃ¥ skuldrene: hudtype 5, tvil
ğŸ¤·ğŸ¿	hudtype 6, likegyldighet, skuldertrekning, trekker pÃ¥ skuldrene, trekker pÃ¥ skuldrene: hudtype 6, tvil
ğŸ¤·â€â™‚	likegyldighet, mann, mann som trekker pÃ¥ skuldrene, skuldertrekning, tvil
ğŸ¤·ğŸ»â€â™‚	hudtype 1â€“2, likegyldighet, mann, mann som trekker pÃ¥ skuldrene, mann som trekker pÃ¥ skuldrene: hudtype 1â€“2, skuldertrekning, tvil
ğŸ¤·ğŸ¼â€â™‚	hudtype 3, likegyldighet, mann, mann som trekker pÃ¥ skuldrene, mann som trekker pÃ¥ skuldrene: hudtype 3, skuldertrekning, tvil
ğŸ¤·ğŸ½â€â™‚	hudtype 4, likegyldighet, mann, mann som trekker pÃ¥ skuldrene, mann som trekker pÃ¥ skuldrene: hudtype 4, skuldertrekning, tvil
ğŸ¤·ğŸ¾â€â™‚	hudtype 5, likegyldighet, mann, mann som trekker pÃ¥ skuldrene, mann som trekker pÃ¥ skuldrene: hudtype 5, skuldertrekning, tvil
ğŸ¤·ğŸ¿â€â™‚	hudtype 6, likegyldighet, mann, mann som trekker pÃ¥ skuldrene, mann som trekker pÃ¥ skuldrene: hudtype 6, skuldertrekning, tvil
ğŸ¤·â€â™€	kvinne, kvinne som trekker pÃ¥ skuldrene, likegyldighet, skuldertrekning, tvil
ğŸ¤·ğŸ»â€â™€	hudtype 1â€“2, kvinne, kvinne som trekker pÃ¥ skuldrene, kvinne som trekker pÃ¥ skuldrene: hudtype 1â€“2, likegyldighet, skuldertrekning, tvil
ğŸ¤·ğŸ¼â€â™€	hudtype 3, kvinne, kvinne som trekker pÃ¥ skuldrene, kvinne som trekker pÃ¥ skuldrene: hudtype 3, likegyldighet, skuldertrekning, tvil
ğŸ¤·ğŸ½â€â™€	hudtype 4, kvinne, kvinne som trekker pÃ¥ skuldrene, kvinne som trekker pÃ¥ skuldrene: hudtype 4, likegyldighet, skuldertrekning, tvil
ğŸ¤·ğŸ¾â€â™€	hudtype 5, kvinne, kvinne som trekker pÃ¥ skuldrene, kvinne som trekker pÃ¥ skuldrene: hudtype 5, likegyldighet, skuldertrekning, tvil
ğŸ¤·ğŸ¿â€â™€	hudtype 6, kvinne, kvinne som trekker pÃ¥ skuldrene, kvinne som trekker pÃ¥ skuldrene: hudtype 6, likegyldighet, skuldertrekning, tvil
ğŸ‘¨â€âš•	doktor, helsevesen, lege, mann, mannlig lege
ğŸ‘¨ğŸ»â€âš•	doktor, helsevesen, hudtype 1â€“2, lege, mann, mannlig lege, mannlig lege: hudtype 1â€“2
ğŸ‘¨ğŸ¼â€âš•	doktor, helsevesen, hudtype 3, lege, mann, mannlig lege, mannlig lege: hudtype 3
ğŸ‘¨ğŸ½â€âš•	doktor, helsevesen, hudtype 4, lege, mann, mannlig lege, mannlig lege: hudtype 4
ğŸ‘¨ğŸ¾â€âš•	doktor, helsevesen, hudtype 5, lege, mann, mannlig lege, mannlig lege: hudtype 5
ğŸ‘¨ğŸ¿â€âš•	doktor, helsevesen, hudtype 6, lege, mann, mannlig lege, mannlig lege: hudtype 6
ğŸ‘©â€âš•	doktor, helsevesen, kvinne, kvinnelig lege, lege
ğŸ‘©ğŸ»â€âš•	doktor, helsevesen, hudtype 1â€“2, kvinne, kvinnelig lege, kvinnelig lege: hudtype 1â€“2, lege
ğŸ‘©ğŸ¼â€âš•	doktor, helsevesen, hudtype 3, kvinne, kvinnelig lege, kvinnelig lege: hudtype 3, lege
ğŸ‘©ğŸ½â€âš•	doktor, helsevesen, hudtype 4, kvinne, kvinnelig lege, kvinnelig lege: hudtype 4, lege
ğŸ‘©ğŸ¾â€âš•	doktor, helsevesen, hudtype 5, kvinne, kvinnelig lege, kvinnelig lege: hudtype 5, lege
ğŸ‘©ğŸ¿â€âš•	doktor, helsevesen, hudtype 6, kvinne, kvinnelig lege, kvinnelig lege: hudtype 6, lege
ğŸ‘¨â€ğŸ“	mann, mannlig student, skole, student, universitet
ğŸ‘¨ğŸ»â€ğŸ“	hudtype 1â€“2, mann, mannlig student, mannlig student: hudtype 1â€“2, skole, student, universitet
ğŸ‘¨ğŸ¼â€ğŸ“	hudtype 3, mann, mannlig student, mannlig student: hudtype 3, skole, student, universitet
ğŸ‘¨ğŸ½â€ğŸ“	hudtype 4, mann, mannlig student, mannlig student: hudtype 4, skole, student, universitet
ğŸ‘¨ğŸ¾â€ğŸ“	hudtype 5, mann, mannlig student, mannlig student: hudtype 5, skole, student, universitet
ğŸ‘¨ğŸ¿â€ğŸ“	hudtype 6, mann, mannlig student, mannlig student: hudtype 6, skole, student, universitet
ğŸ‘©â€ğŸ“	kvinne, kvinnelig student, skole, student, universitet
ğŸ‘©ğŸ»â€ğŸ“	hudtype 1â€“2, kvinne, kvinnelig student, kvinnelig student: hudtype 1â€“2, skole, student, universitet
ğŸ‘©ğŸ¼â€ğŸ“	hudtype 3, kvinne, kvinnelig student, kvinnelig student: hudtype 3, skole, student, universitet
ğŸ‘©ğŸ½â€ğŸ“	hudtype 4, kvinne, kvinnelig student, kvinnelig student: hudtype 4, skole, student, universitet
ğŸ‘©ğŸ¾â€ğŸ“	hudtype 5, kvinne, kvinnelig student, kvinnelig student: hudtype 5, skole, student, universitet
ğŸ‘©ğŸ¿â€ğŸ“	hudtype 6, kvinne, kvinnelig student, kvinnelig student: hudtype 6, skole, student, universitet
ğŸ‘¨â€ğŸ«	lÃ¦rer, mann, mannlig lÃ¦rer, skole, undervisning
ğŸ‘¨ğŸ»â€ğŸ«	hudtype 1â€“2, lÃ¦rer, mann, mannlig lÃ¦rer, mannlig lÃ¦rer: hudtype 1â€“2, skole, undervisning
ğŸ‘¨ğŸ¼â€ğŸ«	hudtype 3, lÃ¦rer, mann, mannlig lÃ¦rer, mannlig lÃ¦rer: hudtype 3, skole, undervisning
ğŸ‘¨ğŸ½â€ğŸ«	hudtype 4, lÃ¦rer, mann, mannlig lÃ¦rer, mannlig lÃ¦rer: hudtype 4, skole, undervisning
ğŸ‘¨ğŸ¾â€ğŸ«	hudtype 5, lÃ¦rer, mann, mannlig lÃ¦rer, mannlig lÃ¦rer: hudtype 5, skole, undervisning
ğŸ‘¨ğŸ¿â€ğŸ«	hudtype 6, lÃ¦rer, mann, mannlig lÃ¦rer, mannlig lÃ¦rer: hudtype 6, skole, undervisning
ğŸ‘©â€ğŸ«	kvinne, kvinnelig lÃ¦rer, lÃ¦rer, skole, undervisning
ğŸ‘©ğŸ»â€ğŸ«	hudtype 1â€“2, kvinne, kvinnelig lÃ¦rer, kvinnelig lÃ¦rer: hudtype 1â€“2, lÃ¦rer, skole, undervisning
ğŸ‘©ğŸ¼â€ğŸ«	hudtype 3, kvinne, kvinnelig lÃ¦rer, kvinnelig lÃ¦rer: hudtype 3, lÃ¦rer, skole, undervisning
ğŸ‘©ğŸ½â€ğŸ«	hudtype 4, kvinne, kvinnelig lÃ¦rer, kvinnelig lÃ¦rer: hudtype 4, lÃ¦rer, skole, undervisning
ğŸ‘©ğŸ¾â€ğŸ«	hudtype 5, kvinne, kvinnelig lÃ¦rer, kvinnelig lÃ¦rer: hudtype 5, lÃ¦rer, skole, undervisning
ğŸ‘©ğŸ¿â€ğŸ«	hudtype 6, kvinne, kvinnelig lÃ¦rer, kvinnelig lÃ¦rer: hudtype 6, lÃ¦rer, skole, undervisning
ğŸ‘¨â€âš–	dommer, jus, mann, mannlig dommer, rettssak
ğŸ‘¨ğŸ»â€âš–	dommer, hudtype 1â€“2, jus, mann, mannlig dommer, mannlig dommer: hudtype 1â€“2, rettssak
ğŸ‘¨ğŸ¼â€âš–	dommer, hudtype 3, jus, mann, mannlig dommer, mannlig dommer: hudtype 3, rettssak
ğŸ‘¨ğŸ½â€âš–	dommer, hudtype 4, jus, mann, mannlig dommer, mannlig dommer: hudtype 4, rettssak
ğŸ‘¨ğŸ¾â€âš–	dommer, hudtype 5, jus, mann, mannlig dommer, mannlig dommer: hudtype 5, rettssak
ğŸ‘¨ğŸ¿â€âš–	dommer, hudtype 6, jus, mann, mannlig dommer, mannlig dommer: hudtype 6, rettssak
ğŸ‘©â€âš–	dommer, jus, juss, kvinne, kvinnelig dommer, rettssak
ğŸ‘©ğŸ»â€âš–	dommer, hudtype 1â€“2, jus, juss, kvinne, kvinnelig dommer, kvinnelig dommer: hudtype 1â€“2, rettssak
ğŸ‘©ğŸ¼â€âš–	dommer, hudtype 3, jus, juss, kvinne, kvinnelig dommer, kvinnelig dommer: hudtype 3, rettssak
ğŸ‘©ğŸ½â€âš–	dommer, hudtype 4, jus, juss, kvinne, kvinnelig dommer, kvinnelig dommer: hudtype 4, rettssak
ğŸ‘©ğŸ¾â€âš–	dommer, hudtype 5, jus, juss, kvinne, kvinnelig dommer, kvinnelig dommer: hudtype 5, rettssak
ğŸ‘©ğŸ¿â€âš–	dommer, hudtype 6, jus, juss, kvinne, kvinnelig dommer, kvinnelig dommer: hudtype 6, rettssak
ğŸ‘¨â€ğŸŒ¾	bonde, dyrke, jordbruk, mann, mannlig bonde
ğŸ‘¨ğŸ»â€ğŸŒ¾	bonde, dyrke, hudtype 1â€“2, jordbruk, mann, mannlig bonde, mannlig bonde: hudtype 1â€“2
ğŸ‘¨ğŸ¼â€ğŸŒ¾	bonde, dyrke, hudtype 3, jordbruk, mann, mannlig bonde, mannlig bonde: hudtype 3
ğŸ‘¨ğŸ½â€ğŸŒ¾	bonde, dyrke, hudtype 4, jordbruk, mann, mannlig bonde, mannlig bonde: hudtype 4
ğŸ‘¨ğŸ¾â€ğŸŒ¾	bonde, dyrke, hudtype 5, jordbruk, mann, mannlig bonde, mannlig bonde: hudtype 5
ğŸ‘¨ğŸ¿â€ğŸŒ¾	bonde, dyrke, hudtype 6, jordbruk, mann, mannlig bonde, mannlig bonde: hudtype 6
ğŸ‘©â€ğŸŒ¾	bonde, dyrke, jordbruk, kvinne, kvinnelig bonde
ğŸ‘©ğŸ»â€ğŸŒ¾	bonde, dyrke, hudtype 1â€“2, jordbruk, kvinne, kvinnelig bonde, kvinnelig bonde: hudtype 1â€“2
ğŸ‘©ğŸ¼â€ğŸŒ¾	bonde, dyrke, hudtype 3, jordbruk, kvinne, kvinnelig bonde, kvinnelig bonde: hudtype 3
ğŸ‘©ğŸ½â€ğŸŒ¾	bonde, dyrke, hudtype 4, jordbruk, kvinne, kvinnelig bonde, kvinnelig bonde: hudtype 4
ğŸ‘©ğŸ¾â€ğŸŒ¾	bonde, dyrke, hudtype 5, jordbruk, kvinne, kvinnelig bonde, kvinnelig bonde: hudtype 5
ğŸ‘©ğŸ¿â€ğŸŒ¾	bonde, dyrke, hudtype 6, jordbruk, kvinne, kvinnelig bonde, kvinnelig bonde: hudtype 6
ğŸ‘¨â€ğŸ³	mann, mannlig kokk, matlaging, restaurant
ğŸ‘¨ğŸ»â€ğŸ³	hudtype 1â€“2, mann, mannlig kokk, mannlig kokk: hudtype 1â€“2, matlaging, restaurant
ğŸ‘¨ğŸ¼â€ğŸ³	hudtype 3, mann, mannlig kokk, mannlig kokk: hudtype 3, matlaging, restaurant
ğŸ‘¨ğŸ½â€ğŸ³	hudtype 4, mann, mannlig kokk, mannlig kokk: hudtype 4, matlaging, restaurant
ğŸ‘¨ğŸ¾â€ğŸ³	hudtype 5, mann, mannlig kokk, mannlig kokk: hudtype 5, matlaging, restaurant
ğŸ‘¨ğŸ¿â€ğŸ³	hudtype 6, mann, mannlig kokk, mannlig kokk: hudtype 6, matlaging, restaurant
ğŸ‘©â€ğŸ³	kvinne, kvinnelig kokk, matlaging, restaurant
ğŸ‘©ğŸ»â€ğŸ³	hudtype 1â€“2, kvinne, kvinnelig kokk, kvinnelig kokk: hudtype 1â€“2, matlaging, restaurant
ğŸ‘©ğŸ¼â€ğŸ³	hudtype 3, kvinne, kvinnelig kokk, kvinnelig kokk: hudtype 3, matlaging, restaurant
ğŸ‘©ğŸ½â€ğŸ³	hudtype 4, kvinne, kvinnelig kokk, kvinnelig kokk: hudtype 4, matlaging, restaurant
ğŸ‘©ğŸ¾â€ğŸ³	hudtype 5, kvinne, kvinnelig kokk, kvinnelig kokk: hudtype 5, matlaging, restaurant
ğŸ‘©ğŸ¿â€ğŸ³	hudtype 6, kvinne, kvinnelig kokk, kvinnelig kokk: hudtype 6, matlaging, restaurant
ğŸ‘¨â€ğŸ”§	bil, mann, mannlig mekaniker, mekaniker, motor
ğŸ‘¨ğŸ»â€ğŸ”§	bil, hudtype 1â€“2, mann, mannlig mekaniker, mannlig mekaniker: hudtype 1â€“2, mekaniker, motor
ğŸ‘¨ğŸ¼â€ğŸ”§	bil, hudtype 3, mann, mannlig mekaniker, mannlig mekaniker: hudtype 3, mekaniker, motor
ğŸ‘¨ğŸ½â€ğŸ”§	bil, hudtype 4, mann, mannlig mekaniker, mannlig mekaniker: hudtype 4, mekaniker, motor
ğŸ‘¨ğŸ¾â€ğŸ”§	bil, hudtype 5, mann, mannlig mekaniker, mannlig mekaniker: hudtype 5, mekaniker, motor
ğŸ‘¨ğŸ¿â€ğŸ”§	bil, hudtype 6, mann, mannlig mekaniker, mannlig mekaniker: hudtype 6, mekaniker, motor
ğŸ‘©â€ğŸ”§	bil, kvinne, kvinnelig mekaniker, mekaniker, motor
ğŸ‘©ğŸ»â€ğŸ”§	bil, hudtype 1â€“2, kvinne, kvinnelig mekaniker, kvinnelig mekaniker: hudtype 1â€“2, mekaniker, motor
ğŸ‘©ğŸ¼â€ğŸ”§	bil, hudtype 3, kvinne, kvinnelig mekaniker, kvinnelig mekaniker: hudtype 3, mekaniker, motor
ğŸ‘©ğŸ½â€ğŸ”§	bil, hudtype 4, kvinne, kvinnelig mekaniker, kvinnelig mekaniker: hudtype 4, mekaniker, motor
ğŸ‘©ğŸ¾â€ğŸ”§	bil, hudtype 5, kvinne, kvinnelig mekaniker, kvinnelig mekaniker: hudtype 5, mekaniker, motor
ğŸ‘©ğŸ¿â€ğŸ”§	bil, hudtype 6, kvinne, kvinnelig mekaniker, kvinnelig mekaniker: hudtype 6, mekaniker, motor
ğŸ‘¨â€ğŸ­	fabrikk, industri, mann, mannlig industriarbeider, produksjon
ğŸ‘¨ğŸ»â€ğŸ­	fabrikk, hudtype 1â€“2, industri, mann, mannlig industriarbeider, mannlig industriarbeider: hudtype 1â€“2, produksjon
ğŸ‘¨ğŸ¼â€ğŸ­	fabrikk, hudtype 3, industri, mann, mannlig industriarbeider, mannlig industriarbeider: hudtype 3, produksjon
ğŸ‘¨ğŸ½â€ğŸ­	fabrikk, hudtype 4, industri, mann, mannlig industriarbeider, mannlig industriarbeider: hudtype 4, produksjon
ğŸ‘¨ğŸ¾â€ğŸ­	fabrikk, hudtype 5, industri, mann, mannlig industriarbeider, mannlig industriarbeider: hudtype 5, produksjon
ğŸ‘¨ğŸ¿â€ğŸ­	fabrikk, hudtype 6, industri, mann, mannlig industriarbeider, mannlig industriarbeider: hudtype 6, produksjon
ğŸ‘©â€ğŸ­	fabrikk, industri, kvinne, kvinnelig industriarbeider, produksjon
ğŸ‘©ğŸ»â€ğŸ­	fabrikk, hudtype 1â€“2, industri, kvinne, kvinnelig industriarbeider, kvinnelig industriarbeider: hudtype 1â€“2, produksjon
ğŸ‘©ğŸ¼â€ğŸ­	fabrikk, hudtype 3, industri, kvinne, kvinnelig industriarbeider, kvinnelig industriarbeider: hudtype 3, produksjon
ğŸ‘©ğŸ½â€ğŸ­	fabrikk, hudtype 4, industri, kvinne, kvinnelig industriarbeider, kvinnelig industriarbeider: hudtype 4, produksjon
ğŸ‘©ğŸ¾â€ğŸ­	fabrikk, hudtype 5, industri, kvinne, kvinnelig industriarbeider, kvinnelig industriarbeider: hudtype 5, produksjon
ğŸ‘©ğŸ¿â€ğŸ­	fabrikk, hudtype 6, industri, kvinne, kvinnelig industriarbeider, kvinnelig industriarbeider: hudtype 6, produksjon
ğŸ‘¨â€ğŸ’¼	kontor, mann, mannlig kontorarbeider, nÃ¦ringsliv
ğŸ‘¨ğŸ»â€ğŸ’¼	hudtype 1â€“2, kontor, mann, mannlig kontorarbeider, mannlig kontorarbeider: hudtype 1â€“2, nÃ¦ringsliv
ğŸ‘¨ğŸ¼â€ğŸ’¼	hudtype 3, kontor, mann, mannlig kontorarbeider, mannlig kontorarbeider: hudtype 3, nÃ¦ringsliv
ğŸ‘¨ğŸ½â€ğŸ’¼	hudtype 4, kontor, mann, mannlig kontorarbeider, mannlig kontorarbeider: hudtype 4, nÃ¦ringsliv
ğŸ‘¨ğŸ¾â€ğŸ’¼	hudtype 5, kontor, mann, mannlig kontorarbeider, mannlig kontorarbeider: hudtype 5, nÃ¦ringsliv
ğŸ‘¨ğŸ¿â€ğŸ’¼	hudtype 6, kontor, mann, mannlig kontorarbeider, mannlig kontorarbeider: hudtype 6, nÃ¦ringsliv
ğŸ‘©â€ğŸ’¼	kontor, kvinne, kvinnelig kontorarbeider, nÃ¦ringsliv
ğŸ‘©ğŸ»â€ğŸ’¼	hudtype 1â€“2, kontor, kvinne, kvinnelig kontorarbeider, kvinnelig kontorarbeider: hudtype 1â€“2, nÃ¦ringsliv
ğŸ‘©ğŸ¼â€ğŸ’¼	hudtype 3, kontor, kvinne, kvinnelig kontorarbeider, kvinnelig kontorarbeider: hudtype 3, nÃ¦ringsliv
ğŸ‘©ğŸ½â€ğŸ’¼	hudtype 4, kontor, kvinne, kvinnelig kontorarbeider, kvinnelig kontorarbeider: hudtype 4, nÃ¦ringsliv
ğŸ‘©ğŸ¾â€ğŸ’¼	hudtype 5, kontor, kvinne, kvinnelig kontorarbeider, kvinnelig kontorarbeider: hudtype 5, nÃ¦ringsliv
ğŸ‘©ğŸ¿â€ğŸ’¼	hudtype 6, kontor, kvinne, kvinnelig kontorarbeider, kvinnelig kontorarbeider: hudtype 6, nÃ¦ringsliv
ğŸ‘¨â€ğŸ”¬	kjemi, laboratorium, mann, mannlig forsker, vitenskap
ğŸ‘¨ğŸ»â€ğŸ”¬	hudtype 1â€“2, kjemi, laboratorium, mann, mannlig forsker, mannlig forsker: hudtype 1â€“2, vitenskap
ğŸ‘¨ğŸ¼â€ğŸ”¬	hudtype 3, kjemi, laboratorium, mann, mannlig forsker, mannlig forsker: hudtype 3, vitenskap
ğŸ‘¨ğŸ½â€ğŸ”¬	hudtype 4, kjemi, laboratorium, mann, mannlig forsker, mannlig forsker: hudtype 4, vitenskap
ğŸ‘¨ğŸ¾â€ğŸ”¬	hudtype 5, kjemi, laboratorium, mann, mannlig forsker, mannlig forsker: hudtype 5, vitenskap
ğŸ‘¨ğŸ¿â€ğŸ”¬	hudtype 6, kjemi, laboratorium, mann, mannlig forsker, mannlig forsker: hudtype 6, vitenskap
ğŸ‘©â€ğŸ”¬	kjemi, kvinne, kvinnelig forsker, laboratorium, vitenskap
ğŸ‘©ğŸ»â€ğŸ”¬	hudtype 1â€“2, kjemi, kvinne, kvinnelig forsker, kvinnelig forsker: hudtype 1â€“2, laboratorium, vitenskap
ğŸ‘©ğŸ¼â€ğŸ”¬	hudtype 3, kjemi, kvinne, kvinnelig forsker, kvinnelig forsker: hudtype 3, laboratorium, vitenskap
ğŸ‘©ğŸ½â€ğŸ”¬	hudtype 4, kjemi, kvinne, kvinnelig forsker, kvinnelig forsker: hudtype 4, laboratorium, vitenskap
ğŸ‘©ğŸ¾â€ğŸ”¬	hudtype 5, kjemi, kvinne, kvinnelig forsker, kvinnelig forsker: hudtype 5, laboratorium, vitenskap
ğŸ‘©ğŸ¿â€ğŸ”¬	hudtype 6, kjemi, kvinne, kvinnelig forsker, kvinnelig forsker: hudtype 6, laboratorium, vitenskap
ğŸ‘¨â€ğŸ’»	IT, data, mann, mannlig IT-ekspert, teknologi
ğŸ‘¨ğŸ»â€ğŸ’»	IT, data, hudtype 1â€“2, mann, mannlig IT-ekspert, mannlig IT-ekspert: hudtype 1â€“2, teknologi
ğŸ‘¨ğŸ¼â€ğŸ’»	IT, data, hudtype 3, mann, mannlig IT-ekspert, mannlig IT-ekspert: hudtype 3, teknologi
ğŸ‘¨ğŸ½â€ğŸ’»	IT, data, hudtype 4, mann, mannlig IT-ekspert, mannlig IT-ekspert: hudtype 4, teknologi
ğŸ‘¨ğŸ¾â€ğŸ’»	IT, data, hudtype 5, mann, mannlig IT-ekspert, mannlig IT-ekspert: hudtype 5, teknologi
ğŸ‘¨ğŸ¿â€ğŸ’»	IT, data, hudtype 6, mann, mannlig IT-ekspert, mannlig IT-ekspert: hudtype 6, teknologi
ğŸ‘©â€ğŸ’»	IT, data, kvinne, kvinnelig IT-ekspert, teknologi
ğŸ‘©ğŸ»â€ğŸ’»	IT, data, hudtype 1â€“2, kvinne, kvinnelig IT-ekspert, kvinnelig IT-ekspert: hudtype 1â€“2, teknologi
ğŸ‘©ğŸ¼â€ğŸ’»	IT, data, hudtype 3, kvinne, kvinnelig IT-ekspert, kvinnelig IT-ekspert: hudtype 3, teknologi
ğŸ‘©ğŸ½â€ğŸ’»	IT, data, hudtype 4, kvinne, kvinnelig IT-ekspert, kvinnelig IT-ekspert: hudtype 4, teknologi
ğŸ‘©ğŸ¾â€ğŸ’»	IT, data, hudtype 5, kvinne, kvinnelig IT-ekspert, kvinnelig IT-ekspert: hudtype 5, teknologi
ğŸ‘©ğŸ¿â€ğŸ’»	IT, data, hudtype 6, kvinne, kvinnelig IT-ekspert, kvinnelig IT-ekspert: hudtype 6, teknologi
ğŸ‘¨â€ğŸ¤	artist, konsert, mann, mannlig artist, sanger
ğŸ‘¨ğŸ»â€ğŸ¤	artist, hudtype 1â€“2, konsert, mann, mannlig artist, mannlig artist: hudtype 1â€“2, sanger
ğŸ‘¨ğŸ¼â€ğŸ¤	artist, hudtype 3, konsert, mann, mannlig artist, mannlig artist: hudtype 3, sanger
ğŸ‘¨ğŸ½â€ğŸ¤	artist, hudtype 4, konsert, mann, mannlig artist, mannlig artist: hudtype 4, sanger
ğŸ‘¨ğŸ¾â€ğŸ¤	artist, hudtype 5, konsert, mann, mannlig artist, mannlig artist: hudtype 5, sanger
ğŸ‘¨ğŸ¿â€ğŸ¤	artist, hudtype 6, konsert, mann, mannlig artist, mannlig artist: hudtype 6, sanger
ğŸ‘©â€ğŸ¤	artist, konsert, kvinne, kvinnelig artist, sangerinne
ğŸ‘©ğŸ»â€ğŸ¤	artist, hudtype 1â€“2, konsert, kvinne, kvinnelig artist, kvinnelig artist: hudtype 1â€“2, sangerinne
ğŸ‘©ğŸ¼â€ğŸ¤	artist, hudtype 3, konsert, kvinne, kvinnelig artist, kvinnelig artist: hudtype 3, sangerinne
ğŸ‘©ğŸ½â€ğŸ¤	artist, hudtype 4, konsert, kvinne, kvinnelig artist, kvinnelig artist: hudtype 4, sangerinne
ğŸ‘©ğŸ¾â€ğŸ¤	artist, hudtype 5, konsert, kvinne, kvinnelig artist, kvinnelig artist: hudtype 5, sangerinne
ğŸ‘©ğŸ¿â€ğŸ¤	artist, hudtype 6, konsert, kvinne, kvinnelig artist, kvinnelig artist: hudtype 6, sangerinne
ğŸ‘¨â€ğŸ¨	kunstner, maler, mann, mannlig kunstner
ğŸ‘¨ğŸ»â€ğŸ¨	hudtype 1â€“2, kunstner, maler, mann, mannlig kunstner, mannlig kunstner: hudtype 1â€“2
ğŸ‘¨ğŸ¼â€ğŸ¨	hudtype 3, kunstner, maler, mann, mannlig kunstner, mannlig kunstner: hudtype 3
ğŸ‘¨ğŸ½â€ğŸ¨	hudtype 4, kunstner, maler, mann, mannlig kunstner, mannlig kunstner: hudtype 4
ğŸ‘¨ğŸ¾â€ğŸ¨	hudtype 5, kunstner, maler, mann, mannlig kunstner, mannlig kunstner: hudtype 5
ğŸ‘¨ğŸ¿â€ğŸ¨	hudtype 6, kunstner, maler, mann, mannlig kunstner, mannlig kunstner: hudtype 6
ğŸ‘©â€ğŸ¨	kunstner, kvinne, kvinnelig kunstner, maler
ğŸ‘©ğŸ»â€ğŸ¨	hudtype 1â€“2, kunstner, kvinne, kvinnelig kunstner, kvinnelig kunstner: hudtype 1â€“2, maler
ğŸ‘©ğŸ¼â€ğŸ¨	hudtype 3, kunstner, kvinne, kvinnelig kunstner, kvinnelig kunstner: hudtype 3, maler
ğŸ‘©ğŸ½â€ğŸ¨	hudtype 4, kunstner, kvinne, kvinnelig kunstner, kvinnelig kunstner: hudtype 4, maler
ğŸ‘©ğŸ¾â€ğŸ¨	hudtype 5, kunstner, kvinne, kvinnelig kunstner, kvinnelig kunstner: hudtype 5, maler
ğŸ‘©ğŸ¿â€ğŸ¨	hudtype 6, kunstner, kvinne, kvinnelig kunstner, kvinnelig kunstner: hudtype 6, maler
ğŸ‘¨â€âœˆ	fly, mann, mannlig pilot, pilot
ğŸ‘¨ğŸ»â€âœˆ	fly, hudtype 1â€“2, mann, mannlig pilot, mannlig pilot: hudtype 1â€“2, pilot
ğŸ‘¨ğŸ¼â€âœˆ	fly, hudtype 3, mann, mannlig pilot, mannlig pilot: hudtype 3, pilot
ğŸ‘¨ğŸ½â€âœˆ	fly, hudtype 4, mann, mannlig pilot, mannlig pilot: hudtype 4, pilot
ğŸ‘¨ğŸ¾â€âœˆ	fly, hudtype 5, mann, mannlig pilot, mannlig pilot: hudtype 5, pilot
ğŸ‘¨ğŸ¿â€âœˆ	fly, hudtype 6, mann, mannlig pilot, mannlig pilot: hudtype 6, pilot
ğŸ‘©â€âœˆ	fly, kvinne, kvinnelig pilot, pilot
ğŸ‘©ğŸ»â€âœˆ	fly, hudtype 1â€“2, kvinne, kvinnelig pilot, kvinnelig pilot: hudtype 1â€“2, pilot
ğŸ‘©ğŸ¼â€âœˆ	fly, hudtype 3, kvinne, kvinnelig pilot, kvinnelig pilot: hudtype 3, pilot
ğŸ‘©ğŸ½â€âœˆ	fly, hudtype 4, kvinne, kvinnelig pilot, kvinnelig pilot: hudtype 4, pilot
ğŸ‘©ğŸ¾â€âœˆ	fly, hudtype 5, kvinne, kvinnelig pilot, kvinnelig pilot: hudtype 5, pilot
ğŸ‘©ğŸ¿â€âœˆ	fly, hudtype 6, kvinne, kvinnelig pilot, kvinnelig pilot: hudtype 6, pilot
ğŸ‘¨â€ğŸš€	astronaut, mann, mannlig astronaut, romfart, verdensrommet
ğŸ‘¨ğŸ»â€ğŸš€	astronaut, hudtype 1â€“2, mann, mannlig astronaut, mannlig astronaut: hudtype 1â€“2, romfart, verdensrommet
ğŸ‘¨ğŸ¼â€ğŸš€	astronaut, hudtype 3, mann, mannlig astronaut, mannlig astronaut: hudtype 3, romfart, verdensrommet
ğŸ‘¨ğŸ½â€ğŸš€	astronaut, hudtype 4, mann, mannlig astronaut, mannlig astronaut: hudtype 4, romfart, verdensrommet
ğŸ‘¨ğŸ¾â€ğŸš€	astronaut, hudtype 5, mann, mannlig astronaut, mannlig astronaut: hudtype 5, romfart, verdensrommet
ğŸ‘¨ğŸ¿â€ğŸš€	astronaut, hudtype 6, mann, mannlig astronaut, mannlig astronaut: hudtype 6, romfart, verdensrommet
ğŸ‘©â€ğŸš€	astronaut, kvinne, kvinnelig astronaut, romfart, verdensrommet
ğŸ‘©ğŸ»â€ğŸš€	astronaut, hudtype 1â€“2, kvinne, kvinnelig astronaut, kvinnelig astronaut: hudtype 1â€“2, romfart, verdensrommet
ğŸ‘©ğŸ¼â€ğŸš€	astronaut, hudtype 3, kvinne, kvinnelig astronaut, kvinnelig astronaut: hudtype 3, romfart, verdensrommet
ğŸ‘©ğŸ½â€ğŸš€	astronaut, hudtype 4, kvinne, kvinnelig astronaut, kvinnelig astronaut: hudtype 4, romfart, verdensrommet
ğŸ‘©ğŸ¾â€ğŸš€	astronaut, hudtype 5, kvinne, kvinnelig astronaut, kvinnelig astronaut: hudtype 5, romfart, verdensrommet
ğŸ‘©ğŸ¿â€ğŸš€	astronaut, hudtype 6, kvinne, kvinnelig astronaut, kvinnelig astronaut: hudtype 6, romfart, verdensrommet
ğŸ‘¨â€ğŸš’	brannkonstabel, brannmann, brannvesenet, mann, mannlig brannkonstabel
ğŸ‘¨ğŸ»â€ğŸš’	brannkonstabel, brannmann, brannvesenet, hudtype 1â€“2, mann, mannlig brannkonstabel, mannlig brannkonstabel: hudtype 1â€“2
ğŸ‘¨ğŸ¼â€ğŸš’	brannkonstabel, brannmann, brannvesenet, hudtype 3, mann, mannlig brannkonstabel, mannlig brannkonstabel: hudtype 3
ğŸ‘¨ğŸ½â€ğŸš’	brannkonstabel, brannmann, brannvesenet, hudtype 4, mann, mannlig brannkonstabel, mannlig brannkonstabel: hudtype 4
ğŸ‘¨ğŸ¾â€ğŸš’	brannkonstabel, brannmann, brannvesenet, hudtype 5, mann, mannlig brannkonstabel, mannlig brannkonstabel: hudtype 5
ğŸ‘¨ğŸ¿â€ğŸš’	brannkonstabel, brannmann, brannvesenet, hudtype 6, mann, mannlig brannkonstabel, mannlig brannkonstabel: hudtype 6
ğŸ‘©â€ğŸš’	brannkonstabel, brannmann, brannvesenet, kvinne, kvinnelig brannkonstabel
ğŸ‘©ğŸ»â€ğŸš’	brannkonstabel, brannmann, brannvesenet, hudtype 1â€“2, kvinne, kvinnelig brannkonstabel, kvinnelig brannkonstabel: hudtype 1â€“2
ğŸ‘©ğŸ¼â€ğŸš’	brannkonstabel, brannmann, brannvesenet, hudtype 3, kvinne, kvinnelig brannkonstabel, kvinnelig brannkonstabel: hudtype 3
ğŸ‘©ğŸ½â€ğŸš’	brannkonstabel, brannmann, brannvesenet, hudtype 4, kvinne, kvinnelig brannkonstabel, kvinnelig brannkonstabel: hudtype 4
ğŸ‘©ğŸ¾â€ğŸš’	brannkonstabel, brannmann, brannvesenet, hudtype 5, kvinne, kvinnelig brannkonstabel, kvinnelig brannkonstabel: hudtype 5
ğŸ‘©ğŸ¿â€ğŸš’	brannkonstabel, brannmann, brannvesenet, hudtype 6, kvinne, kvinnelig brannkonstabel, kvinnelig brannkonstabel: hudtype 6
ğŸ‘®	menneske, politi, politimann, tjenestemann
ğŸ‘®ğŸ»	hudtype 1â€“2, menneske, politi, politimann, politimann: hudtype 1â€“2, tjenestemann
ğŸ‘®ğŸ¼	hudtype 3, menneske, politi, politimann, politimann: hudtype 3, tjenestemann
ğŸ‘®ğŸ½	hudtype 4, menneske, politi, politimann, politimann: hudtype 4, tjenestemann
ğŸ‘®ğŸ¾	hudtype 5, menneske, politi, politimann, politimann: hudtype 5, tjenestemann
ğŸ‘®ğŸ¿	hudtype 6, menneske, politi, politimann, politimann: hudtype 6, tjenestemann
ğŸ‘®â€â™‚	lov, mann, mannlig politibetjent, politi, politibetjent
ğŸ‘®ğŸ»â€â™‚	hudtype 1â€“2, lov, mann, mannlig politibetjent, mannlig politibetjent: hudtype 1â€“2, politi, politibetjent
ğŸ‘®ğŸ¼â€â™‚	hudtype 3, lov, mann, mannlig politibetjent, mannlig politibetjent: hudtype 3, politi, politibetjent
ğŸ‘®ğŸ½â€â™‚	hudtype 4, lov, mann, mannlig politibetjent, mannlig politibetjent: hudtype 4, politi, politibetjent
ğŸ‘®ğŸ¾â€â™‚	hudtype 5, lov, mann, mannlig politibetjent, mannlig politibetjent: hudtype 5, politi, politibetjent
ğŸ‘®ğŸ¿â€â™‚	hudtype 6, lov, mann, mannlig politibetjent, mannlig politibetjent: hudtype 6, politi, politibetjent
ğŸ‘®â€â™€	kvinne, kvinnelig politibetjent, lov, politi, politibetjent
ğŸ‘®ğŸ»â€â™€	hudtype 1â€“2, kvinne, kvinnelig politibetjent, kvinnelig politibetjent: hudtype 1â€“2, lov, politi, politibetjent
ğŸ‘®ğŸ¼â€â™€	hudtype 3, kvinne, kvinnelig politibetjent, kvinnelig politibetjent: hudtype 3, lov, politi, politibetjent
ğŸ‘®ğŸ½â€â™€	hudtype 4, kvinne, kvinnelig politibetjent, kvinnelig politibetjent: hudtype 4, lov, politi, politibetjent
ğŸ‘®ğŸ¾â€â™€	hudtype 5, kvinne, kvinnelig politibetjent, kvinnelig politibetjent: hudtype 5, lov, politi, politibetjent
ğŸ‘®ğŸ¿â€â™€	hudtype 6, kvinne, kvinnelig politibetjent, kvinnelig politibetjent: hudtype 6, lov, politi, politibetjent
ğŸ•µï¸	detektiv, spion
ğŸ•µğŸ»	detektiv, detektiv: hudtype 1â€“2, hudtype 1â€“2, spion
ğŸ•µğŸ¼	detektiv, detektiv: hudtype 3, hudtype 3, spion
ğŸ•µğŸ½	detektiv, detektiv: hudtype 4, hudtype 4, spion
ğŸ•µğŸ¾	detektiv, detektiv: hudtype 5, hudtype 5, spion
ğŸ•µğŸ¿	detektiv, detektiv: hudtype 6, hudtype 6, spion
ğŸ•µâ€â™‚	etterforske, forbrytelse, mann, mannlig detektiv, privatdetektiv
ğŸ•µğŸ»â€â™‚	etterforske, forbrytelse, hudtype 1â€“2, mann, mannlig detektiv, mannlig detektiv: hudtype 1â€“2, privatdetektiv
ğŸ•µğŸ¼â€â™‚	etterforske, forbrytelse, hudtype 3, mann, mannlig detektiv, mannlig detektiv: hudtype 3, privatdetektiv
ğŸ•µğŸ½â€â™‚	etterforske, forbrytelse, hudtype 4, mann, mannlig detektiv, mannlig detektiv: hudtype 4, privatdetektiv
ğŸ•µğŸ¾â€â™‚	etterforske, forbrytelse, hudtype 5, mann, mannlig detektiv, mannlig detektiv: hudtype 5, privatdetektiv
ğŸ•µğŸ¿â€â™‚	etterforske, forbrytelse, hudtype 6, mann, mannlig detektiv, mannlig detektiv: hudtype 6, privatdetektiv
ğŸ•µâ€â™€	etterforske, forbrytelse, kvinne, kvinnelig detektiv, privatdetektiv
ğŸ•µğŸ»â€â™€	etterforske, forbrytelse, hudtype 1â€“2, kvinne, kvinnelig detektiv, kvinnelig detektiv: hudtype 1â€“2, privatdetektiv
ğŸ•µğŸ¼â€â™€	etterforske, forbrytelse, hudtype 3, kvinne, kvinnelig detektiv, kvinnelig detektiv: hudtype 3, privatdetektiv
ğŸ•µğŸ½â€â™€	etterforske, forbrytelse, hudtype 4, kvinne, kvinnelig detektiv, kvinnelig detektiv: hudtype 4, privatdetektiv
ğŸ•µğŸ¾â€â™€	etterforske, forbrytelse, hudtype 5, kvinne, kvinnelig detektiv, kvinnelig detektiv: hudtype 5, privatdetektiv
ğŸ•µğŸ¿â€â™€	etterforske, forbrytelse, hudtype 6, kvinne, kvinnelig detektiv, kvinnelig detektiv: hudtype 6, privatdetektiv
ğŸ’‚	gardist, menneske, vaktmann
ğŸ’‚ğŸ»	gardist, gardist: hudtype 1â€“2, hudtype 1â€“2, menneske, vaktmann
ğŸ’‚ğŸ¼	gardist, gardist: hudtype 3, hudtype 3, menneske, vaktmann
ğŸ’‚ğŸ½	gardist, gardist: hudtype 4, hudtype 4, menneske, vaktmann
ğŸ’‚ğŸ¾	gardist, gardist: hudtype 5, hudtype 5, menneske, vaktmann
ğŸ’‚ğŸ¿	gardist, gardist: hudtype 6, hudtype 6, menneske, vaktmann
ğŸ’‚â€â™‚	England, garde, gardist, mann, mannlig gardist
ğŸ’‚ğŸ»â€â™‚	England, garde, gardist, hudtype 1â€“2, mann, mannlig gardist, mannlig gardist: hudtype 1â€“2
ğŸ’‚ğŸ¼â€â™‚	England, garde, gardist, hudtype 3, mann, mannlig gardist, mannlig gardist: hudtype 3
ğŸ’‚ğŸ½â€â™‚	England, garde, gardist, hudtype 4, mann, mannlig gardist, mannlig gardist: hudtype 4
ğŸ’‚ğŸ¾â€â™‚	England, garde, gardist, hudtype 5, mann, mannlig gardist, mannlig gardist: hudtype 5
ğŸ’‚ğŸ¿â€â™‚	England, garde, gardist, hudtype 6, mann, mannlig gardist, mannlig gardist: hudtype 6
ğŸ’‚â€â™€	England, garde, gardist, kvinne, kvinnelig gardist
ğŸ’‚ğŸ»â€â™€	England, garde, gardist, hudtype 1â€“2, kvinne, kvinnelig gardist, kvinnelig gardist: hudtype 1â€“2
ğŸ’‚ğŸ¼â€â™€	England, garde, gardist, hudtype 3, kvinne, kvinnelig gardist, kvinnelig gardist: hudtype 3
ğŸ’‚ğŸ½â€â™€	England, garde, gardist, hudtype 4, kvinne, kvinnelig gardist, kvinnelig gardist: hudtype 4
ğŸ’‚ğŸ¾â€â™€	England, garde, gardist, hudtype 5, kvinne, kvinnelig gardist, kvinnelig gardist: hudtype 5
ğŸ’‚ğŸ¿â€â™€	England, garde, gardist, hudtype 6, kvinne, kvinnelig gardist, kvinnelig gardist: hudtype 6
ğŸ‘·	anlegg, anleggsarbeider, arbeider, ingeniÃ¸r, menneske
ğŸ‘·ğŸ»	anlegg, anleggsarbeider, anleggsarbeider: hudtype 1â€“2, arbeider, hudtype 1â€“2, ingeniÃ¸r, menneske
ğŸ‘·ğŸ¼	anlegg, anleggsarbeider, anleggsarbeider: hudtype 3, arbeider, hudtype 3, ingeniÃ¸r, menneske
ğŸ‘·ğŸ½	anlegg, anleggsarbeider, anleggsarbeider: hudtype 4, arbeider, hudtype 4, ingeniÃ¸r, menneske
ğŸ‘·ğŸ¾	anlegg, anleggsarbeider, anleggsarbeider: hudtype 5, arbeider, hudtype 5, ingeniÃ¸r, menneske
ğŸ‘·ğŸ¿	anlegg, anleggsarbeider, anleggsarbeider: hudtype 6, arbeider, hudtype 6, ingeniÃ¸r, menneske
ğŸ‘·â€â™‚	anlegg, arbeider, bygg, ingeniÃ¸r, mann, mannlig anleggsarbeider
ğŸ‘·ğŸ»â€â™‚	anlegg, arbeider, bygg, hudtype 1â€“2, ingeniÃ¸r, mann, mannlig anleggsarbeider, mannlig anleggsarbeider: hudtype 1â€“2
ğŸ‘·ğŸ¼â€â™‚	anlegg, arbeider, bygg, hudtype 3, ingeniÃ¸r, mann, mannlig anleggsarbeider, mannlig anleggsarbeider: hudtype 3
ğŸ‘·ğŸ½â€â™‚	anlegg, arbeider, bygg, hudtype 4, ingeniÃ¸r, mann, mannlig anleggsarbeider, mannlig anleggsarbeider: hudtype 4
ğŸ‘·ğŸ¾â€â™‚	anlegg, arbeider, bygg, hudtype 5, ingeniÃ¸r, mann, mannlig anleggsarbeider, mannlig anleggsarbeider: hudtype 5
ğŸ‘·ğŸ¿â€â™‚	anlegg, arbeider, bygg, hudtype 6, ingeniÃ¸r, mann, mannlig anleggsarbeider, mannlig anleggsarbeider: hudtype 6
ğŸ‘·â€â™€	anlegg, arbeider, bygg, ingeniÃ¸r, kvinne, kvinnelig anleggsarbeider
ğŸ‘·ğŸ»â€â™€	anlegg, arbeider, bygg, hudtype 1â€“2, ingeniÃ¸r, kvinne, kvinnelig anleggsarbeider, kvinnelig anleggsarbeider: hudtype 1â€“2
ğŸ‘·ğŸ¼â€â™€	anlegg, arbeider, bygg, hudtype 3, ingeniÃ¸r, kvinne, kvinnelig anleggsarbeider, kvinnelig anleggsarbeider: hudtype 3
ğŸ‘·ğŸ½â€â™€	anlegg, arbeider, bygg, hudtype 4, ingeniÃ¸r, kvinne, kvinnelig anleggsarbeider, kvinnelig anleggsarbeider: hudtype 4
ğŸ‘·ğŸ¾â€â™€	anlegg, arbeider, bygg, hudtype 5, ingeniÃ¸r, kvinne, kvinnelig anleggsarbeider, kvinnelig anleggsarbeider: hudtype 5
ğŸ‘·ğŸ¿â€â™€	anlegg, arbeider, bygg, hudtype 6, ingeniÃ¸r, kvinne, kvinnelig anleggsarbeider, kvinnelig anleggsarbeider: hudtype 6
ğŸ¤´	prins
ğŸ¤´ğŸ»	hudtype 1â€“2, prins, prins: hudtype 1â€“2
ğŸ¤´ğŸ¼	hudtype 3, prins, prins: hudtype 3
ğŸ¤´ğŸ½	hudtype 4, prins, prins: hudtype 4
ğŸ¤´ğŸ¾	hudtype 5, prins, prins: hudtype 5
ğŸ¤´ğŸ¿	hudtype 6, prins, prins: hudtype 6
ğŸ‘¸	eventyr, menneske, prinsesse
ğŸ‘¸ğŸ»	eventyr, hudtype 1â€“2, menneske, prinsesse, prinsesse: hudtype 1â€“2
ğŸ‘¸ğŸ¼	eventyr, hudtype 3, menneske, prinsesse, prinsesse: hudtype 3
ğŸ‘¸ğŸ½	eventyr, hudtype 4, menneske, prinsesse, prinsesse: hudtype 4
ğŸ‘¸ğŸ¾	eventyr, hudtype 5, menneske, prinsesse, prinsesse: hudtype 5
ğŸ‘¸ğŸ¿	eventyr, hudtype 6, menneske, prinsesse, prinsesse: hudtype 6
ğŸ‘³	menneske, turbankledd person
ğŸ‘³ğŸ»	hudtype 1â€“2, menneske, turbankledd person, turbankledd person: hudtype 1â€“2
ğŸ‘³ğŸ¼	hudtype 3, menneske, turbankledd person, turbankledd person: hudtype 3
ğŸ‘³ğŸ½	hudtype 4, menneske, turbankledd person, turbankledd person: hudtype 4
ğŸ‘³ğŸ¾	hudtype 5, menneske, turbankledd person, turbankledd person: hudtype 5
ğŸ‘³ğŸ¿	hudtype 6, menneske, turbankledd person, turbankledd person: hudtype 6
ğŸ‘³â€â™‚	mann, turban, turbankledd mann
ğŸ‘³ğŸ»â€â™‚	hudtype 1â€“2, mann, turban, turbankledd mann, turbankledd mann: hudtype 1â€“2
ğŸ‘³ğŸ¼â€â™‚	hudtype 3, mann, turban, turbankledd mann, turbankledd mann: hudtype 3
ğŸ‘³ğŸ½â€â™‚	hudtype 4, mann, turban, turbankledd mann, turbankledd mann: hudtype 4
ğŸ‘³ğŸ¾â€â™‚	hudtype 5, mann, turban, turbankledd mann, turbankledd mann: hudtype 5
ğŸ‘³ğŸ¿â€â™‚	hudtype 6, mann, turban, turbankledd mann, turbankledd mann: hudtype 6
ğŸ‘³â€â™€	kvinne, turban, turbankledd kvinne
ğŸ‘³ğŸ»â€â™€	hudtype 1â€“2, kvinne, turban, turbankledd kvinne, turbankledd kvinne: hudtype 1â€“2
ğŸ‘³ğŸ¼â€â™€	hudtype 3, kvinne, turban, turbankledd kvinne, turbankledd kvinne: hudtype 3
ğŸ‘³ğŸ½â€â™€	hudtype 4, kvinne, turban, turbankledd kvinne, turbankledd kvinne: hudtype 4
ğŸ‘³ğŸ¾â€â™€	hudtype 5, kvinne, turban, turbankledd kvinne, turbankledd kvinne: hudtype 5
ğŸ‘³ğŸ¿â€â™€	hudtype 6, kvinne, turban, turbankledd kvinne, turbankledd kvinne: hudtype 6
ğŸ‘²	gua pi mao, hatt, lue, mann, mann med kinesisk lue, menneske
ğŸ‘²ğŸ»	gua pi mao, hatt, hudtype 1â€“2, lue, mann, mann med kinesisk lue, mann med kinesisk lue: hudtype 1â€“2, menneske
ğŸ‘²ğŸ¼	gua pi mao, hatt, hudtype 3, lue, mann, mann med kinesisk lue, mann med kinesisk lue: hudtype 3, menneske
ğŸ‘²ğŸ½	gua pi mao, hatt, hudtype 4, lue, mann, mann med kinesisk lue, mann med kinesisk lue: hudtype 4, menneske
ğŸ‘²ğŸ¾	gua pi mao, hatt, hudtype 5, lue, mann, mann med kinesisk lue, mann med kinesisk lue: hudtype 5, menneske
ğŸ‘²ğŸ¿	gua pi mao, hatt, hudtype 6, lue, mann, mann med kinesisk lue, mann med kinesisk lue: hudtype 6, menneske
ğŸ§•	hijab, hodeskjerf, hodeslÃ¸r, kvinne med hodeslÃ¸r, muslim
ğŸ§•ğŸ»	hijab, hodeskjerf, hodeslÃ¸r, hudtype 1â€“2, kvinne med hodeslÃ¸r, kvinne med hodeslÃ¸r: hudtype 1â€“2, muslim
ğŸ§•ğŸ¼	hijab, hodeskjerf, hodeslÃ¸r, hudtype 3, kvinne med hodeslÃ¸r, kvinne med hodeslÃ¸r: hudtype 3, muslim
ğŸ§•ğŸ½	hijab, hodeskjerf, hodeslÃ¸r, hudtype 4, kvinne med hodeslÃ¸r, kvinne med hodeslÃ¸r: hudtype 4, muslim
ğŸ§•ğŸ¾	hijab, hodeskjerf, hodeslÃ¸r, hudtype 5, kvinne med hodeslÃ¸r, kvinne med hodeslÃ¸r: hudtype 5, muslim
ğŸ§•ğŸ¿	hijab, hodeskjerf, hodeslÃ¸r, hudtype 6, kvinne med hodeslÃ¸r, kvinne med hodeslÃ¸r: hudtype 6, muslim
ğŸ¤µ	brudgom, mann, mann i smoking, smoking
ğŸ¤µğŸ»	brudgom, hudtype 1â€“2, mann, mann i smoking, mann i smoking: hudtype 1â€“2, smoking
ğŸ¤µğŸ¼	brudgom, hudtype 3, mann, mann i smoking, mann i smoking: hudtype 3, smoking
ğŸ¤µğŸ½	brudgom, hudtype 4, mann, mann i smoking, mann i smoking: hudtype 4, smoking
ğŸ¤µğŸ¾	brudgom, hudtype 5, mann, mann i smoking, mann i smoking: hudtype 5, smoking
ğŸ¤µğŸ¿	brudgom, hudtype 6, mann, mann i smoking, mann i smoking: hudtype 6, smoking
ğŸ‘°	brud, brud med slÃ¸r, bryllup, mennesker, slÃ¸r
ğŸ‘°ğŸ»	brud, brud med slÃ¸r, brud: hudtype 1â€“2, bryllup, hudtype 1â€“2, mennesker, slÃ¸r
ğŸ‘°ğŸ¼	brud, brud med slÃ¸r, brud: hudtype 3, bryllup, hudtype 3, mennesker, slÃ¸r
ğŸ‘°ğŸ½	brud, brud med slÃ¸r, brud: hudtype 4, bryllup, hudtype 4, mennesker, slÃ¸r
ğŸ‘°ğŸ¾	brud, brud med slÃ¸r, brud: hudtype 5, bryllup, hudtype 5, mennesker, slÃ¸r
ğŸ‘°ğŸ¿	brud, brud med slÃ¸r, brud: hudtype 6, bryllup, hudtype 6, mennesker, slÃ¸r
ğŸ¤°	gravid, gravid kvinne, kvinne
ğŸ¤°ğŸ»	gravid, gravid kvinne: hudtype 1â€“2, hudtype 1â€“2, kvinne
ğŸ¤°ğŸ¼	gravid, gravid kvinne: hudtype 3, hudtype 3, kvinne
ğŸ¤°ğŸ½	gravid, gravid kvinne: hudtype 4, hudtype 4, kvinne
ğŸ¤°ğŸ¾	gravid, gravid kvinne: hudtype 5, hudtype 5, kvinne
ğŸ¤°ğŸ¿	gravid, gravid kvinne: hudtype 6, hudtype 6, kvinne
ğŸ¤±	ammer, amming, baby, bryst, morsmelk
ğŸ¤±ğŸ»	ammer, ammer: hudtype 1â€“2, amming, baby, bryst, hudtype 1â€“2, morsmelk
ğŸ¤±ğŸ¼	ammer, ammer: hudtype 3, amming, baby, bryst, hudtype 3, morsmelk
ğŸ¤±ğŸ½	ammer, ammer: hudtype 4, amming, baby, bryst, hudtype 4, morsmelk
ğŸ¤±ğŸ¾	ammer, ammer: hudtype 5, amming, baby, bryst, hudtype 5, morsmelk
ğŸ¤±ğŸ¿	ammer, ammer: hudtype 6, amming, baby, bryst, hudtype 6, morsmelk
ğŸ‘¼	ansikt, babyengel, engel, eventyr
ğŸ‘¼ğŸ»	ansikt, babyengel, babyengel: hudtype 1â€“2, engel, eventyr, hudtype 1â€“2
ğŸ‘¼ğŸ¼	ansikt, babyengel, babyengel: hudtype 3, engel, eventyr, hudtype 3
ğŸ‘¼ğŸ½	ansikt, babyengel, babyengel: hudtype 4, engel, eventyr, hudtype 4
ğŸ‘¼ğŸ¾	ansikt, babyengel, babyengel: hudtype 5, engel, eventyr, hudtype 5
ğŸ‘¼ğŸ¿	ansikt, babyengel, babyengel: hudtype 6, engel, eventyr, hudtype 6
ğŸ…	feiring, jul, julenissen, nissefar, nissen
ğŸ…ğŸ»	feiring, hudtype 1â€“2, jul, julenissen, julenissen: hudtype 1â€“2, nissefar, nissen
ğŸ…ğŸ¼	feiring, hudtype 3, jul, julenissen, julenissen: hudtype 3, nissefar, nissen
ğŸ…ğŸ½	feiring, hudtype 4, jul, julenissen, julenissen: hudtype 4, nissefar, nissen
ğŸ…ğŸ¾	feiring, hudtype 5, jul, julenissen, julenissen: hudtype 5, nissefar, nissen
ğŸ…ğŸ¿	feiring, hudtype 6, jul, julenissen, julenissen: hudtype 6, nissefar, nissen
ğŸ¤¶	jul, julenissemor, mor, nisse
ğŸ¤¶ğŸ»	hudtype 1â€“2, jul, julenissemor, julenissemor: hudtype 1â€“2, mor, nisse
ğŸ¤¶ğŸ¼	hudtype 3, jul, julenissemor, julenissemor: hudtype 3, mor, nisse
ğŸ¤¶ğŸ½	hudtype 4, jul, julenissemor, julenissemor: hudtype 4, mor, nisse
ğŸ¤¶ğŸ¾	hudtype 5, jul, julenissemor, julenissemor: hudtype 5, mor, nisse
ğŸ¤¶ğŸ¿	hudtype 6, jul, julenissemor, julenissemor: hudtype 6, mor, nisse
ğŸ¦¸	god, helt, heltinne, superhelt, superkrefter
ğŸ¦¸ğŸ»	god, helt, heltinne, hudtype 1â€“2, superhelt, superhelt: hudtype 1â€“2, superkrefter
ğŸ¦¸ğŸ¼	god, helt, heltinne, hudtype 3, superhelt, superhelt: hudtype 3, superkrefter
ğŸ¦¸ğŸ½	god, helt, heltinne, hudtype 4, superhelt, superhelt: hudtype 4, superkrefter
ğŸ¦¸ğŸ¾	god, helt, heltinne, hudtype 5, superhelt, superhelt: hudtype 5, superkrefter
ğŸ¦¸ğŸ¿	god, helt, heltinne, hudtype 6, superhelt, superhelt: hudtype 6, superkrefter
ğŸ¦¸â€â™‚	god, helt, mann, mannlig superhelt, superkrefter
ğŸ¦¸ğŸ»â€â™‚	god, helt, hudtype 1â€“2, mann, mannlig superhelt, mannlig superhelt: hudtype 1â€“2, superkrefter
ğŸ¦¸ğŸ¼â€â™‚	god, helt, hudtype 3, mann, mannlig superhelt, mannlig superhelt: hudtype 3, superkrefter
ğŸ¦¸ğŸ½â€â™‚	god, helt, hudtype 4, mann, mannlig superhelt, mannlig superhelt: hudtype 4, superkrefter
ğŸ¦¸ğŸ¾â€â™‚	god, helt, hudtype 5, mann, mannlig superhelt, mannlig superhelt: hudtype 5, superkrefter
ğŸ¦¸ğŸ¿â€â™‚	god, helt, hudtype 6, mann, mannlig superhelt, mannlig superhelt: hudtype 6, superkrefter
ğŸ¦¸â€â™€	god, helt, heltinne, kvinne, kvinnelig superhelt, superkrefter
ğŸ¦¸ğŸ»â€â™€	god, helt, heltinne, hudtype 1â€“2, kvinne, kvinnelig superhelt, kvinnelig superhelt: hudtype 1â€“2, superkrefter
ğŸ¦¸ğŸ¼â€â™€	god, helt, heltinne, hudtype 3, kvinne, kvinnelig superhelt, kvinnelig superhelt: hudtype 3, superkrefter
ğŸ¦¸ğŸ½â€â™€	god, helt, heltinne, hudtype 4, kvinne, kvinnelig superhelt, kvinnelig superhelt: hudtype 4, superkrefter
ğŸ¦¸ğŸ¾â€â™€	god, helt, heltinne, hudtype 5, kvinne, kvinnelig superhelt, kvinnelig superhelt: hudtype 5, superkrefter
ğŸ¦¸ğŸ¿â€â™€	god, helt, heltinne, hudtype 6, kvinne, kvinnelig superhelt, kvinnelig superhelt: hudtype 6, superkrefter
ğŸ¦¹	kriminell, ond, skurk, superkrefter, superskurk
ğŸ¦¹ğŸ»	hudtype 1â€“2, kriminell, ond, skurk, superkrefter, superskurk, superskurk: hudtype 1â€“2
ğŸ¦¹ğŸ¼	hudtype 3, kriminell, ond, skurk, superkrefter, superskurk, superskurk: hudtype 3
ğŸ¦¹ğŸ½	hudtype 4, kriminell, ond, skurk, superkrefter, superskurk, superskurk: hudtype 4
ğŸ¦¹ğŸ¾	hudtype 5, kriminell, ond, skurk, superkrefter, superskurk, superskurk: hudtype 5
ğŸ¦¹ğŸ¿	hudtype 6, kriminell, ond, skurk, superkrefter, superskurk, superskurk: hudtype 6
ğŸ¦¹â€â™‚	kriminell, mann, mannlig superskurk, ond, skurk, superkrefter
ğŸ¦¹ğŸ»â€â™‚	hudtype 1â€“2, kriminell, mann, mannlig superskurk, mannlig superskurk: hudtype 1â€“2, ond, skurk, superkrefter
ğŸ¦¹ğŸ¼â€â™‚	hudtype 3, kriminell, mann, mannlig superskurk, mannlig superskurk: hudtype 3, ond, skurk, superkrefter
ğŸ¦¹ğŸ½â€â™‚	hudtype 4, kriminell, mann, mannlig superskurk, mannlig superskurk: hudtype 4, ond, skurk, superkrefter
ğŸ¦¹ğŸ¾â€â™‚	hudtype 5, kriminell, mann, mannlig superskurk, mannlig superskurk: hudtype 5, ond, skurk, superkrefter
ğŸ¦¹ğŸ¿â€â™‚	hudtype 6, kriminell, mann, mannlig superskurk, mannlig superskurk: hudtype 6, ond, skurk, superkrefter
ğŸ¦¹â€â™€	kriminell, kvinne, kvinnelig superskurk, ond, skurk, superkrefter
ğŸ¦¹ğŸ»â€â™€	hudtype 1â€“2, kriminell, kvinne, kvinnelig superskurk, kvinnelig superskurk: hudtype 1â€“2, ond, skurk, superkrefter
ğŸ¦¹ğŸ¼â€â™€	hudtype 3, kriminell, kvinne, kvinnelig superskurk, kvinnelig superskurk: hudtype 3, ond, skurk, superkrefter
ğŸ¦¹ğŸ½â€â™€	hudtype 4, kriminell, kvinne, kvinnelig superskurk, kvinnelig superskurk: hudtype 4, ond, skurk, superkrefter
ğŸ¦¹ğŸ¾â€â™€	hudtype 5, kriminell, kvinne, kvinnelig superskurk, kvinnelig superskurk: hudtype 5, ond, skurk, superkrefter
ğŸ¦¹ğŸ¿â€â™€	hudtype 6, kriminell, kvinne, kvinnelig superskurk, kvinnelig superskurk: hudtype 6, ond, skurk, superkrefter
ğŸ§™	heks, trollkvinne, trollmann, trollperson
ğŸ§™ğŸ»	heks, hudtype 1â€“2, trollkvinne, trollmann, trollperson, trollperson: hudtype 1â€“2
ğŸ§™ğŸ¼	heks, hudtype 3, trollkvinne, trollmann, trollperson, trollperson: hudtype 3
ğŸ§™ğŸ½	heks, hudtype 4, trollkvinne, trollmann, trollperson, trollperson: hudtype 4
ğŸ§™ğŸ¾	heks, hudtype 5, trollkvinne, trollmann, trollperson, trollperson: hudtype 5
ğŸ§™ğŸ¿	heks, hudtype 6, trollkvinne, trollmann, trollperson, trollperson: hudtype 6
ğŸ§™â€â™‚	heksemester, trollmann
ğŸ§™ğŸ»â€â™‚	heksemester, hudtype 1â€“2, trollmann, trollmann: hudtype 1â€“2
ğŸ§™ğŸ¼â€â™‚	heksemester, hudtype 3, trollmann, trollmann: hudtype 3
ğŸ§™ğŸ½â€â™‚	heksemester, hudtype 4, trollmann, trollmann: hudtype 4
ğŸ§™ğŸ¾â€â™‚	heksemester, hudtype 5, trollmann, trollmann: hudtype 5
ğŸ§™ğŸ¿â€â™‚	heksemester, hudtype 6, trollmann, trollmann: hudtype 6
ğŸ§™â€â™€	heks, trollkvinne
ğŸ§™ğŸ»â€â™€	heks, hudtype 1â€“2, trollkvinne, trollkvinne: hudtype 1â€“2
ğŸ§™ğŸ¼â€â™€	heks, hudtype 3, trollkvinne, trollkvinne: hudtype 3
ğŸ§™ğŸ½â€â™€	heks, hudtype 4, trollkvinne, trollkvinne: hudtype 4
ğŸ§™ğŸ¾â€â™€	heks, hudtype 5, trollkvinne, trollkvinne: hudtype 5
ğŸ§™ğŸ¿â€â™€	heks, hudtype 6, trollkvinne, trollkvinne: hudtype 6
ğŸ§š	Oberon, Puck, Titania, fe
ğŸ§šğŸ»	Oberon, Puck, Titania, fe, fe: hudtype 1â€“2, hudtype 1â€“2
ğŸ§šğŸ¼	Oberon, Puck, Titania, fe, fe: hudtype 3, hudtype 3
ğŸ§šğŸ½	Oberon, Puck, Titania, fe, fe: hudtype 4, hudtype 4
ğŸ§šğŸ¾	Oberon, Puck, Titania, fe, fe: hudtype 5, hudtype 5
ğŸ§šğŸ¿	Oberon, Puck, Titania, fe, fe: hudtype 6, hudtype 6
ğŸ§šâ€â™‚	Oberon, Puck, fe, mannlig fe
ğŸ§šğŸ»â€â™‚	Oberon, Puck, fe, hudtype 1â€“2, mannlig fe, mannlig fe: hudtype 1â€“2
ğŸ§šğŸ¼â€â™‚	Oberon, Puck, fe, hudtype 3, mannlig fe, mannlig fe: hudtype 3
ğŸ§šğŸ½â€â™‚	Oberon, Puck, fe, hudtype 4, mannlig fe, mannlig fe: hudtype 4
ğŸ§šğŸ¾â€â™‚	Oberon, Puck, fe, hudtype 5, mannlig fe, mannlig fe: hudtype 5
ğŸ§šğŸ¿â€â™‚	Oberon, Puck, fe, hudtype 6, mannlig fe, mannlig fe: hudtype 6
ğŸ§šâ€â™€	Titania, fe, kvinnelig fe
ğŸ§šğŸ»â€â™€	Titania, fe, hudtype 1â€“2, kvinnelig fe, kvinnelig fe: hudtype 1â€“2
ğŸ§šğŸ¼â€â™€	Titania, fe, hudtype 3, kvinnelig fe, kvinnelig fe: hudtype 3
ğŸ§šğŸ½â€â™€	Titania, fe, hudtype 4, kvinnelig fe, kvinnelig fe: hudtype 4
ğŸ§šğŸ¾â€â™€	Titania, fe, hudtype 5, kvinnelig fe, kvinnelig fe: hudtype 5
ğŸ§šğŸ¿â€â™€	Titania, fe, hudtype 6, kvinnelig fe, kvinnelig fe: hudtype 6
ğŸ§›	Dracula, vampyr, vandÃ¸d
ğŸ§›ğŸ»	Dracula, hudtype 1â€“2, vampyr, vampyr: hudtype 1â€“2, vandÃ¸d
ğŸ§›ğŸ¼	Dracula, hudtype 3, vampyr, vampyr: hudtype 3, vandÃ¸d
ğŸ§›ğŸ½	Dracula, hudtype 4, vampyr, vampyr: hudtype 4, vandÃ¸d
ğŸ§›ğŸ¾	Dracula, hudtype 5, vampyr, vampyr: hudtype 5, vandÃ¸d
ğŸ§›ğŸ¿	Dracula, hudtype 6, vampyr, vampyr: hudtype 6, vandÃ¸d
ğŸ§›â€â™‚	Dracula, mannlig vampyr, vandÃ¸d
ğŸ§›ğŸ»â€â™‚	Dracula, hudtype 1â€“2, mannlig vampyr, mannlig vampyr: hudtype 1â€“2, vandÃ¸d
ğŸ§›ğŸ¼â€â™‚	Dracula, hudtype 3, mannlig vampyr, mannlig vampyr: hudtype 3, vandÃ¸d
ğŸ§›ğŸ½â€â™‚	Dracula, hudtype 4, mannlig vampyr, mannlig vampyr: hudtype 4, vandÃ¸d
ğŸ§›ğŸ¾â€â™‚	Dracula, hudtype 5, mannlig vampyr, mannlig vampyr: hudtype 5, vandÃ¸d
ğŸ§›ğŸ¿â€â™‚	Dracula, hudtype 6, mannlig vampyr, mannlig vampyr: hudtype 6, vandÃ¸d
ğŸ§›â€â™€	kvinnelig vampyr, vandÃ¸d
ğŸ§›ğŸ»â€â™€	hudtype 1â€“2, kvinnelig vampyr, kvinnelig vampyr: hudtype 1â€“2, vandÃ¸d
ğŸ§›ğŸ¼â€â™€	hudtype 3, kvinnelig vampyr, kvinnelig vampyr: hudtype 3, vandÃ¸d
ğŸ§›ğŸ½â€â™€	hudtype 4, kvinnelig vampyr, kvinnelig vampyr: hudtype 4, vandÃ¸d
ğŸ§›ğŸ¾â€â™€	hudtype 5, kvinnelig vampyr, kvinnelig vampyr: hudtype 5, vandÃ¸d
ğŸ§›ğŸ¿â€â™€	hudtype 6, kvinnelig vampyr, kvinnelig vampyr: hudtype 6, vandÃ¸d
ğŸ§œ	havfrue, havkvinne, havmann, havperson
ğŸ§œğŸ»	havfrue, havkvinne, havmann, havperson, havperson: hudtype 1â€“2, hudtype 1â€“2
ğŸ§œğŸ¼	havfrue, havkvinne, havmann, havperson, havperson: hudtype 3, hudtype 3
ğŸ§œğŸ½	havfrue, havkvinne, havmann, havperson, havperson: hudtype 4, hudtype 4
ğŸ§œğŸ¾	havfrue, havkvinne, havmann, havperson, havperson: hudtype 5, hudtype 5
ğŸ§œğŸ¿	havfrue, havkvinne, havmann, havperson, havperson: hudtype 6, hudtype 6
ğŸ§œâ€â™‚	Triton, havmann
ğŸ§œğŸ»â€â™‚	Triton, havmann, havmann: hudtype 1â€“2, hudtype 1â€“2
ğŸ§œğŸ¼â€â™‚	Triton, havmann, havmann: hudtype 3, hudtype 3
ğŸ§œğŸ½â€â™‚	Triton, havmann, havmann: hudtype 4, hudtype 4
ğŸ§œğŸ¾â€â™‚	Triton, havmann, havmann: hudtype 5, hudtype 5
ğŸ§œğŸ¿â€â™‚	Triton, havmann, havmann: hudtype 6, hudtype 6
ğŸ§œâ€â™€	havfrue, havkvinne
ğŸ§œğŸ»â€â™€	havfrue, havfrue: hudtype 1â€“2, havkvinne, hudtype 1â€“2
ğŸ§œğŸ¼â€â™€	havfrue, havfrue: hudtype 3, havkvinne, hudtype 3
ğŸ§œğŸ½â€â™€	havfrue, havfrue: hudtype 4, havkvinne, hudtype 4
ğŸ§œğŸ¾â€â™€	havfrue, havfrue: hudtype 5, havkvinne, hudtype 5
ğŸ§œğŸ¿â€â™€	havfrue, havfrue: hudtype 6, havkvinne, hudtype 6
ğŸ§	alv, magi
ğŸ§ğŸ»	alv, alv: hudtype 1â€“2, hudtype 1â€“2, magi
ğŸ§ğŸ¼	alv, alv: hudtype 3, hudtype 3, magi
ğŸ§ğŸ½	alv, alv: hudtype 4, hudtype 4, magi
ğŸ§ğŸ¾	alv, alv: hudtype 5, hudtype 5, magi
ğŸ§ğŸ¿	alv, alv: hudtype 6, hudtype 6, magi
ğŸ§â€â™‚	magi, mannlig alv
ğŸ§ğŸ»â€â™‚	hudtype 1â€“2, magi, mannlig alv, mannlig alv: hudtype 1â€“2
ğŸ§ğŸ¼â€â™‚	hudtype 3, magi, mannlig alv, mannlig alv: hudtype 3
ğŸ§ğŸ½â€â™‚	hudtype 4, magi, mannlig alv, mannlig alv: hudtype 4
ğŸ§ğŸ¾â€â™‚	hudtype 5, magi, mannlig alv, mannlig alv: hudtype 5
ğŸ§ğŸ¿â€â™‚	hudtype 6, magi, mannlig alv, mannlig alv: hudtype 6
ğŸ§â€â™€	kvinnelig alv, magi
ğŸ§ğŸ»â€â™€	hudtype 1â€“2, kvinnelig alv, kvinnelig alv: hudtype 1â€“2, magi
ğŸ§ğŸ¼â€â™€	hudtype 3, kvinnelig alv, kvinnelig alv: hudtype 3, magi
ğŸ§ğŸ½â€â™€	hudtype 4, kvinnelig alv, kvinnelig alv: hudtype 4, magi
ğŸ§ğŸ¾â€â™€	hudtype 5, kvinnelig alv, kvinnelig alv: hudtype 5, magi
ğŸ§ğŸ¿â€â™€	hudtype 6, kvinnelig alv, kvinnelig alv: hudtype 6, magi
ğŸ§	djinn, Ã¥nd
ğŸ§â€â™‚	djinn, mannlig Ã¥nd
ğŸ§â€â™€	djinn, kvinnelig Ã¥nd
ğŸ§Ÿ	udÃ¸d, vandÃ¸d, zombie
ğŸ§Ÿâ€â™‚	mannlig zombie, udÃ¸d, vandÃ¸d
ğŸ§Ÿâ€â™€	kvinnelig zombie, udÃ¸d, vandÃ¸d
ğŸ’†	ansikt, ansiktsmassasje, massasje, skjÃ¸nnhetssalong
ğŸ’†ğŸ»	ansikt, ansiktsmassasje, ansiktsmassasje: hudtype 1â€“2, hudtype 1â€“2, massasje, skjÃ¸nnhetssalong
ğŸ’†ğŸ¼	ansikt, ansiktsmassasje, ansiktsmassasje: hudtype 3, hudtype 3, massasje, skjÃ¸nnhetssalong
ğŸ’†ğŸ½	ansikt, ansiktsmassasje, ansiktsmassasje: hudtype 4, hudtype 4, massasje, skjÃ¸nnhetssalong
ğŸ’†ğŸ¾	ansikt, ansiktsmassasje, ansiktsmassasje: hudtype 5, hudtype 5, massasje, skjÃ¸nnhetssalong
ğŸ’†ğŸ¿	ansikt, ansiktsmassasje, ansiktsmassasje: hudtype 6, hudtype 6, massasje, skjÃ¸nnhetssalong
ğŸ’†â€â™‚	ansikt, avslapning, hodemassasje, mann, mann som fÃ¥r ansiktsmassasje, massasje, velvÃ¦re
ğŸ’†ğŸ»â€â™‚	ansikt, avslapning, hodemassasje, hudtype 1â€“2, mann, mann som fÃ¥r ansiktsmassasje, mann som fÃ¥r ansiktsmassasje: hudtype 1â€“2, massasje, velvÃ¦re
ğŸ’†ğŸ¼â€â™‚	ansikt, avslapning, hodemassasje, hudtype 3, mann, mann som fÃ¥r ansiktsmassasje, mann som fÃ¥r ansiktsmassasje: hudtype 3, massasje, velvÃ¦re
ğŸ’†ğŸ½â€â™‚	ansikt, avslapning, hodemassasje, hudtype 4, mann, mann som fÃ¥r ansiktsmassasje, mann som fÃ¥r ansiktsmassasje: hudtype 4, massasje, velvÃ¦re
ğŸ’†ğŸ¾â€â™‚	ansikt, avslapning, hodemassasje, hudtype 5, mann, mann som fÃ¥r ansiktsmassasje, mann som fÃ¥r ansiktsmassasje: hudtype 5, massasje, velvÃ¦re
ğŸ’†ğŸ¿â€â™‚	ansikt, avslapning, hodemassasje, hudtype 6, mann, mann som fÃ¥r ansiktsmassasje, mann som fÃ¥r ansiktsmassasje: hudtype 6, massasje, velvÃ¦re
ğŸ’†â€â™€	ansikt, avslapning, hodemassasje, kvinne, kvinne som fÃ¥r ansiktsmassasje, massasje, velvÃ¦re
ğŸ’†ğŸ»â€â™€	ansikt, avslapning, hodemassasje, hudtype 1â€“2, kvinne, kvinne som fÃ¥r ansiktsmassasje, kvinne som fÃ¥r ansiktsmassasje: hudtype 1â€“2, massasje, velvÃ¦re
ğŸ’†ğŸ¼â€â™€	ansikt, avslapning, hodemassasje, hudtype 3, kvinne, kvinne som fÃ¥r ansiktsmassasje, kvinne som fÃ¥r ansiktsmassasje: hudtype 3, massasje, velvÃ¦re
ğŸ’†ğŸ½â€â™€	ansikt, avslapning, hodemassasje, hudtype 4, kvinne, kvinne som fÃ¥r ansiktsmassasje, kvinne som fÃ¥r ansiktsmassasje: hudtype 4, massasje, velvÃ¦re
ğŸ’†ğŸ¾â€â™€	ansikt, avslapning, hodemassasje, hudtype 5, kvinne, kvinne som fÃ¥r ansiktsmassasje, kvinne som fÃ¥r ansiktsmassasje: hudtype 5, massasje, velvÃ¦re
ğŸ’†ğŸ¿â€â™€	ansikt, avslapning, hodemassasje, hudtype 6, kvinne, kvinne som fÃ¥r ansiktsmassasje, kvinne som fÃ¥r ansiktsmassasje: hudtype 6, massasje, velvÃ¦re
ğŸ’‡	frisÃ¸r, hÃ¥rklipp, salong, skjÃ¸nnhet, skjÃ¸nnhetssalong
ğŸ’‡ğŸ»	frisÃ¸r, hudtype 1â€“2, hÃ¥rklipp, hÃ¥rklipp: hudtype 1â€“2, salong, skjÃ¸nnhet, skjÃ¸nnhetssalong
ğŸ’‡ğŸ¼	frisÃ¸r, hudtype 3, hÃ¥rklipp, hÃ¥rklipp: hudtype 3, salong, skjÃ¸nnhet, skjÃ¸nnhetssalong
ğŸ’‡ğŸ½	frisÃ¸r, hudtype 4, hÃ¥rklipp, hÃ¥rklipp: hudtype 4, salong, skjÃ¸nnhet, skjÃ¸nnhetssalong
ğŸ’‡ğŸ¾	frisÃ¸r, hudtype 5, hÃ¥rklipp, hÃ¥rklipp: hudtype 5, salong, skjÃ¸nnhet, skjÃ¸nnhetssalong
ğŸ’‡ğŸ¿	frisÃ¸r, hudtype 6, hÃ¥rklipp, hÃ¥rklipp: hudtype 6, salong, skjÃ¸nnhet, skjÃ¸nnhetssalong
ğŸ’‡â€â™‚	frisÃ¸r, hÃ¥rklipp, mann, mann som fÃ¥r hÃ¥rklipp, sveis
ğŸ’‡ğŸ»â€â™‚	frisÃ¸r, hudtype 1â€“2, hÃ¥rklipp, mann, mann som fÃ¥r hÃ¥rklipp, mann som fÃ¥r hÃ¥rklipp: hudtype 1â€“2, sveis
ğŸ’‡ğŸ¼â€â™‚	frisÃ¸r, hudtype 3, hÃ¥rklipp, mann, mann som fÃ¥r hÃ¥rklipp, mann som fÃ¥r hÃ¥rklipp: hudtype 3, sveis
ğŸ’‡ğŸ½â€â™‚	frisÃ¸r, hudtype 4, hÃ¥rklipp, mann, mann som fÃ¥r hÃ¥rklipp, mann som fÃ¥r hÃ¥rklipp: hudtype 4, sveis
ğŸ’‡ğŸ¾â€â™‚	frisÃ¸r, hudtype 5, hÃ¥rklipp, mann, mann som fÃ¥r hÃ¥rklipp, mann som fÃ¥r hÃ¥rklipp: hudtype 5, sveis
ğŸ’‡ğŸ¿â€â™‚	frisÃ¸r, hudtype 6, hÃ¥rklipp, mann, mann som fÃ¥r hÃ¥rklipp, mann som fÃ¥r hÃ¥rklipp: hudtype 6, sveis
ğŸ’‡â€â™€	frisyre, frisÃ¸r, hÃ¥rklipp, kvinne, kvinne som fÃ¥r hÃ¥rklipp
ğŸ’‡ğŸ»â€â™€	frisyre, frisÃ¸r, hudtype 1â€“2, hÃ¥rklipp, kvinne, kvinne som fÃ¥r hÃ¥rklipp, kvinne som fÃ¥r hÃ¥rklipp: hudtype 1â€“2
ğŸ’‡ğŸ¼â€â™€	frisyre, frisÃ¸r, hudtype 3, hÃ¥rklipp, kvinne, kvinne som fÃ¥r hÃ¥rklipp, kvinne som fÃ¥r hÃ¥rklipp: hudtype 3
ğŸ’‡ğŸ½â€â™€	frisyre, frisÃ¸r, hudtype 4, hÃ¥rklipp, kvinne, kvinne som fÃ¥r hÃ¥rklipp, kvinne som fÃ¥r hÃ¥rklipp: hudtype 4
ğŸ’‡ğŸ¾â€â™€	frisyre, frisÃ¸r, hudtype 5, hÃ¥rklipp, kvinne, kvinne som fÃ¥r hÃ¥rklipp, kvinne som fÃ¥r hÃ¥rklipp: hudtype 5
ğŸ’‡ğŸ¿â€â™€	frisyre, frisÃ¸r, hudtype 6, hÃ¥rklipp, kvinne, kvinne som fÃ¥r hÃ¥rklipp, kvinne som fÃ¥r hÃ¥rklipp: hudtype 6
ğŸš¶	fotgjenger, gÃ¥ende
ğŸš¶ğŸ»	fotgjenger, fotgjenger: hudtype 1â€“2, gÃ¥ende, hudtype 1â€“2
ğŸš¶ğŸ¼	fotgjenger, fotgjenger: hudtype 3, gÃ¥ende, hudtype 3
ğŸš¶ğŸ½	fotgjenger, fotgjenger: hudtype 4, gÃ¥ende, hudtype 4
ğŸš¶ğŸ¾	fotgjenger, fotgjenger: hudtype 5, gÃ¥ende, hudtype 5
ğŸš¶ğŸ¿	fotgjenger, fotgjenger: hudtype 6, gÃ¥ende, hudtype 6
ğŸš¶â€â™‚	fotgjenger, gÃ¥, mann, mannlig fotgjenger
ğŸš¶ğŸ»â€â™‚	fotgjenger, gÃ¥, hudtype 1â€“2, mann, mannlig fotgjenger, mannlig fotgjenger: hudtype 1â€“2
ğŸš¶ğŸ¼â€â™‚	fotgjenger, gÃ¥, hudtype 3, mann, mannlig fotgjenger, mannlig fotgjenger: hudtype 3
ğŸš¶ğŸ½â€â™‚	fotgjenger, gÃ¥, hudtype 4, mann, mannlig fotgjenger, mannlig fotgjenger: hudtype 4
ğŸš¶ğŸ¾â€â™‚	fotgjenger, gÃ¥, hudtype 5, mann, mannlig fotgjenger, mannlig fotgjenger: hudtype 5
ğŸš¶ğŸ¿â€â™‚	fotgjenger, gÃ¥, hudtype 6, mann, mannlig fotgjenger, mannlig fotgjenger: hudtype 6
ğŸš¶â€â™€	fotgjenger, gÃ¥, kvinne, kvinnelig fotgjenger
ğŸš¶ğŸ»â€â™€	fotgjenger, gÃ¥, hudtype 1â€“2, kvinne, kvinnelig fotgjenger, kvinnelig fotgjenger: hudtype 1â€“2
ğŸš¶ğŸ¼â€â™€	fotgjenger, gÃ¥, hudtype 3, kvinne, kvinnelig fotgjenger, kvinnelig fotgjenger: hudtype 3
ğŸš¶ğŸ½â€â™€	fotgjenger, gÃ¥, hudtype 4, kvinne, kvinnelig fotgjenger, kvinnelig fotgjenger: hudtype 4
ğŸš¶ğŸ¾â€â™€	fotgjenger, gÃ¥, hudtype 5, kvinne, kvinnelig fotgjenger, kvinnelig fotgjenger: hudtype 5
ğŸš¶ğŸ¿â€â™€	fotgjenger, gÃ¥, hudtype 6, kvinne, kvinnelig fotgjenger, kvinnelig fotgjenger: hudtype 6
ğŸ§	person som stÃ¥r
ğŸ§ğŸ»	hudtype 1â€“2, person som stÃ¥r, person som stÃ¥r: hudtype 1â€“2
ğŸ§ğŸ¼	hudtype 3, person som stÃ¥r, person som stÃ¥r: hudtype 3
ğŸ§ğŸ½	hudtype 4, person som stÃ¥r, person som stÃ¥r: hudtype 4
ğŸ§ğŸ¾	hudtype 5, person som stÃ¥r, person som stÃ¥r: hudtype 5
ğŸ§ğŸ¿	hudtype 6, person som stÃ¥r, person som stÃ¥r: hudtype 6
ğŸ§â€â™‚	mann som stÃ¥r
ğŸ§ğŸ»â€â™‚	hudtype 1â€“2, mann som stÃ¥r, mann som stÃ¥r: hudtype 1â€“2
ğŸ§ğŸ¼â€â™‚	hudtype 3, mann som stÃ¥r, mann som stÃ¥r: hudtype 3
ğŸ§ğŸ½â€â™‚	hudtype 4, mann som stÃ¥r, mann som stÃ¥r: hudtype 4
ğŸ§ğŸ¾â€â™‚	hudtype 5, mann som stÃ¥r, mann som stÃ¥r: hudtype 5
ğŸ§ğŸ¿â€â™‚	hudtype 6, mann som stÃ¥r, mann som stÃ¥r: hudtype 6
ğŸ§â€â™€	kvinne som stÃ¥r
ğŸ§ğŸ»â€â™€	hudtype 1â€“2, kvinne som stÃ¥r, kvinne som stÃ¥r: hudtype 1â€“2
ğŸ§ğŸ¼â€â™€	hudtype 3, kvinne som stÃ¥r, kvinne som stÃ¥r: hudtype 3
ğŸ§ğŸ½â€â™€	hudtype 4, kvinne som stÃ¥r, kvinne som stÃ¥r: hudtype 4
ğŸ§ğŸ¾â€â™€	hudtype 5, kvinne som stÃ¥r, kvinne som stÃ¥r: hudtype 5
ğŸ§ğŸ¿â€â™€	hudtype 6, kvinne som stÃ¥r, kvinne som stÃ¥r: hudtype 6
ğŸ§	person som kneler
ğŸ§ğŸ»	hudtype 1â€“2, person som kneler, person som kneler: hudtype 1â€“2
ğŸ§ğŸ¼	hudtype 3, person som kneler, person som kneler: hudtype 3
ğŸ§ğŸ½	hudtype 4, person som kneler, person som kneler: hudtype 4
ğŸ§ğŸ¾	hudtype 5, person som kneler, person som kneler: hudtype 5
ğŸ§ğŸ¿	hudtype 6, person som kneler, person som kneler: hudtype 6
ğŸ§â€â™‚	mann som kneler
ğŸ§ğŸ»â€â™‚	hudtype 1â€“2, mann som kneler, mann som kneler: hudtype 1â€“2
ğŸ§ğŸ¼â€â™‚	hudtype 3, mann som kneler, mann som kneler: hudtype 3
ğŸ§ğŸ½â€â™‚	hudtype 4, mann som kneler, mann som kneler: hudtype 4
ğŸ§ğŸ¾â€â™‚	hudtype 5, mann som kneler, mann som kneler: hudtype 5
ğŸ§ğŸ¿â€â™‚	hudtype 6, mann som kneler, mann som kneler: hudtype 6
ğŸ§â€â™€	kvinne som kneler
ğŸ§ğŸ»â€â™€	hudtype 1â€“2, kvinne som kneler, kvinne som kneler: hudtype 1â€“2
ğŸ§ğŸ¼â€â™€	hudtype 3, kvinne som kneler, kvinne som kneler: hudtype 3
ğŸ§ğŸ½â€â™€	hudtype 4, kvinne som kneler, kvinne som kneler: hudtype 4
ğŸ§ğŸ¾â€â™€	hudtype 5, kvinne som kneler, kvinne som kneler: hudtype 5
ğŸ§ğŸ¿â€â™€	hudtype 6, kvinne som kneler, kvinne som kneler: hudtype 6
ğŸ‘¨â€ğŸ¦¯	mann med blindestokk
ğŸ‘¨ğŸ»â€ğŸ¦¯	hudtype 1â€“2, mann med blindestokk, mann med blindestokk: hudtype 1â€“2
ğŸ‘¨ğŸ¼â€ğŸ¦¯	hudtype 3, mann med blindestokk, mann med blindestokk: hudtype 3
ğŸ‘¨ğŸ½â€ğŸ¦¯	hudtype 4, mann med blindestokk, mann med blindestokk: hudtype 4
ğŸ‘¨ğŸ¾â€ğŸ¦¯	hudtype 5, mann med blindestokk, mann med blindestokk: hudtype 5
ğŸ‘¨ğŸ¿â€ğŸ¦¯	hudtype 6, mann med blindestokk, mann med blindestokk: hudtype 6
ğŸ‘©â€ğŸ¦¯	kvinne med blindestokk
ğŸ‘©ğŸ»â€ğŸ¦¯	hudtype 1â€“2, kvinne med blindestokk, kvinne med blindestokk: hudtype 1â€“2
ğŸ‘©ğŸ¼â€ğŸ¦¯	hudtype 3, kvinne med blindestokk, kvinne med blindestokk: hudtype 3
ğŸ‘©ğŸ½â€ğŸ¦¯	hudtype 4, kvinne med blindestokk, kvinne med blindestokk: hudtype 4
ğŸ‘©ğŸ¾â€ğŸ¦¯	hudtype 5, kvinne med blindestokk, kvinne med blindestokk: hudtype 5
ğŸ‘©ğŸ¿â€ğŸ¦¯	hudtype 6, kvinne med blindestokk, kvinne med blindestokk: hudtype 6
ğŸ‘¨â€ğŸ¦¼	mann i motorisert rullestol
ğŸ‘¨ğŸ»â€ğŸ¦¼	hudtype 1â€“2, mann i motorisert rullestol, mann i motorisert rullestol: hudtype 1â€“2
ğŸ‘¨ğŸ¼â€ğŸ¦¼	hudtype 3, mann i motorisert rullestol, mann i motorisert rullestol: hudtype 3
ğŸ‘¨ğŸ½â€ğŸ¦¼	hudtype 4, mann i motorisert rullestol, mann i motorisert rullestol: hudtype 4
ğŸ‘¨ğŸ¾â€ğŸ¦¼	hudtype 5, mann i motorisert rullestol, mann i motorisert rullestol: hudtype 5
ğŸ‘¨ğŸ¿â€ğŸ¦¼	hudtype 6, mann i motorisert rullestol, mann i motorisert rullestol: hudtype 6
ğŸ‘©â€ğŸ¦¼	kvinne i motorisert rullestol
ğŸ‘©ğŸ»â€ğŸ¦¼	hudtype 1â€“2, kvinne i motorisert rullestol, kvinne i motorisert rullestol: hudtype 1â€“2
ğŸ‘©ğŸ¼â€ğŸ¦¼	hudtype 3, kvinne i motorisert rullestol, kvinne i motorisert rullestol: hudtype 3
ğŸ‘©ğŸ½â€ğŸ¦¼	hudtype 4, kvinne i motorisert rullestol, kvinne i motorisert rullestol: hudtype 4
ğŸ‘©ğŸ¾â€ğŸ¦¼	hudtype 5, kvinne i motorisert rullestol, kvinne i motorisert rullestol: hudtype 5
ğŸ‘©ğŸ¿â€ğŸ¦¼	hudtype 6, kvinne i motorisert rullestol, kvinne i motorisert rullestol: hudtype 6
ğŸ‘¨â€ğŸ¦½	mann i manuell rullestol
ğŸ‘¨ğŸ»â€ğŸ¦½	hudtype 1â€“2, mann i manuell rullestol, mann i manuell rullestol: hudtype 1â€“2
ğŸ‘¨ğŸ¼â€ğŸ¦½	hudtype 3, mann i manuell rullestol, mann i manuell rullestol: hudtype 3
ğŸ‘¨ğŸ½â€ğŸ¦½	hudtype 4, mann i manuell rullestol, mann i manuell rullestol: hudtype 4
ğŸ‘¨ğŸ¾â€ğŸ¦½	hudtype 5, mann i manuell rullestol, mann i manuell rullestol: hudtype 5
ğŸ‘¨ğŸ¿â€ğŸ¦½	hudtype 6, mann i manuell rullestol, mann i manuell rullestol: hudtype 6
ğŸ‘©â€ğŸ¦½	kvinne i manuell rullestol
ğŸ‘©ğŸ»â€ğŸ¦½	hudtype 1â€“2, kvinne i manuell rullestol, kvinne i manuell rullestol: hudtype 1â€“2
ğŸ‘©ğŸ¼â€ğŸ¦½	hudtype 3, kvinne i manuell rullestol, kvinne i manuell rullestol: hudtype 3
ğŸ‘©ğŸ½â€ğŸ¦½	hudtype 4, kvinne i manuell rullestol, kvinne i manuell rullestol: hudtype 4
ğŸ‘©ğŸ¾â€ğŸ¦½	hudtype 5, kvinne i manuell rullestol, kvinne i manuell rullestol: hudtype 5
ğŸ‘©ğŸ¿â€ğŸ¦½	hudtype 6, kvinne i manuell rullestol, kvinne i manuell rullestol: hudtype 6
ğŸƒ	jogger, jogging, lÃ¸per, lÃ¸ping, maraton, sport
ğŸƒğŸ»	hudtype 1â€“2, jogger, jogging, lÃ¸per, lÃ¸per: hudtype 1â€“2, lÃ¸ping, maraton, sport
ğŸƒğŸ¼	hudtype 3, jogger, jogging, lÃ¸per, lÃ¸per: hudtype 3, lÃ¸ping, maraton, sport
ğŸƒğŸ½	hudtype 4, jogger, jogging, lÃ¸per, lÃ¸per: hudtype 4, lÃ¸ping, maraton, sport
ğŸƒğŸ¾	hudtype 5, jogger, jogging, lÃ¸per, lÃ¸per: hudtype 5, lÃ¸ping, maraton, sport
ğŸƒğŸ¿	hudtype 6, jogger, jogging, lÃ¸per, lÃ¸per: hudtype 6, lÃ¸ping, maraton, sport
ğŸƒâ€â™‚	jogge, lÃ¸pe, mann, mannlig lÃ¸per
ğŸƒğŸ»â€â™‚	hudtype 1â€“2, jogge, lÃ¸pe, mann, mannlig lÃ¸per, mannlig lÃ¸per: hudtype 1â€“2
ğŸƒğŸ¼â€â™‚	hudtype 3, jogge, lÃ¸pe, mann, mannlig lÃ¸per, mannlig lÃ¸per: hudtype 3
ğŸƒğŸ½â€â™‚	hudtype 4, jogge, lÃ¸pe, mann, mannlig lÃ¸per, mannlig lÃ¸per: hudtype 4
ğŸƒğŸ¾â€â™‚	hudtype 5, jogge, lÃ¸pe, mann, mannlig lÃ¸per, mannlig lÃ¸per: hudtype 5
ğŸƒğŸ¿â€â™‚	hudtype 6, jogge, lÃ¸pe, mann, mannlig lÃ¸per, mannlig lÃ¸per: hudtype 6
ğŸƒâ€â™€	jogge, kvinne, kvinnelig lÃ¸per, lÃ¸pe
ğŸƒğŸ»â€â™€	hudtype 1â€“2, jogge, kvinne, kvinnelig lÃ¸per, kvinnelig lÃ¸per: hudtype 1â€“2, lÃ¸pe
ğŸƒğŸ¼â€â™€	hudtype 3, jogge, kvinne, kvinnelig lÃ¸per, kvinnelig lÃ¸per: hudtype 3, lÃ¸pe
ğŸƒğŸ½â€â™€	hudtype 4, jogge, kvinne, kvinnelig lÃ¸per, kvinnelig lÃ¸per: hudtype 4, lÃ¸pe
ğŸƒğŸ¾â€â™€	hudtype 5, jogge, kvinne, kvinnelig lÃ¸per, kvinnelig lÃ¸per: hudtype 5, lÃ¸pe
ğŸƒğŸ¿â€â™€	hudtype 6, jogge, kvinne, kvinnelig lÃ¸per, kvinnelig lÃ¸per: hudtype 6, lÃ¸pe
ğŸ’ƒ	dans, dansende kvinne, menneske
ğŸ’ƒğŸ»	dans, dansende kvinne, dansende kvinne: hudtype 1â€“2, hudtype 1â€“2, menneske
ğŸ’ƒğŸ¼	dans, dansende kvinne, dansende kvinne: hudtype 3, hudtype 3, menneske
ğŸ’ƒğŸ½	dans, dansende kvinne, dansende kvinne: hudtype 4, hudtype 4, menneske
ğŸ’ƒğŸ¾	dans, dansende kvinne, dansende kvinne: hudtype 5, hudtype 5, menneske
ğŸ’ƒğŸ¿	dans, dansende kvinne, dansende kvinne: hudtype 6, hudtype 6, menneske
ğŸ•º	dans, dansende mann, menneske
ğŸ•ºğŸ»	dans, dansende mann, dansende mann: hudtype 1â€“2, hudtype 1â€“2, menneske
ğŸ•ºğŸ¼	dans, dansende mann, dansende mann: hudtype 3, hudtype 3, menneske
ğŸ•ºğŸ½	dans, dansende mann, dansende mann: hudtype 4, hudtype 4, menneske
ğŸ•ºğŸ¾	dans, dansende mann, dansende mann: hudtype 5, hudtype 5, menneske
ğŸ•ºğŸ¿	dans, dansende mann, dansende mann: hudtype 6, hudtype 6, menneske
ğŸ•´ï¸	business, dress, forretningsmann, mann, svevende mann i dress
ğŸ•´ğŸ»	business, dress, forretningsmann, hudtype 1â€“2, mann, svevende mann i dress, svevende mann i dress: hudtype 1â€“2
ğŸ•´ğŸ¼	business, dress, forretningsmann, hudtype 3, mann, svevende mann i dress, svevende mann i dress: hudtype 3
ğŸ•´ğŸ½	business, dress, forretningsmann, hudtype 4, mann, svevende mann i dress, svevende mann i dress: hudtype 4
ğŸ•´ğŸ¾	business, dress, forretningsmann, hudtype 5, mann, svevende mann i dress, svevende mann i dress: hudtype 5
ğŸ•´ğŸ¿	business, dress, forretningsmann, hudtype 6, mann, svevende mann i dress, svevende mann i dress: hudtype 6
ğŸ‘¯	danser, fest, hareÃ¸rer, menneske, personer med kaninÃ¸rer
ğŸ‘¯â€â™‚	danser, hareÃ¸rer, mann, menn, menn med kaninÃ¸rer
ğŸ‘¯â€â™€	danser, hareÃ¸rer, kvinne, kvinner, kvinner med kaninÃ¸rer
ğŸ§–	dampbad, person i badstu, sauna
ğŸ§–ğŸ»	dampbad, hudtype 1â€“2, person i badstu, person i badstu: hudtype 1â€“2, sauna
ğŸ§–ğŸ¼	dampbad, hudtype 3, person i badstu, person i badstu: hudtype 3, sauna
ğŸ§–ğŸ½	dampbad, hudtype 4, person i badstu, person i badstu: hudtype 4, sauna
ğŸ§–ğŸ¾	dampbad, hudtype 5, person i badstu, person i badstu: hudtype 5, sauna
ğŸ§–ğŸ¿	dampbad, hudtype 6, person i badstu, person i badstu: hudtype 6, sauna
ğŸ§–â€â™‚	dampbad, mann i badstu, sauna
ğŸ§–ğŸ»â€â™‚	dampbad, hudtype 1â€“2, mann i badstu, mann i badstu: hudtype 1â€“2, sauna
ğŸ§–ğŸ¼â€â™‚	dampbad, hudtype 3, mann i badstu, mann i badstu: hudtype 3, sauna
ğŸ§–ğŸ½â€â™‚	dampbad, hudtype 4, mann i badstu, mann i badstu: hudtype 4, sauna
ğŸ§–ğŸ¾â€â™‚	dampbad, hudtype 5, mann i badstu, mann i badstu: hudtype 5, sauna
ğŸ§–ğŸ¿â€â™‚	dampbad, hudtype 6, mann i badstu, mann i badstu: hudtype 6, sauna
ğŸ§–â€â™€	dampbad, kvinne i badstu, sauna
ğŸ§–ğŸ»â€â™€	dampbad, hudtype 1â€“2, kvinne i badstu, kvinne i badstu: hudtype 1â€“2, sauna
ğŸ§–ğŸ¼â€â™€	dampbad, hudtype 3, kvinne i badstu, kvinne i badstu: hudtype 3, sauna
ğŸ§–ğŸ½â€â™€	dampbad, hudtype 4, kvinne i badstu, kvinne i badstu: hudtype 4, sauna
ğŸ§–ğŸ¾â€â™€	dampbad, hudtype 5, kvinne i badstu, kvinne i badstu: hudtype 5, sauna
ğŸ§–ğŸ¿â€â™€	dampbad, hudtype 6, kvinne i badstu, kvinne i badstu: hudtype 6, sauna
ğŸ§—	klatrer, klatring
ğŸ§—ğŸ»	hudtype 1â€“2, klatrer, klatrer: hudtype 1â€“2, klatring
ğŸ§—ğŸ¼	hudtype 3, klatrer, klatrer: hudtype 3, klatring
ğŸ§—ğŸ½	hudtype 4, klatrer, klatrer: hudtype 4, klatring
ğŸ§—ğŸ¾	hudtype 5, klatrer, klatrer: hudtype 5, klatring
ğŸ§—ğŸ¿	hudtype 6, klatrer, klatrer: hudtype 6, klatring
ğŸ§—â€â™‚	klatring, mannlig klatrer
ğŸ§—ğŸ»â€â™‚	hudtype 1â€“2, klatring, mannlig klatrer, mannlig klatrer: hudtype 1â€“2
ğŸ§—ğŸ¼â€â™‚	hudtype 3, klatring, mannlig klatrer, mannlig klatrer: hudtype 3
ğŸ§—ğŸ½â€â™‚	hudtype 4, klatring, mannlig klatrer, mannlig klatrer: hudtype 4
ğŸ§—ğŸ¾â€â™‚	hudtype 5, klatring, mannlig klatrer, mannlig klatrer: hudtype 5
ğŸ§—ğŸ¿â€â™‚	hudtype 6, klatring, mannlig klatrer, mannlig klatrer: hudtype 6
ğŸ§—â€â™€	klatring, kvinnelig klatrer
ğŸ§—ğŸ»â€â™€	hudtype 1â€“2, klatring, kvinnelig klatrer, kvinnelig klatrer: hudtype 1â€“2
ğŸ§—ğŸ¼â€â™€	hudtype 3, klatring, kvinnelig klatrer, kvinnelig klatrer: hudtype 3
ğŸ§—ğŸ½â€â™€	hudtype 4, klatring, kvinnelig klatrer, kvinnelig klatrer: hudtype 4
ğŸ§—ğŸ¾â€â™€	hudtype 5, klatring, kvinnelig klatrer, kvinnelig klatrer: hudtype 5
ğŸ§—ğŸ¿â€â™€	hudtype 6, klatring, kvinnelig klatrer, kvinnelig klatrer: hudtype 6
ğŸ¤º	fekte, fekter, fekting, person, sport, sverd
ğŸ‡	galopp, hest, hesteveddelÃ¸p, jockey, lÃ¸p, sport, veddelÃ¸pshest
ğŸ‡ğŸ»	galopp, hest, hesteveddelÃ¸p, hesteveddelÃ¸p: hudtype 1â€“2, hudtype 1â€“2, jockey, lÃ¸p, sport, veddelÃ¸pshest
ğŸ‡ğŸ¼	galopp, hest, hesteveddelÃ¸p, hesteveddelÃ¸p: hudtype 3, hudtype 3, jockey, lÃ¸p, sport, veddelÃ¸pshest
ğŸ‡ğŸ½	galopp, hest, hesteveddelÃ¸p, hesteveddelÃ¸p: hudtype 4, hudtype 4, jockey, lÃ¸p, sport, veddelÃ¸pshest
ğŸ‡ğŸ¾	galopp, hest, hesteveddelÃ¸p, hesteveddelÃ¸p: hudtype 5, hudtype 5, jockey, lÃ¸p, sport, veddelÃ¸pshest
ğŸ‡ğŸ¿	galopp, hest, hesteveddelÃ¸p, hesteveddelÃ¸p: hudtype 6, hudtype 6, jockey, lÃ¸p, sport, veddelÃ¸pshest
â›·ï¸	ski, skilÃ¸per, snÃ¸
ğŸ‚ï¸	snowboard, snowboarder, snowboarding, snÃ¸brett, snÃ¸brettkjÃ¸ring, vintersport
ğŸ‚ğŸ»	hudtype 1â€“2, snowboard, snowboarder, snowboarder: hudtype 1â€“2, snowboarding, snÃ¸brett, snÃ¸brettkjÃ¸ring, vintersport
ğŸ‚ğŸ¼	hudtype 3, snowboard, snowboarder, snowboarder: hudtype 3, snowboarding, snÃ¸brett, snÃ¸brettkjÃ¸ring, vintersport
ğŸ‚ğŸ½	hudtype 4, snowboard, snowboarder, snowboarder: hudtype 4, snowboarding, snÃ¸brett, snÃ¸brettkjÃ¸ring, vintersport
ğŸ‚ğŸ¾	hudtype 5, snowboard, snowboarder, snowboarder: hudtype 5, snowboarding, snÃ¸brett, snÃ¸brettkjÃ¸ring, vintersport
ğŸ‚ğŸ¿	hudtype 6, snowboard, snowboarder, snowboarder: hudtype 6, snowboarding, snÃ¸brett, snÃ¸brettkjÃ¸ring, vintersport
ğŸŒï¸	ball, golf, golfspiller
ğŸŒğŸ»	ball, golf, golfspiller, golfspiller: hudtype 1â€“2, hudtype 1â€“2
ğŸŒğŸ¼	ball, golf, golfspiller, golfspiller: hudtype 3, hudtype 3
ğŸŒğŸ½	ball, golf, golfspiller, golfspiller: hudtype 4, hudtype 4
ğŸŒğŸ¾	ball, golf, golfspiller, golfspiller: hudtype 5, hudtype 5
ğŸŒğŸ¿	ball, golf, golfspiller, golfspiller: hudtype 6, hudtype 6
ğŸŒâ€â™‚	golf, golfspiller, mann, mannlig golfspiller
ğŸŒğŸ»â€â™‚	golf, golfspiller, hudtype 1â€“2, mann, mannlig golfspiller, mannlig golfspiller: hudtype 1â€“2
ğŸŒğŸ¼â€â™‚	golf, golfspiller, hudtype 3, mann, mannlig golfspiller, mannlig golfspiller: hudtype 3
ğŸŒğŸ½â€â™‚	golf, golfspiller, hudtype 4, mann, mannlig golfspiller, mannlig golfspiller: hudtype 4
ğŸŒğŸ¾â€â™‚	golf, golfspiller, hudtype 5, mann, mannlig golfspiller, mannlig golfspiller: hudtype 5
ğŸŒğŸ¿â€â™‚	golf, golfspiller, hudtype 6, mann, mannlig golfspiller, mannlig golfspiller: hudtype 6
ğŸŒâ€â™€	golf, golfspiller, kvinne, kvinnelig golfspiller
ğŸŒğŸ»â€â™€	golf, golfspiller, hudtype 1â€“2, kvinne, kvinnelig golfspiller, kvinnelig golfspiller: hudtype 1â€“2
ğŸŒğŸ¼â€â™€	golf, golfspiller, hudtype 3, kvinne, kvinnelig golfspiller, kvinnelig golfspiller: hudtype 3
ğŸŒğŸ½â€â™€	golf, golfspiller, hudtype 4, kvinne, kvinnelig golfspiller, kvinnelig golfspiller: hudtype 4
ğŸŒğŸ¾â€â™€	golf, golfspiller, hudtype 5, kvinne, kvinnelig golfspiller, kvinnelig golfspiller: hudtype 5
ğŸŒğŸ¿â€â™€	golf, golfspiller, hudtype 6, kvinne, kvinnelig golfspiller, kvinnelig golfspiller: hudtype 6
ğŸ„ï¸	sport, surfer, surfing
ğŸ„ğŸ»	hudtype 1â€“2, sport, surfer, surfer: hudtype 1â€“2, surfing
ğŸ„ğŸ¼	hudtype 3, sport, surfer, surfer: hudtype 3, surfing
ğŸ„ğŸ½	hudtype 4, sport, surfer, surfer: hudtype 4, surfing
ğŸ„ğŸ¾	hudtype 5, sport, surfer, surfer: hudtype 5, surfing
ğŸ„ğŸ¿	hudtype 6, sport, surfer, surfer: hudtype 6, surfing
ğŸ„â€â™‚	mann, mannlig surfer, surfing
ğŸ„ğŸ»â€â™‚	hudtype 1â€“2, mann, mannlig surfer, mannlig surfer: hudtype 1â€“2, surfing
ğŸ„ğŸ¼â€â™‚	hudtype 3, mann, mannlig surfer, mannlig surfer: hudtype 3, surfing
ğŸ„ğŸ½â€â™‚	hudtype 4, mann, mannlig surfer, mannlig surfer: hudtype 4, surfing
ğŸ„ğŸ¾â€â™‚	hudtype 5, mann, mannlig surfer, mannlig surfer: hudtype 5, surfing
ğŸ„ğŸ¿â€â™‚	hudtype 6, mann, mannlig surfer, mannlig surfer: hudtype 6, surfing
ğŸ„â€â™€	kvinne, kvinnelig surfer, surfing
ğŸ„ğŸ»â€â™€	hudtype 1â€“2, kvinne, kvinnelig surfer, kvinnelig surfer: hudtype 1â€“2, surfing
ğŸ„ğŸ¼â€â™€	hudtype 3, kvinne, kvinnelig surfer, kvinnelig surfer: hudtype 3, surfing
ğŸ„ğŸ½â€â™€	hudtype 4, kvinne, kvinnelig surfer, kvinnelig surfer: hudtype 4, surfing
ğŸ„ğŸ¾â€â™€	hudtype 5, kvinne, kvinnelig surfer, kvinnelig surfer: hudtype 5, surfing
ğŸ„ğŸ¿â€â™€	hudtype 6, kvinne, kvinnelig surfer, kvinnelig surfer: hudtype 6, surfing
ğŸš£	bÃ¥t, fartÃ¸y, person i robÃ¥t
ğŸš£ğŸ»	bÃ¥t, fartÃ¸y, hudtype 1â€“2, person i robÃ¥t, person i robÃ¥t: hudtype 1â€“2
ğŸš£ğŸ¼	bÃ¥t, fartÃ¸y, hudtype 3, person i robÃ¥t, person i robÃ¥t: hudtype 3
ğŸš£ğŸ½	bÃ¥t, fartÃ¸y, hudtype 4, person i robÃ¥t, person i robÃ¥t: hudtype 4
ğŸš£ğŸ¾	bÃ¥t, fartÃ¸y, hudtype 5, person i robÃ¥t, person i robÃ¥t: hudtype 5
ğŸš£ğŸ¿	bÃ¥t, fartÃ¸y, hudtype 6, person i robÃ¥t, person i robÃ¥t: hudtype 6
ğŸš£â€â™‚	bÃ¥t, mann, mann i robÃ¥t, ro, robÃ¥t
ğŸš£ğŸ»â€â™‚	bÃ¥t, hudtype 1â€“2, mann, mann i robÃ¥t, mann i robÃ¥t: hudtype 1â€“2, ro, robÃ¥t
ğŸš£ğŸ¼â€â™‚	bÃ¥t, hudtype 3, mann, mann i robÃ¥t, mann i robÃ¥t: hudtype 3, ro, robÃ¥t
ğŸš£ğŸ½â€â™‚	bÃ¥t, hudtype 4, mann, mann i robÃ¥t, mann i robÃ¥t: hudtype 4, ro, robÃ¥t
ğŸš£ğŸ¾â€â™‚	bÃ¥t, hudtype 5, mann, mann i robÃ¥t, mann i robÃ¥t: hudtype 5, ro, robÃ¥t
ğŸš£ğŸ¿â€â™‚	bÃ¥t, hudtype 6, mann, mann i robÃ¥t, mann i robÃ¥t: hudtype 6, ro, robÃ¥t
ğŸš£â€â™€	bÃ¥t, kvinne, kvinne i robÃ¥t, ro, robÃ¥t
ğŸš£ğŸ»â€â™€	bÃ¥t, hudtype 1â€“2, kvinne, kvinne i robÃ¥t, kvinne i robÃ¥t: hudtype 1â€“2, ro, robÃ¥t
ğŸš£ğŸ¼â€â™€	bÃ¥t, hudtype 3, kvinne, kvinne i robÃ¥t, kvinne i robÃ¥t: hudtype 3, ro, robÃ¥t
ğŸš£ğŸ½â€â™€	bÃ¥t, hudtype 4, kvinne, kvinne i robÃ¥t, kvinne i robÃ¥t: hudtype 4, ro, robÃ¥t
ğŸš£ğŸ¾â€â™€	bÃ¥t, hudtype 5, kvinne, kvinne i robÃ¥t, kvinne i robÃ¥t: hudtype 5, ro, robÃ¥t
ğŸš£ğŸ¿â€â™€	bÃ¥t, hudtype 6, kvinne, kvinne i robÃ¥t, kvinne i robÃ¥t: hudtype 6, ro, robÃ¥t
ğŸŠï¸	sport, svÃ¸mme, svÃ¸mmer, svÃ¸mming
ğŸŠğŸ»	hudtype 1â€“2, sport, svÃ¸mme, svÃ¸mmer, svÃ¸mmer: hudtype 1â€“2, svÃ¸mming
ğŸŠğŸ¼	hudtype 3, sport, svÃ¸mme, svÃ¸mmer, svÃ¸mmer: hudtype 3, svÃ¸mming
ğŸŠğŸ½	hudtype 4, sport, svÃ¸mme, svÃ¸mmer, svÃ¸mmer: hudtype 4, svÃ¸mming
ğŸŠğŸ¾	hudtype 5, sport, svÃ¸mme, svÃ¸mmer, svÃ¸mmer: hudtype 5, svÃ¸mming
ğŸŠğŸ¿	hudtype 6, sport, svÃ¸mme, svÃ¸mmer, svÃ¸mmer: hudtype 6, svÃ¸mming
ğŸŠâ€â™‚	mann, mannlig svÃ¸mmer, svÃ¸mme, svÃ¸mming
ğŸŠğŸ»â€â™‚	hudtype 1â€“2, mann, mannlig svÃ¸mmer, mannlig svÃ¸mmer: hudtype 1â€“2, svÃ¸mme, svÃ¸mming
ğŸŠğŸ¼â€â™‚	hudtype 3, mann, mannlig svÃ¸mmer, mannlig svÃ¸mmer: hudtype 3, svÃ¸mme, svÃ¸mming
ğŸŠğŸ½â€â™‚	hudtype 4, mann, mannlig svÃ¸mmer, mannlig svÃ¸mmer: hudtype 4, svÃ¸mme, svÃ¸mming
ğŸŠğŸ¾â€â™‚	hudtype 5, mann, mannlig svÃ¸mmer, mannlig svÃ¸mmer: hudtype 5, svÃ¸mme, svÃ¸mming
ğŸŠğŸ¿â€â™‚	hudtype 6, mann, mannlig svÃ¸mmer, mannlig svÃ¸mmer: hudtype 6, svÃ¸mme, svÃ¸mming
ğŸŠâ€â™€	kvinne, kvinnelig svÃ¸mmer, svÃ¸mme, svÃ¸mming
ğŸŠğŸ»â€â™€	hudtype 1â€“2, kvinne, kvinnelig svÃ¸mmer, kvinnelig svÃ¸mmer: hudtype 1â€“2, svÃ¸mme, svÃ¸mming
ğŸŠğŸ¼â€â™€	hudtype 3, kvinne, kvinnelig svÃ¸mmer, kvinnelig svÃ¸mmer: hudtype 3, svÃ¸mme, svÃ¸mming
ğŸŠğŸ½â€â™€	hudtype 4, kvinne, kvinnelig svÃ¸mmer, kvinnelig svÃ¸mmer: hudtype 4, svÃ¸mme, svÃ¸mming
ğŸŠğŸ¾â€â™€	hudtype 5, kvinne, kvinnelig svÃ¸mmer, kvinnelig svÃ¸mmer: hudtype 5, svÃ¸mme, svÃ¸mming
ğŸŠğŸ¿â€â™€	hudtype 6, kvinne, kvinnelig svÃ¸mmer, kvinnelig svÃ¸mmer: hudtype 6, svÃ¸mme, svÃ¸mming
â›¹ï¸	ball, person med ball
â›¹ğŸ»	ball, hudtype 1â€“2, person med ball, person med ball: hudtype 1â€“2
â›¹ğŸ¼	ball, hudtype 3, person med ball, person med ball: hudtype 3
â›¹ğŸ½	ball, hudtype 4, person med ball, person med ball: hudtype 4
â›¹ğŸ¾	ball, hudtype 5, person med ball, person med ball: hudtype 5
â›¹ğŸ¿	ball, hudtype 6, person med ball, person med ball: hudtype 6
â›¹â€â™‚	ballsport, mann, mann med ball
â›¹ğŸ»â€â™‚	ballsport, hudtype 1â€“2, mann, mann med ball, mann med ball: hudtype 1â€“2
â›¹ğŸ¼â€â™‚	ballsport, hudtype 3, mann, mann med ball, mann med ball: hudtype 3
â›¹ğŸ½â€â™‚	ballsport, hudtype 4, mann, mann med ball, mann med ball: hudtype 4
â›¹ğŸ¾â€â™‚	ballsport, hudtype 5, mann, mann med ball, mann med ball: hudtype 5
â›¹ğŸ¿â€â™‚	ballsport, hudtype 6, mann, mann med ball, mann med ball: hudtype 6
â›¹â€â™€	ballsport, kvinne, kvinne med ball
â›¹ğŸ»â€â™€	ballsport, hudtype 1â€“2, kvinne, kvinne med ball, kvinne med ball: hudtype 1â€“2
â›¹ğŸ¼â€â™€	ballsport, hudtype 3, kvinne, kvinne med ball, kvinne med ball: hudtype 3
â›¹ğŸ½â€â™€	ballsport, hudtype 4, kvinne, kvinne med ball, kvinne med ball: hudtype 4
â›¹ğŸ¾â€â™€	ballsport, hudtype 5, kvinne, kvinne med ball, kvinne med ball: hudtype 5
â›¹ğŸ¿â€â™€	ballsport, hudtype 6, kvinne, kvinne med ball, kvinne med ball: hudtype 6
ğŸ‹ï¸	lÃ¸fter, vekt, vektlÃ¸fter
ğŸ‹ğŸ»	hudtype 1â€“2, lÃ¸fter, vekt, vektlÃ¸fter, vektlÃ¸fter: hudtype 1â€“2
ğŸ‹ğŸ¼	hudtype 3, lÃ¸fter, vekt, vektlÃ¸fter, vektlÃ¸fter: hudtype 3
ğŸ‹ğŸ½	hudtype 4, lÃ¸fter, vekt, vektlÃ¸fter, vektlÃ¸fter: hudtype 4
ğŸ‹ğŸ¾	hudtype 5, lÃ¸fter, vekt, vektlÃ¸fter, vektlÃ¸fter: hudtype 5
ğŸ‹ğŸ¿	hudtype 6, lÃ¸fter, vekt, vektlÃ¸fter, vektlÃ¸fter: hudtype 6
ğŸ‹â€â™‚	bodybuilding, mann, mannlig vektlÃ¸fter, vektlÃ¸fter
ğŸ‹ğŸ»â€â™‚	bodybuilding, hudtype 1â€“2, mann, mannlig vektlÃ¸fter, mannlig vektlÃ¸fter: hudtype 1â€“2, vektlÃ¸fter
ğŸ‹ğŸ¼â€â™‚	bodybuilding, hudtype 3, mann, mannlig vektlÃ¸fter, mannlig vektlÃ¸fter: hudtype 3, vektlÃ¸fter
ğŸ‹ğŸ½â€â™‚	bodybuilding, hudtype 4, mann, mannlig vektlÃ¸fter, mannlig vektlÃ¸fter: hudtype 4, vektlÃ¸fter
ğŸ‹ğŸ¾â€â™‚	bodybuilding, hudtype 5, mann, mannlig vektlÃ¸fter, mannlig vektlÃ¸fter: hudtype 5, vektlÃ¸fter
ğŸ‹ğŸ¿â€â™‚	bodybuilding, hudtype 6, mann, mannlig vektlÃ¸fter, mannlig vektlÃ¸fter: hudtype 6, vektlÃ¸fter
ğŸ‹â€â™€	bodybuilding, kvinne, kvinnelig vektlÃ¸fter, vektlÃ¸fting
ğŸ‹ğŸ»â€â™€	bodybuilding, hudtype 1â€“2, kvinne, kvinnelig vektlÃ¸fter, kvinnelig vektlÃ¸fter: hudtype 1â€“2, vektlÃ¸fting
ğŸ‹ğŸ¼â€â™€	bodybuilding, hudtype 3, kvinne, kvinnelig vektlÃ¸fter, kvinnelig vektlÃ¸fter: hudtype 3, vektlÃ¸fting
ğŸ‹ğŸ½â€â™€	bodybuilding, hudtype 4, kvinne, kvinnelig vektlÃ¸fter, kvinnelig vektlÃ¸fter: hudtype 4, vektlÃ¸fting
ğŸ‹ğŸ¾â€â™€	bodybuilding, hudtype 5, kvinne, kvinnelig vektlÃ¸fter, kvinnelig vektlÃ¸fter: hudtype 5, vektlÃ¸fting
ğŸ‹ğŸ¿â€â™€	bodybuilding, hudtype 6, kvinne, kvinnelig vektlÃ¸fter, kvinnelig vektlÃ¸fter: hudtype 6, vektlÃ¸fting
ğŸš´	sykkel, sykle, syklist
ğŸš´ğŸ»	hudtype 1â€“2, sykkel, sykle, syklist, syklist: hudtype 1â€“2
ğŸš´ğŸ¼	hudtype 3, sykkel, sykle, syklist, syklist: hudtype 3
ğŸš´ğŸ½	hudtype 4, sykkel, sykle, syklist, syklist: hudtype 4
ğŸš´ğŸ¾	hudtype 5, sykkel, sykle, syklist, syklist: hudtype 5
ğŸš´ğŸ¿	hudtype 6, sykkel, sykle, syklist, syklist: hudtype 6
ğŸš´â€â™‚	mann, mannlig syklist, sykkel, sykle
ğŸš´ğŸ»â€â™‚	hudtype 1â€“2, mann, mannlig syklist, mannlig syklist: hudtype 1â€“2, sykkel, sykle
ğŸš´ğŸ¼â€â™‚	hudtype 3, mann, mannlig syklist, mannlig syklist: hudtype 3, sykkel, sykle
ğŸš´ğŸ½â€â™‚	hudtype 4, mann, mannlig syklist, mannlig syklist: hudtype 4, sykkel, sykle
ğŸš´ğŸ¾â€â™‚	hudtype 5, mann, mannlig syklist, mannlig syklist: hudtype 5, sykkel, sykle
ğŸš´ğŸ¿â€â™‚	hudtype 6, mann, mannlig syklist, mannlig syklist: hudtype 6, sykkel, sykle
ğŸš´â€â™€	kvinne, kvinnelig syklist, sykkel, sykle
ğŸš´ğŸ»â€â™€	hudtype 1â€“2, kvinne, kvinnelig syklist, kvinnelig syklist: hudtype 1â€“2, sykkel, sykle
ğŸš´ğŸ¼â€â™€	hudtype 3, kvinne, kvinnelig syklist, kvinnelig syklist: hudtype 3, sykkel, sykle
ğŸš´ğŸ½â€â™€	hudtype 4, kvinne, kvinnelig syklist, kvinnelig syklist: hudtype 4, sykkel, sykle
ğŸš´ğŸ¾â€â™€	hudtype 5, kvinne, kvinnelig syklist, kvinnelig syklist: hudtype 5, sykkel, sykle
ğŸš´ğŸ¿â€â™€	hudtype 6, kvinne, kvinnelig syklist, kvinnelig syklist: hudtype 6, sykkel, sykle
ğŸšµ	mountainbike, terrengsykkel, terrengsyklist
ğŸšµğŸ»	hudtype 1â€“2, mountainbike, terrengsykkel, terrengsyklist, terrengsyklist: hudtype 1â€“2
ğŸšµğŸ¼	hudtype 3, mountainbike, terrengsykkel, terrengsyklist, terrengsyklist: hudtype 3
ğŸšµğŸ½	hudtype 4, mountainbike, terrengsykkel, terrengsyklist, terrengsyklist: hudtype 4
ğŸšµğŸ¾	hudtype 5, mountainbike, terrengsykkel, terrengsyklist, terrengsyklist: hudtype 5
ğŸšµğŸ¿	hudtype 6, mountainbike, terrengsykkel, terrengsyklist, terrengsyklist: hudtype 6
ğŸšµâ€â™‚	mann, mann pÃ¥ terrengsykkel, mountainbike, terrengsykkel
ğŸšµğŸ»â€â™‚	hudtype 1â€“2, mann, mann pÃ¥ terrengsykkel, mann pÃ¥ terrengsykkel: hudtype 1â€“2, mountainbike, terrengsykkel
ğŸšµğŸ¼â€â™‚	hudtype 3, mann, mann pÃ¥ terrengsykkel, mann pÃ¥ terrengsykkel: hudtype 3, mountainbike, terrengsykkel
ğŸšµğŸ½â€â™‚	hudtype 4, mann, mann pÃ¥ terrengsykkel, mann pÃ¥ terrengsykkel: hudtype 4, mountainbike, terrengsykkel
ğŸšµğŸ¾â€â™‚	hudtype 5, mann, mann pÃ¥ terrengsykkel, mann pÃ¥ terrengsykkel: hudtype 5, mountainbike, terrengsykkel
ğŸšµğŸ¿â€â™‚	hudtype 6, mann, mann pÃ¥ terrengsykkel, mann pÃ¥ terrengsykkel: hudtype 6, mountainbike, terrengsykkel
ğŸšµâ€â™€	kvinne, kvinne pÃ¥ terrengsykkel, mountainbike, terrengsykkel
ğŸšµğŸ»â€â™€	hudtype 1â€“2, kvinne, kvinne pÃ¥ terrengsykkel, kvinne pÃ¥ terrengsykkel: hudtype 1â€“2, mountainbike, terrengsykkel
ğŸšµğŸ¼â€â™€	hudtype 3, kvinne, kvinne pÃ¥ terrengsykkel, kvinne pÃ¥ terrengsykkel: hudtype 3, mountainbike, terrengsykkel
ğŸšµğŸ½â€â™€	hudtype 4, kvinne, kvinne pÃ¥ terrengsykkel, kvinne pÃ¥ terrengsykkel: hudtype 4, mountainbike, terrengsykkel
ğŸšµğŸ¾â€â™€	hudtype 5, kvinne, kvinne pÃ¥ terrengsykkel, kvinne pÃ¥ terrengsykkel: hudtype 5, mountainbike, terrengsykkel
ğŸšµğŸ¿â€â™€	hudtype 6, kvinne, kvinne pÃ¥ terrengsykkel, kvinne pÃ¥ terrengsykkel: hudtype 6, mountainbike, terrengsykkel
ğŸ¤¸	gym, gymnastikk, person, slÃ¥ hjul, sport
ğŸ¤¸ğŸ»	gym, gymnastikk, hudtype 1â€“2, person, slÃ¥ hjul, slÃ¥ hjul: hudtype 1â€“2, sport
ğŸ¤¸ğŸ¼	gym, gymnastikk, hudtype 3, person, slÃ¥ hjul, slÃ¥ hjul: hudtype 3, sport
ğŸ¤¸ğŸ½	gym, gymnastikk, hudtype 4, person, slÃ¥ hjul, slÃ¥ hjul: hudtype 4, sport
ğŸ¤¸ğŸ¾	gym, gymnastikk, hudtype 5, person, slÃ¥ hjul, slÃ¥ hjul: hudtype 5, sport
ğŸ¤¸ğŸ¿	gym, gymnastikk, hudtype 6, person, slÃ¥ hjul, slÃ¥ hjul: hudtype 6, sport
ğŸ¤¸â€â™‚	mann, mann som slÃ¥r hjul, slÃ¥ hjul
ğŸ¤¸ğŸ»â€â™‚	hudtype 1â€“2, mann, mann som slÃ¥r hjul, mann som slÃ¥r hjul: hudtype 1â€“2, slÃ¥ hjul
ğŸ¤¸ğŸ¼â€â™‚	hudtype 3, mann, mann som slÃ¥r hjul, mann som slÃ¥r hjul: hudtype 3, slÃ¥ hjul
ğŸ¤¸ğŸ½â€â™‚	hudtype 4, mann, mann som slÃ¥r hjul, mann som slÃ¥r hjul: hudtype 4, slÃ¥ hjul
ğŸ¤¸ğŸ¾â€â™‚	hudtype 5, mann, mann som slÃ¥r hjul, mann som slÃ¥r hjul: hudtype 5, slÃ¥ hjul
ğŸ¤¸ğŸ¿â€â™‚	hudtype 6, mann, mann som slÃ¥r hjul, mann som slÃ¥r hjul: hudtype 6, slÃ¥ hjul
ğŸ¤¸â€â™€	kvinne, kvinne som slÃ¥r hjul, slÃ¥ hjul
ğŸ¤¸ğŸ»â€â™€	hudtype 1â€“2, kvinne, kvinne som slÃ¥r hjul, kvinne som slÃ¥r hjul: hudtype 1â€“2, slÃ¥ hjul
ğŸ¤¸ğŸ¼â€â™€	hudtype 3, kvinne, kvinne som slÃ¥r hjul, kvinne som slÃ¥r hjul: hudtype 3, slÃ¥ hjul
ğŸ¤¸ğŸ½â€â™€	hudtype 4, kvinne, kvinne som slÃ¥r hjul, kvinne som slÃ¥r hjul: hudtype 4, slÃ¥ hjul
ğŸ¤¸ğŸ¾â€â™€	hudtype 5, kvinne, kvinne som slÃ¥r hjul, kvinne som slÃ¥r hjul: hudtype 5, slÃ¥ hjul
ğŸ¤¸ğŸ¿â€â™€	hudtype 6, kvinne, kvinne som slÃ¥r hjul, kvinne som slÃ¥r hjul: hudtype 6, slÃ¥ hjul
ğŸ¤¼	bryter, brytere, bryting, person, sport
ğŸ¤¼â€â™‚	bryter, mann, mannlige brytere, menn
ğŸ¤¼â€â™€	bryter, kvinne, kvinnelige brytere, kvinner
ğŸ¤½	person, polo, sport, vann, vannpolo
ğŸ¤½ğŸ»	hudtype 1â€“2, person, polo, sport, vann, vannpolo, vannpolo: hudtype 1â€“2
ğŸ¤½ğŸ¼	hudtype 3, person, polo, sport, vann, vannpolo, vannpolo: hudtype 3
ğŸ¤½ğŸ½	hudtype 4, person, polo, sport, vann, vannpolo, vannpolo: hudtype 4
ğŸ¤½ğŸ¾	hudtype 5, person, polo, sport, vann, vannpolo, vannpolo: hudtype 5
ğŸ¤½ğŸ¿	hudtype 6, person, polo, sport, vann, vannpolo, vannpolo: hudtype 6
ğŸ¤½â€â™‚	mann, mannlig vannpolospiller, vannpolo
ğŸ¤½ğŸ»â€â™‚	hudtype 1â€“2, mann, mannlig vannpolospiller, mannlig vannpolospiller: hudtype 1â€“2, vannpolo
ğŸ¤½ğŸ¼â€â™‚	hudtype 3, mann, mannlig vannpolospiller, mannlig vannpolospiller: hudtype 3, vannpolo
ğŸ¤½ğŸ½â€â™‚	hudtype 4, mann, mannlig vannpolospiller, mannlig vannpolospiller: hudtype 4, vannpolo
ğŸ¤½ğŸ¾â€â™‚	hudtype 5, mann, mannlig vannpolospiller, mannlig vannpolospiller: hudtype 5, vannpolo
ğŸ¤½ğŸ¿â€â™‚	hudtype 6, mann, mannlig vannpolospiller, mannlig vannpolospiller: hudtype 6, vannpolo
ğŸ¤½â€â™€	kvinne, kvinnelig vannpolospiller, vannpolo
ğŸ¤½ğŸ»â€â™€	hudtype 1â€“2, kvinne, kvinnelig vannpolospiller, kvinnelig vannpolospiller: hudtype 1â€“2, vannpolo
ğŸ¤½ğŸ¼â€â™€	hudtype 3, kvinne, kvinnelig vannpolospiller, kvinnelig vannpolospiller: hudtype 3, vannpolo
ğŸ¤½ğŸ½â€â™€	hudtype 4, kvinne, kvinnelig vannpolospiller, kvinnelig vannpolospiller: hudtype 4, vannpolo
ğŸ¤½ğŸ¾â€â™€	hudtype 5, kvinne, kvinnelig vannpolospiller, kvinnelig vannpolospiller: hudtype 5, vannpolo
ğŸ¤½ğŸ¿â€â™€	hudtype 6, kvinne, kvinnelig vannpolospiller, kvinnelig vannpolospiller: hudtype 6, vannpolo
ğŸ¤¾	ball, hÃ¥ndball, person, sport
ğŸ¤¾ğŸ»	ball, hudtype 1â€“2, hÃ¥ndball, hÃ¥ndball: hudtype 1â€“2, person, sport
ğŸ¤¾ğŸ¼	ball, hudtype 3, hÃ¥ndball, hÃ¥ndball: hudtype 3, person, sport
ğŸ¤¾ğŸ½	ball, hudtype 4, hÃ¥ndball, hÃ¥ndball: hudtype 4, person, sport
ğŸ¤¾ğŸ¾	ball, hudtype 5, hÃ¥ndball, hÃ¥ndball: hudtype 5, person, sport
ğŸ¤¾ğŸ¿	ball, hudtype 6, hÃ¥ndball, hÃ¥ndball: hudtype 6, person, sport
ğŸ¤¾â€â™‚	hÃ¥ndball, mann, mannlig hÃ¥ndballspiller
ğŸ¤¾ğŸ»â€â™‚	hudtype 1â€“2, hÃ¥ndball, mann, mannlig hÃ¥ndballspiller, mannlig hÃ¥ndballspiller: hudtype 1â€“2
ğŸ¤¾ğŸ¼â€â™‚	hudtype 3, hÃ¥ndball, mann, mannlig hÃ¥ndballspiller, mannlig hÃ¥ndballspiller: hudtype 3
ğŸ¤¾ğŸ½â€â™‚	hudtype 4, hÃ¥ndball, mann, mannlig hÃ¥ndballspiller, mannlig hÃ¥ndballspiller: hudtype 4
ğŸ¤¾ğŸ¾â€â™‚	hudtype 5, hÃ¥ndball, mann, mannlig hÃ¥ndballspiller, mannlig hÃ¥ndballspiller: hudtype 5
ğŸ¤¾ğŸ¿â€â™‚	hudtype 6, hÃ¥ndball, mann, mannlig hÃ¥ndballspiller, mannlig hÃ¥ndballspiller: hudtype 6
ğŸ¤¾â€â™€	hÃ¥ndball, kvinne, kvinnelig hÃ¥ndballspiller
ğŸ¤¾ğŸ»â€â™€	hudtype 1â€“2, hÃ¥ndball, kvinne, kvinnelig hÃ¥ndballspiller, kvinnelig hÃ¥ndballspiller: hudtype 1â€“2
ğŸ¤¾ğŸ¼â€â™€	hudtype 3, hÃ¥ndball, kvinne, kvinnelig hÃ¥ndballspiller, kvinnelig hÃ¥ndballspiller: hudtype 3
ğŸ¤¾ğŸ½â€â™€	hudtype 4, hÃ¥ndball, kvinne, kvinnelig hÃ¥ndballspiller, kvinnelig hÃ¥ndballspiller: hudtype 4
ğŸ¤¾ğŸ¾â€â™€	hudtype 5, hÃ¥ndball, kvinne, kvinnelig hÃ¥ndballspiller, kvinnelig hÃ¥ndballspiller: hudtype 5
ğŸ¤¾ğŸ¿â€â™€	hudtype 6, hÃ¥ndball, kvinne, kvinnelig hÃ¥ndballspiller, kvinnelig hÃ¥ndballspiller: hudtype 6
ğŸ¤¹	balanse, ferdighet, multitasking, sjonglering
ğŸ¤¹ğŸ»	balanse, ferdighet, hudtype 1â€“2, multitasking, sjonglering, sjonglering: hudtype 1â€“2
ğŸ¤¹ğŸ¼	balanse, ferdighet, hudtype 3, multitasking, sjonglering, sjonglering: hudtype 3
ğŸ¤¹ğŸ½	balanse, ferdighet, hudtype 4, multitasking, sjonglering, sjonglering: hudtype 4
ğŸ¤¹ğŸ¾	balanse, ferdighet, hudtype 5, multitasking, sjonglering, sjonglering: hudtype 5
ğŸ¤¹ğŸ¿	balanse, ferdighet, hudtype 6, multitasking, sjonglering, sjonglering: hudtype 6
ğŸ¤¹â€â™‚	mann, mannlig sjonglÃ¸r, sirkus, sjonglere
ğŸ¤¹ğŸ»â€â™‚	hudtype 1â€“2, mann, mannlig sjonglÃ¸r, mannlig sjonglÃ¸r: hudtype 1â€“2, sirkus, sjonglere
ğŸ¤¹ğŸ¼â€â™‚	hudtype 3, mann, mannlig sjonglÃ¸r, mannlig sjonglÃ¸r: hudtype 3, sirkus, sjonglere
ğŸ¤¹ğŸ½â€â™‚	hudtype 4, mann, mannlig sjonglÃ¸r, mannlig sjonglÃ¸r: hudtype 4, sirkus, sjonglere
ğŸ¤¹ğŸ¾â€â™‚	hudtype 5, mann, mannlig sjonglÃ¸r, mannlig sjonglÃ¸r: hudtype 5, sirkus, sjonglere
ğŸ¤¹ğŸ¿â€â™‚	hudtype 6, mann, mannlig sjonglÃ¸r, mannlig sjonglÃ¸r: hudtype 6, sirkus, sjonglere
ğŸ¤¹â€â™€	kvinne, kvinnelig sjonglÃ¸r, sirkus, sjonglere
ğŸ¤¹ğŸ»â€â™€	hudtype 1â€“2, kvinne, kvinnelig sjonglÃ¸r, kvinnelig sjonglÃ¸r: hudtype 1â€“2, sirkus, sjonglere
ğŸ¤¹ğŸ¼â€â™€	hudtype 3, kvinne, kvinnelig sjonglÃ¸r, kvinnelig sjonglÃ¸r: hudtype 3, sirkus, sjonglere
ğŸ¤¹ğŸ½â€â™€	hudtype 4, kvinne, kvinnelig sjonglÃ¸r, kvinnelig sjonglÃ¸r: hudtype 4, sirkus, sjonglere
ğŸ¤¹ğŸ¾â€â™€	hudtype 5, kvinne, kvinnelig sjonglÃ¸r, kvinnelig sjonglÃ¸r: hudtype 5, sirkus, sjonglere
ğŸ¤¹ğŸ¿â€â™€	hudtype 6, kvinne, kvinnelig sjonglÃ¸r, kvinnelig sjonglÃ¸r: hudtype 6, sirkus, sjonglere
ğŸ§˜	lotusstilling, meditasjon, yoga
ğŸ§˜ğŸ»	hudtype 1â€“2, lotusstilling, lotusstilling: hudtype 1â€“2, meditasjon, yoga
ğŸ§˜ğŸ¼	hudtype 3, lotusstilling, lotusstilling: hudtype 3, meditasjon, yoga
ğŸ§˜ğŸ½	hudtype 4, lotusstilling, lotusstilling: hudtype 4, meditasjon, yoga
ğŸ§˜ğŸ¾	hudtype 5, lotusstilling, lotusstilling: hudtype 5, meditasjon, yoga
ğŸ§˜ğŸ¿	hudtype 6, lotusstilling, lotusstilling: hudtype 6, meditasjon, yoga
ğŸ§˜â€â™‚	mann i lotusstilling, meditasjon, yoga
ğŸ§˜ğŸ»â€â™‚	hudtype 1â€“2, mann i lotusstilling, mann i lotusstilling: hudtype 1â€“2, meditasjon, yoga
ğŸ§˜ğŸ¼â€â™‚	hudtype 3, mann i lotusstilling, mann i lotusstilling: hudtype 3, meditasjon, yoga
ğŸ§˜ğŸ½â€â™‚	hudtype 4, mann i lotusstilling, mann i lotusstilling: hudtype 4, meditasjon, yoga
ğŸ§˜ğŸ¾â€â™‚	hudtype 5, mann i lotusstilling, mann i lotusstilling: hudtype 5, meditasjon, yoga
ğŸ§˜ğŸ¿â€â™‚	hudtype 6, mann i lotusstilling, mann i lotusstilling: hudtype 6, meditasjon, yoga
ğŸ§˜â€â™€	kvinne i lotusstilling, meditasjon, yoga
ğŸ§˜ğŸ»â€â™€	hudtype 1â€“2, kvinne i lotusstilling, kvinne i lotusstilling: hudtype 1â€“2, meditasjon, yoga
ğŸ§˜ğŸ¼â€â™€	hudtype 3, kvinne i lotusstilling, kvinne i lotusstilling: hudtype 3, meditasjon, yoga
ğŸ§˜ğŸ½â€â™€	hudtype 4, kvinne i lotusstilling, kvinne i lotusstilling: hudtype 4, meditasjon, yoga
ğŸ§˜ğŸ¾â€â™€	hudtype 5, kvinne i lotusstilling, kvinne i lotusstilling: hudtype 5, meditasjon, yoga
ğŸ§˜ğŸ¿â€â™€	hudtype 6, kvinne i lotusstilling, kvinne i lotusstilling: hudtype 6, meditasjon, yoga
ğŸ›€	bad, badekar, person i badekar
ğŸ›€ğŸ»	bad, badekar, hudtype 1â€“2, person i badekar, person i badekar: hudtype 1â€“2
ğŸ›€ğŸ¼	bad, badekar, hudtype 3, person i badekar, person i badekar: hudtype 3
ğŸ›€ğŸ½	bad, badekar, hudtype 4, person i badekar, person i badekar: hudtype 4
ğŸ›€ğŸ¾	bad, badekar, hudtype 5, person i badekar, person i badekar: hudtype 5
ğŸ›€ğŸ¿	bad, badekar, hudtype 6, person i badekar, person i badekar: hudtype 6
ğŸ›Œ	hotell, person i seng, sove
ğŸ›ŒğŸ»	hotell, hudtype 1â€“2, person i seng, person i seng: hudtype 1â€“2, sove
ğŸ›ŒğŸ¼	hotell, hudtype 3, person i seng, person i seng: hudtype 3, sove
ğŸ›ŒğŸ½	hotell, hudtype 4, person i seng, person i seng: hudtype 4, sove
ğŸ›ŒğŸ¾	hotell, hudtype 5, person i seng, person i seng: hudtype 5, sove
ğŸ›ŒğŸ¿	hotell, hudtype 6, person i seng, person i seng: hudtype 6, sove
ğŸ§‘â€ğŸ¤â€ğŸ§‘	holde hender, par, personer, personer som leier
ğŸ§‘ğŸ»â€ğŸ¤â€ğŸ§‘ğŸ»	holde hender, hudtype 1â€“2, par, personer, personer som leier, personer som leier: hudtype 1â€“2
ğŸ§‘ğŸ¼â€ğŸ¤â€ğŸ§‘ğŸ»	holde hender, hudtype 1â€“2, hudtype 3, par, personer, personer som leier, personer som leier: hudtype 3, hudtype 1â€“2
ğŸ§‘ğŸ¼â€ğŸ¤â€ğŸ§‘ğŸ¼	holde hender, hudtype 3, par, personer, personer som leier, personer som leier: hudtype 3
ğŸ§‘ğŸ½â€ğŸ¤â€ğŸ§‘ğŸ»	holde hender, hudtype 1â€“2, hudtype 4, par, personer, personer som leier, personer som leier: hudtype 4, hudtype 1â€“2
ğŸ§‘ğŸ½â€ğŸ¤â€ğŸ§‘ğŸ¼	holde hender, hudtype 3, hudtype 4, par, personer, personer som leier, personer som leier: hudtype 4, hudtype 3
ğŸ§‘ğŸ½â€ğŸ¤â€ğŸ§‘ğŸ½	holde hender, hudtype 4, par, personer, personer som leier, personer som leier: hudtype 4
ğŸ§‘ğŸ¾â€ğŸ¤â€ğŸ§‘ğŸ»	holde hender, hudtype 1â€“2, hudtype 5, par, personer, personer som leier, personer som leier: hudtype 5, hudtype 1â€“2
ğŸ§‘ğŸ¾â€ğŸ¤â€ğŸ§‘ğŸ¼	holde hender, hudtype 3, hudtype 5, par, personer, personer som leier, personer som leier: hudtype 5, hudtype 3
ğŸ§‘ğŸ¾â€ğŸ¤â€ğŸ§‘ğŸ½	holde hender, hudtype 4, hudtype 5, par, personer, personer som leier, personer som leier: hudtype 5, hudtype 4
ğŸ§‘ğŸ¾â€ğŸ¤â€ğŸ§‘ğŸ¾	holde hender, hudtype 5, par, personer, personer som leier, personer som leier: hudtype 5
ğŸ§‘ğŸ¿â€ğŸ¤â€ğŸ§‘ğŸ»	holde hender, hudtype 1â€“2, hudtype 6, par, personer, personer som leier, personer som leier: hudtype 6, hudtype 1â€“2
ğŸ§‘ğŸ¿â€ğŸ¤â€ğŸ§‘ğŸ¼	holde hender, hudtype 3, hudtype 6, par, personer, personer som leier, personer som leier: hudtype 6, hudtype 3
ğŸ§‘ğŸ¿â€ğŸ¤â€ğŸ§‘ğŸ½	holde hender, hudtype 4, hudtype 6, par, personer, personer som leier, personer som leier: hudtype 6, hudtype 4
ğŸ§‘ğŸ¿â€ğŸ¤â€ğŸ§‘ğŸ¾	holde hender, hudtype 5, hudtype 6, par, personer, personer som leier, personer som leier: hudtype 6, hudtype 5
ğŸ§‘ğŸ¿â€ğŸ¤â€ğŸ§‘ğŸ¿	holde hender, hudtype 6, par, personer, personer som leier, personer som leier: hudtype 6
ğŸ‘­	holder hender, kvinne, kvinner som leier, par, to kvinner som leier
ğŸ‘­ğŸ»	holder hender, hudtype 1â€“2, kvinne, kvinner som leier, kvinner som leier: hudtype 1â€“2, par, to kvinner som leier
ğŸ‘©ğŸ¼â€ğŸ¤â€ğŸ‘©ğŸ»	holder hender, hudtype 1â€“2, hudtype 3, kvinne, kvinner som leier, kvinner som leier: hudtype 3, hudtype 1â€“2, par, to kvinner som leier
ğŸ‘­ğŸ¼	holder hender, hudtype 3, kvinne, kvinner som leier, kvinner som leier: hudtype 3, par, to kvinner som leier
ğŸ‘©ğŸ½â€ğŸ¤â€ğŸ‘©ğŸ»	holder hender, hudtype 1â€“2, hudtype 4, kvinne, kvinner som leier, kvinner som leier: hudtype 4, hudtype 1â€“2, par, to kvinner som leier
ğŸ‘©ğŸ½â€ğŸ¤â€ğŸ‘©ğŸ¼	holder hender, hudtype 3, hudtype 4, kvinne, kvinner som leier, kvinner som leier: hudtype 4, hudtype 3, par, to kvinner som leier
ğŸ‘­ğŸ½	holder hender, hudtype 4, kvinne, kvinner som leier, kvinner som leier: hudtype 4, par, to kvinner som leier
ğŸ‘©ğŸ¾â€ğŸ¤â€ğŸ‘©ğŸ»	holder hender, hudtype 1â€“2, hudtype 5, kvinne, kvinner som leier, kvinner som leier: hudtype 5, hudtype 1â€“2, par, to kvinner som leier
ğŸ‘©ğŸ¾â€ğŸ¤â€ğŸ‘©ğŸ¼	holder hender, hudtype 3, hudtype 5, kvinne, kvinner som leier, kvinner som leier: hudtype 5, hudtype 3, par, to kvinner som leier
ğŸ‘©ğŸ¾â€ğŸ¤â€ğŸ‘©ğŸ½	holder hender, hudtype 4, hudtype 5, kvinne, kvinner som leier, kvinner som leier: hudtype 5, hudtype 4, par, to kvinner som leier
ğŸ‘­ğŸ¾	holder hender, hudtype 5, kvinne, kvinner som leier, kvinner som leier: hudtype 5, par, to kvinner som leier
ğŸ‘©ğŸ¿â€ğŸ¤â€ğŸ‘©ğŸ»	holder hender, hudtype 1â€“2, hudtype 6, kvinne, kvinner som leier, kvinner som leier: hudtype 6, hudtype 1â€“2, par, to kvinner som leier
ğŸ‘©ğŸ¿â€ğŸ¤â€ğŸ‘©ğŸ¼	holder hender, hudtype 3, hudtype 6, kvinne, kvinner som leier, kvinner som leier: hudtype 6, hudtype 3, par, to kvinner som leier
ğŸ‘©ğŸ¿â€ğŸ¤â€ğŸ‘©ğŸ½	holder hender, hudtype 4, hudtype 6, kvinne, kvinner som leier, kvinner som leier: hudtype 6, hudtype 4, par, to kvinner som leier
ğŸ‘©ğŸ¿â€ğŸ¤â€ğŸ‘©ğŸ¾	holder hender, hudtype 5, hudtype 6, kvinne, kvinner som leier, kvinner som leier: hudtype 6, hudtype 5, par, to kvinner som leier
ğŸ‘­ğŸ¿	holder hender, hudtype 6, kvinne, kvinner som leier, kvinner som leier: hudtype 6, par, to kvinner som leier
ğŸ‘«	holder hender, kvinne, mann, mann og kvinne som leier, par
ğŸ‘«ğŸ»	holder hender, hudtype 1â€“2, kvinne, mann, mann og kvinne som leier, mann og kvinne som leier: hudtype 1â€“2, par
ğŸ‘©ğŸ»â€ğŸ¤â€ğŸ‘¨ğŸ¼	holder hender, hudtype 1â€“2, hudtype 3, kvinne, mann, mann og kvinne som leier, mann og kvinne som leier: hudtype 1â€“2, hudtype 3, par
ğŸ‘©ğŸ»â€ğŸ¤â€ğŸ‘¨ğŸ½	holder hender, hudtype 1â€“2, hudtype 4, kvinne, mann, mann og kvinne som leier, mann og kvinne som leier: hudtype 1â€“2, hudtype 4, par
ğŸ‘©ğŸ»â€ğŸ¤â€ğŸ‘¨ğŸ¾	holder hender, hudtype 1â€“2, hudtype 5, kvinne, mann, mann og kvinne som leier, mann og kvinne som leier: hudtype 1â€“2, hudtype 5, par
ğŸ‘©ğŸ»â€ğŸ¤â€ğŸ‘¨ğŸ¿	holder hender, hudtype 1â€“2, hudtype 6, kvinne, mann, mann og kvinne som leier, mann og kvinne som leier: hudtype 1â€“2, hudtype 6, par
ğŸ‘©ğŸ¼â€ğŸ¤â€ğŸ‘¨ğŸ»	holder hender, hudtype 1â€“2, hudtype 3, kvinne, mann, mann og kvinne som leier, mann og kvinne som leier: hudtype 3, hudtype 1â€“2, par
ğŸ‘«ğŸ¼	holder hender, hudtype 3, kvinne, mann, mann og kvinne som leier, mann og kvinne som leier: hudtype 3, par
ğŸ‘©ğŸ¼â€ğŸ¤â€ğŸ‘¨ğŸ½	holder hender, hudtype 3, hudtype 4, kvinne, mann, mann og kvinne som leier, mann og kvinne som leier: hudtype 3, hudtype 4, par
ğŸ‘©ğŸ¼â€ğŸ¤â€ğŸ‘¨ğŸ¾	holder hender, hudtype 3, hudtype 5, kvinne, mann, mann og kvinne som leier, mann og kvinne som leier: hudtype 3, hudtype 5, par
ğŸ‘©ğŸ¼â€ğŸ¤â€ğŸ‘¨ğŸ¿	holder hender, hudtype 3, hudtype 6, kvinne, mann, mann og kvinne som leier, mann og kvinne som leier: hudtype 3, hudtype 6, par
ğŸ‘©ğŸ½â€ğŸ¤â€ğŸ‘¨ğŸ»	holder hender, hudtype 1â€“2, hudtype 4, kvinne, mann, mann og kvinne som leier, mann og kvinne som leier: hudtype 4, hudtype 1â€“2, par
ğŸ‘©ğŸ½â€ğŸ¤â€ğŸ‘¨ğŸ¼	holder hender, hudtype 3, hudtype 4, kvinne, mann, mann og kvinne som leier, mann og kvinne som leier: hudtype 4, hudtype 3, par
ğŸ‘«ğŸ½	holder hender, hudtype 4, kvinne, mann, mann og kvinne som leier, mann og kvinne som leier: hudtype 4, par
ğŸ‘©ğŸ½â€ğŸ¤â€ğŸ‘¨ğŸ¾	holder hender, hudtype 4, hudtype 5, kvinne, mann, mann og kvinne som leier, mann og kvinne som leier: hudtype 4, hudtype 5, par
ğŸ‘©ğŸ½â€ğŸ¤â€ğŸ‘¨ğŸ¿	holder hender, hudtype 4, hudtype 6, kvinne, mann, mann og kvinne som leier, mann og kvinne som leier: hudtype 4, hudtype 6, par
ğŸ‘©ğŸ¾â€ğŸ¤â€ğŸ‘¨ğŸ»	holder hender, hudtype 1â€“2, hudtype 5, kvinne, mann, mann og kvinne som leier, mann og kvinne som leier: hudtype 5, hudtype 1â€“2, par
ğŸ‘©ğŸ¾â€ğŸ¤â€ğŸ‘¨ğŸ¼	holder hender, hudtype 3, hudtype 5, kvinne, mann, mann og kvinne som leier, mann og kvinne som leier: hudtype 5, hudtype 3, par
ğŸ‘©ğŸ¾â€ğŸ¤â€ğŸ‘¨ğŸ½	holder hender, hudtype 4, hudtype 5, kvinne, mann, mann og kvinne som leier, mann og kvinne som leier: hudtype 5, hudtype 4, par
ğŸ‘«ğŸ¾	holder hender, hudtype 5, kvinne, mann, mann og kvinne som leier, mann og kvinne som leier: hudtype 5, par
ğŸ‘©ğŸ¾â€ğŸ¤â€ğŸ‘¨ğŸ¿	holder hender, hudtype 5, hudtype 6, kvinne, mann, mann og kvinne som leier, mann og kvinne som leier: hudtype 5, hudtype 6, par
ğŸ‘©ğŸ¿â€ğŸ¤â€ğŸ‘¨ğŸ»	holder hender, hudtype 1â€“2, hudtype 6, kvinne, mann, mann og kvinne som leier, mann og kvinne som leier: hudtype 6, hudtype 1â€“2, par
ğŸ‘©ğŸ¿â€ğŸ¤â€ğŸ‘¨ğŸ¼	holder hender, hudtype 3, hudtype 6, kvinne, mann, mann og kvinne som leier, mann og kvinne som leier: hudtype 6, hudtype 3, par
ğŸ‘©ğŸ¿â€ğŸ¤â€ğŸ‘¨ğŸ½	holder hender, hudtype 4, hudtype 6, kvinne, mann, mann og kvinne som leier, mann og kvinne som leier: hudtype 6, hudtype 4, par
ğŸ‘©ğŸ¿â€ğŸ¤â€ğŸ‘¨ğŸ¾	holder hender, hudtype 5, hudtype 6, kvinne, mann, mann og kvinne som leier, mann og kvinne som leier: hudtype 6, hudtype 5, par
ğŸ‘«ğŸ¿	holder hender, hudtype 6, kvinne, mann, mann og kvinne som leier, mann og kvinne som leier: hudtype 6, par
ğŸ‘¬	holde hender, leier, mann, menn, menn som leier, par, stjernetegn, tvillingene
ğŸ‘¬ğŸ»	holde hender, hudtype 1â€“2, leier, mann, menn, menn som leier, menn som leier: hudtype 1â€“2, par, stjernetegn, tvillingene
ğŸ‘¨ğŸ¼â€ğŸ¤â€ğŸ‘¨ğŸ»	holde hender, hudtype 1â€“2, hudtype 3, leier, mann, menn, menn som leier, menn som leier: hudtype 3, hudtype 1â€“2, par, stjernetegn, tvillingene
ğŸ‘¬ğŸ¼	holde hender, hudtype 3, leier, mann, menn, menn som leier, menn som leier: hudtype 3, par, stjernetegn, tvillingene
ğŸ‘¨ğŸ½â€ğŸ¤â€ğŸ‘¨ğŸ»	holde hender, hudtype 1â€“2, hudtype 4, leier, mann, menn, menn som leier, menn som leier: hudtype 4, hudtype 1â€“2, par, stjernetegn, tvillingene
ğŸ‘¨ğŸ½â€ğŸ¤â€ğŸ‘¨ğŸ¼	holde hender, hudtype 3, hudtype 4, leier, mann, menn, menn som leier, menn som leier: hudtype 4, hudtype 3, par, stjernetegn, tvillingene
ğŸ‘¬ğŸ½	holde hender, hudtype 4, leier, mann, menn, menn som leier, menn som leier: hudtype 4, par, stjernetegn, tvillingene
ğŸ‘¨ğŸ¾â€ğŸ¤â€ğŸ‘¨ğŸ»	holde hender, hudtype 1â€“2, hudtype 5, leier, mann, menn, menn som leier, menn som leier: hudtype 5, hudtype 1â€“2, par, stjernetegn, tvillingene
ğŸ‘¨ğŸ¾â€ğŸ¤â€ğŸ‘¨ğŸ¼	holde hender, hudtype 3, hudtype 5, leier, mann, menn, menn som leier, menn som leier: hudtype 5, hudtype 3, par, stjernetegn, tvillingene
ğŸ‘¨ğŸ¾â€ğŸ¤â€ğŸ‘¨ğŸ½	holde hender, hudtype 4, hudtype 5, leier, mann, menn, menn som leier, menn som leier: hudtype 5, hudtype 4, par, stjernetegn, tvillingene
ğŸ‘¬ğŸ¾	holde hender, hudtype 5, leier, mann, menn, menn som leier, menn som leier: hudtype 5, par, stjernetegn, tvillingene
ğŸ‘¨ğŸ¿â€ğŸ¤â€ğŸ‘¨ğŸ»	holde hender, hudtype 1â€“2, hudtype 6, leier, mann, menn, menn som leier, menn som leier: hudtype 6, hudtype 1â€“2, par, stjernetegn, tvillingene
ğŸ‘¨ğŸ¿â€ğŸ¤â€ğŸ‘¨ğŸ¼	holde hender, hudtype 3, hudtype 6, leier, mann, menn, menn som leier, menn som leier: hudtype 6, hudtype 3, par, stjernetegn, tvillingene
ğŸ‘¨ğŸ¿â€ğŸ¤â€ğŸ‘¨ğŸ½	holde hender, hudtype 4, hudtype 6, leier, mann, menn, menn som leier, menn som leier: hudtype 6, hudtype 4, par, stjernetegn, tvillingene
ğŸ‘¨ğŸ¿â€ğŸ¤â€ğŸ‘¨ğŸ¾	holde hender, hudtype 5, hudtype 6, leier, mann, menn, menn som leier, menn som leier: hudtype 6, hudtype 5, par, stjernetegn, tvillingene
ğŸ‘¬ğŸ¿	holde hender, hudtype 6, leier, mann, menn, menn som leier, menn som leier: hudtype 6, par, stjernetegn, tvillingene
ğŸ’	kyss, kyssing, mennesker, romantikk
ğŸ‘©â€â¤â€ğŸ’‹â€ğŸ‘¨	kvinne, kyss, kyss: kvinne, mann, kyssing, mann, mennesker, romantikk
ğŸ‘¨â€â¤â€ğŸ’‹â€ğŸ‘¨	kyss, kyss: mann, mann, kyssing, mann, mennesker, romantikk
ğŸ‘©â€â¤â€ğŸ’‹â€ğŸ‘©	kvinne, kyss, kyss: kvinne, kvinne, kyssing, mennesker, romantikk
ğŸ’‘	hjerte, kjÃ¦rlighet, mennesker, par med hjerte, romantikk
ğŸ‘©â€â¤â€ğŸ‘¨	hjerte, kjÃ¦rlighet, kvinne, mann, mennesker, par med hjerte, par med hjerte: kvinne, mann, romantikk
ğŸ‘¨â€â¤â€ğŸ‘¨	hjerte, kjÃ¦rlighet, mann, mennesker, par med hjerte, par med hjerte: mann, mann, romantikk
ğŸ‘©â€â¤â€ğŸ‘©	hjerte, kjÃ¦rlighet, kvinne, mennesker, par med hjerte, par med hjerte: kvinne, kvinne, romantikk
ğŸ‘ªï¸	barn, familie, far, mennesker, mor
ğŸ‘¨â€ğŸ‘©â€ğŸ‘¦	barn, familie, familie: mann, kvinne, gutt, far, gutt, kvinne, mann, mennesker, mor
ğŸ‘¨â€ğŸ‘©â€ğŸ‘§	barn, familie, familie: mann, kvinne, jente, far, jente, kvinne, mann, mennesker, mor
ğŸ‘¨â€ğŸ‘©â€ğŸ‘§â€ğŸ‘¦	barn, familie, familie: mann, kvinne, jente, gutt, far, gutt, jente, kvinne, mann, mennesker, mor
ğŸ‘¨â€ğŸ‘©â€ğŸ‘¦â€ğŸ‘¦	barn, familie, familie: mann, kvinne, gutt, gutt, far, gutt, kvinne, mann, mennesker, mor
ğŸ‘¨â€ğŸ‘©â€ğŸ‘§â€ğŸ‘§	barn, familie, familie: mann, kvinne, jente, jente, far, jente, kvinne, mann, mennesker, mor
ğŸ‘¨â€ğŸ‘¨â€ğŸ‘¦	barn, familie, familie: mann, mann, gutt, far, gutt, mann, mennesker, mor
ğŸ‘¨â€ğŸ‘¨â€ğŸ‘§	barn, familie, familie: mann, mann, jente, far, jente, mann, mennesker, mor
ğŸ‘¨â€ğŸ‘¨â€ğŸ‘§â€ğŸ‘¦	barn, familie, familie: mann, mann, jente, gutt, far, gutt, jente, mann, mennesker, mor
ğŸ‘¨â€ğŸ‘¨â€ğŸ‘¦â€ğŸ‘¦	barn, familie, familie: mann, mann, gutt, gutt, far, gutt, mann, mennesker, mor
ğŸ‘¨â€ğŸ‘¨â€ğŸ‘§â€ğŸ‘§	barn, familie, familie: mann, mann, jente, jente, far, jente, mann, mennesker, mor
ğŸ‘©â€ğŸ‘©â€ğŸ‘¦	barn, familie, familie: kvinne, kvinne, gutt, far, gutt, kvinne, mennesker, mor
ğŸ‘©â€ğŸ‘©â€ğŸ‘§	barn, familie, familie: kvinne, kvinne, jente, far, jente, kvinne, mennesker, mor
ğŸ‘©â€ğŸ‘©â€ğŸ‘§â€ğŸ‘¦	barn, familie, familie: kvinne, kvinne, jente, gutt, far, gutt, jente, kvinne, mennesker, mor
ğŸ‘©â€ğŸ‘©â€ğŸ‘¦â€ğŸ‘¦	barn, familie, familie: kvinne, kvinne, gutt, gutt, far, gutt, kvinne, mennesker, mor
ğŸ‘©â€ğŸ‘©â€ğŸ‘§â€ğŸ‘§	barn, familie, familie: kvinne, kvinne, jente, jente, far, jente, kvinne, mennesker, mor
ğŸ‘¨â€ğŸ‘¦	barn, familie, familie: mann, gutt, far, gutt, mann, mennesker, mor
ğŸ‘¨â€ğŸ‘¦â€ğŸ‘¦	barn, familie, familie: mann, gutt, gutt, far, gutt, mann, mennesker, mor
ğŸ‘¨â€ğŸ‘§	barn, familie, familie: mann, jente, far, jente, mann, mennesker, mor
ğŸ‘¨â€ğŸ‘§â€ğŸ‘¦	barn, familie, familie: mann, jente, gutt, far, gutt, jente, mann, mennesker, mor
ğŸ‘¨â€ğŸ‘§â€ğŸ‘§	barn, familie, familie: mann, jente, jente, far, jente, mann, mennesker, mor
ğŸ‘©â€ğŸ‘¦	barn, familie, familie: kvinne, gutt, far, gutt, kvinne, mennesker, mor
ğŸ‘©â€ğŸ‘¦â€ğŸ‘¦	barn, familie, familie: kvinne, gutt, gutt, far, gutt, kvinne, mennesker, mor
ğŸ‘©â€ğŸ‘§	barn, familie, familie: kvinne, jente, far, jente, kvinne, mennesker, mor
ğŸ‘©â€ğŸ‘§â€ğŸ‘¦	barn, familie, familie: kvinne, jente, gutt, far, gutt, jente, kvinne, mennesker, mor
ğŸ‘©â€ğŸ‘§â€ğŸ‘§	barn, familie, familie: kvinne, jente, jente, far, jente, kvinne, mennesker, mor
ğŸ—£ï¸	fjes, hode, silhuett, snakke, snakkende hode i profil, snakker
ğŸ‘¤	byste, menneske, silhuett, silhuett av byste
ğŸ‘¥	byste, menneske, silhuett, silhuett av byster
ğŸ‘£	avtrykk, fot, fotavtrykk, fotspor, kropp, spor
ğŸ¦°	rÃ¸dhÃ¥ring, rÃ¸dt hÃ¥r
ğŸ¦±	afrikansk, afro, kruset hÃ¥r, krÃ¸llet
ğŸ¦³	gammel, grÃ¥, grÃ¥tt hÃ¥r, hvit, hÃ¥r
ğŸ¦²	barbert, hÃ¥rlÃ¸s, kjemoterapi, skallet, uten hÃ¥r
ğŸµ	ape, apefjes, dyr, fjes
ğŸ’	ape, dyr
ğŸ¦	dyr, gorilla
ğŸ¦§	ape, orangutang
ğŸ¶	dyr, fjes, hund, hundefjes
ğŸ•ï¸	dyr, hund, valp
ğŸ¦®	blind, fÃ¸rerhund, hund, tilgjengelighet
ğŸ•â€ğŸ¦º	hjelp, hund, servicehund, tilgjengelighet
ğŸ©	dyr, hund, puddel
ğŸº	dyr, fjes, ulv
ğŸ¦Š	dyr, fjes, rev
ğŸ¦	nysgjerrig, sky, vaskebjÃ¸rn
ğŸ±	dyr, fjes, katt, kattefjes
ğŸˆï¸	dyr, katt
ğŸ¦	fjes, lÃ¸ve, lÃ¸ven, stjernebilde, stjernetegn
ğŸ¯	dyr, fjes, tiger, tigerfjes
ğŸ…	dyr, tiger
ğŸ†	dyr, leopard
ğŸ´	dyr, fjes, hest, hestefjes
ğŸ	dyr, galopp, hest, trav
ğŸ¦„	enhjÃ¸rning, fjes
ğŸ¦“	dyr, sebra, striper
ğŸ¦Œ	dyr, hjort
ğŸ®	dyr, fjes, ku, kufjes
ğŸ‚	dyr, okse, stjernebilde, stjernetegn, tyren
ğŸƒ	bÃ¸ffel, dyr, vannbÃ¸ffel
ğŸ„	dyr, ku
ğŸ·	dyr, fjes, gris, grisefjes
ğŸ–	dyr, gris
ğŸ—	dyr, villsvin
ğŸ½	dyr, gris, grisetryne, snute
ğŸ	bukk, dyr, stjernebilde, stjernetegn, vÃ¦ren
ğŸ‘	dyr, sÃ¸ye
ğŸ	dyr, geit, steinbukken, stjernebilde, stjernetegn
ğŸª	dromedar, dyr, kamel, pukkel
ğŸ«	dyr, kamel, pukkel
ğŸ¦™	alpakka, guanaco, lama, ull
ğŸ¦’	dyr, flekker, sjiraff
ğŸ˜	dyr, elefant
ğŸ¦	dyr, horn, nese, neshorn
ğŸ¦›	flodhest
ğŸ­	dyr, fjes, mus, musefjes
ğŸ	dyr, mus
ğŸ€	dyr, rotte
ğŸ¹	dyr, fjes, hamster
ğŸ°	dyr, fjes, kanin, kaninfjes
ğŸ‡	dyr, hare, kanin
ğŸ¿ï¸	dyr, ekorn, jordekorn
ğŸ¦”	dyr, pigger, piggsvin, pinnsvin
ğŸ¦‡	dyr, flaggermus, vampyr
ğŸ»	bjÃ¸rn, dyr, fjes
ğŸ¨	dyr, koala, koalabjÃ¸rn
ğŸ¼	dyr, fjes, panda
ğŸ¦¥	dovendyr, lat, treg
ğŸ¦¦	fisker, lekende, oter
ğŸ¦¨	stank, stinkdyr, stinke
ğŸ¦˜	Australia, hoppe, kenguru, pungdyr
ğŸ¦¡	grevling, skadedyr
ğŸ¾	avtrykk, dyr, poteavtrykk, poter, spor
ğŸ¦ƒ	fugl, kalkun
ğŸ”	dyr, fugl, hÃ¸ne
ğŸ“	dyr, fugl, hane
ğŸ£	dyr, fugl, klekking, kylling, nyklekket kylling
ğŸ¤	baby, dyr, fugl, kylling
ğŸ¥	baby, dyr, fugl, kylling, kylling forfra
ğŸ¦ï¸	dyr, fugl
ğŸ§	dyr, fugl, pingvin
ğŸ•Šï¸	dyr, fly, fred, fredsdue, fugl
ğŸ¦…	dyr, fugl, Ã¸rn
ğŸ¦†	and, dyr, fugl
ğŸ¦¢	den stygge andungen, fugl, svane
ğŸ¦‰	dyr, fugl, ugle, vis
ğŸ¦©	flamingo, prangende, tropisk
ğŸ¦š	fugl, prangende, pÃ¥fugl, stolt
ğŸ¦œ	fugl, papegÃ¸ye, pirat, snakkende, snakker
ğŸ¸	dyr, fjes, frosk
ğŸŠ	dyr, krokodille
ğŸ¢	dyr, skilpadde
ğŸ¦	dyr, firfisle, reptil, Ã¸gle
ğŸ	dyr, orm, slange, slangebÃ¦reren, stjernebilde, stjernetegn
ğŸ²	drage, dragefjes, dyr, eventyr, fjes
ğŸ‰	drage, dyr, eventyr
ğŸ¦•	brachiosaurus, brontosaurus, dinosaur, diplodocus, sauropod
ğŸ¦–	T-Rex, Tyrannosaurus Rex, dinosaur
ğŸ³	dyr, sprutende hval
ğŸ‹	dyr, hval
ğŸ¬	delfin, dyr
ğŸŸï¸	dyr, fisk, fiskene, stjernebilde, stjernetegn
ğŸ 	dyr, fisk, tropisk fisk
ğŸ¡	dyr, fisk, kulefisk
ğŸ¦ˆ	fisk, hai
ğŸ™	blekksprut, blÃ¸tdyr, dyr
ğŸš	dyr, skjell, spiralskjell
ğŸŒ	dyr, snegle
ğŸ¦‹	dyr, insekt, pen, sommer, sommerfugl
ğŸ›	dyr, insekt, kryp, larve, Ã¥me
ğŸœ	dyr, insekt, maur
ğŸ	bie, dyr, honningbie, insekt
ğŸ	bille, dyr, insekt, marihÃ¸ne
ğŸ¦—	dyr, gresshoppe, insekt
ğŸ•·ï¸	dyr, edderkopp, insekt
ğŸ•¸ï¸	edderkopp, nett, spindelvev
ğŸ¦‚	dyr, skorpion, skorpionen, stjernebilde, stjernetegn
ğŸ¦Ÿ	feber, insekt, malaria, mygg, sykdom, virus
ğŸ¦ 	amÃ¸be, bakterie, mikrobe, virus
ğŸ’	blomst, blomster, bukett, romantikk
ğŸŒ¸	blomst, kirsebÃ¦r, kirsebÃ¦rblomst
ğŸ’®	blomst, blomsterstempel, hvit blomst, stempel
ğŸµï¸	plante, rosett
ğŸŒ¹	blomst, rose
ğŸ¥€	blomst, tÃ¸rket, vissen, vissen blomst
ğŸŒº	blomst, hibiskus
ğŸŒ»	blomst, sol, solsikke
ğŸŒ¼	blomst, plante
ğŸŒ·	blomst, tulipan
ğŸŒ±	plante, spire, ung
ğŸŒ²	barnÃ¥ler, bartre, eviggrÃ¸nt tre, gran, juletre, tre
ğŸŒ³	blader, lÃ¸vtre, tre
ğŸŒ´	palme, palmetre, tre
ğŸŒµ	kaktus, plante
ğŸŒ¾	aks, plante, ris, risplante, siv, strÃ¥
ğŸŒ¿	plante, urt, urteblader
â˜˜ï¸	klÃ¸ver, plante, treklÃ¸ver
ğŸ€	4, firklÃ¸ver, flaks, hell, klÃ¸ver, plante
ğŸ	blad, hÃ¸stblad, lÃ¸nn, lÃ¸nneblad
ğŸ‚	blad, fallende, hÃ¸stblad, lÃ¸v
ğŸƒ	blader i vind, blÃ¥se, blÃ¥ser, blÃ¥st, lÃ¸v i vind, vind
ğŸ‡	drueklase, druer, frukt
ğŸˆ	frukt, honningmelon, melon
ğŸ‰	frukt, melon, vannmelon
ğŸŠ	appelsin, frukt, klementin, mandarin
ğŸ‹	frukt, sitron, sitrus
ğŸŒ	banan, frukt
ğŸ	ananas, frukt
ğŸ¥­	frukt, mango, tropisk
ğŸ	eple, frukt, rÃ¸dt eple
ğŸ	eple, frukt, grÃ¸nt eple
ğŸ	frukt, pÃ¦re
ğŸ‘	fersken, frukt
ğŸ’	bÃ¦r, kirsebÃ¦r, moreller
ğŸ“	bÃ¦r, jordbÃ¦r
ğŸ¥	frukt, kiwi, mat
ğŸ…	frukt, grÃ¸nnsak, tomat
ğŸ¥¥	kokosnÃ¸tt, palme, piÃ±a colada
ğŸ¥‘	avokado, frukt, mat
ğŸ†	aubergine, grÃ¸nnsak
ğŸ¥”	grÃ¸nnsak, mat, potet
ğŸ¥•	grÃ¸nnsak, gulrot, mat, rot
ğŸŒ½	mais, maiskolbe
ğŸŒ¶ï¸	chili, plante, rÃ¸d chili, sterk
ğŸ¥’	agurk, grÃ¸nnsak, mat
ğŸ¥¬	bladgrÃ¸nnsaker, bladsalat, grÃ¸nnkÃ¥l, kinakÃ¥l, kÃ¥l, pak choy
ğŸ¥¦	brokkoli, grÃ¸nnsak
ğŸ§„	hvitlÃ¸k, smakstilsetning
ğŸ§…	lÃ¸k, smakstilsetning
ğŸ„	fluesopp, sopp
ğŸ¥œ	grÃ¸nnsak, mat, nÃ¸tt, peanÃ¸tt, peanÃ¸tter
ğŸŒ°	kastanje, kastanjenÃ¸tt, nÃ¸tt
ğŸ	brÃ¸d, loff
ğŸ¥	brÃ¸d, croissant, fransk, mat
ğŸ¥–	bagett, baguette, brÃ¸d, fransk, mat
ğŸ¥¨	saltkringle, saltstenger, snacks
ğŸ¥¯	bagel, bakst, pÃ¥smurt
ğŸ¥	crÃªpe, mat, pannekake, pannekaker
ğŸ§‡	belgisk vaffel, jern, vaffel
ğŸ§€	ost, ostestykke
ğŸ–	kjÃ¸tt med bein, kjÃ¸ttbein, restaurant
ğŸ—	fjÃ¦rfe, fjÃ¦rkre, kyllingklubbe, kyllinglÃ¥r, restaurant
ğŸ¥©	biff, kjÃ¸ttstykke, lammekotelett, lammeskank, svinekotelett
ğŸ¥“	bacon, kjÃ¸tt, mat
ğŸ”	burger, hamburger, restaurant
ğŸŸ	chips, pommes frites, restaurant
ğŸ•	pizza, pizzabit, pizzastykke, restaurant
ğŸŒ­	hot dog, hotdog, pÃ¸lse, pÃ¸lse med brÃ¸d
ğŸ¥ª	brÃ¸d, brÃ¸dskive, sandwich, smÃ¸rbrÃ¸d
ğŸŒ®	meksikansk, taco
ğŸŒ¯	burrito, meksikansk, wrap
ğŸ¥™	falafel, fylt pitabrÃ¸d, gyro, kebab, mat, pita
ğŸ§†	falafel, kikerter, kjÃ¸ttboller
ğŸ¥š	egg, mat
ğŸ³	egg, matlaging, steke, stekepanne
ğŸ¥˜	lav gryte med mat, mat, paella, stekepanne
ğŸ²	gryte, gryterett, middag, middagsmat, panne
ğŸ¥£	bolle med skje, congee, frokost, frokostblanding, grÃ¸t
ğŸ¥—	grÃ¸nn, grÃ¸nn salat, mat, salat
ğŸ¿	kino, popcorn, popkorn
ğŸ§ˆ	meieriprodukt, smÃ¸r
ğŸ§‚	bÃ¸sse, krydder, salt
ğŸ¥«	boks, hermetikk
ğŸ±	bento-boks, bentoboks, matboks
ğŸ˜	kjeks, ris, riskjeks
ğŸ™	japansk, onigiri, restaurant, ris, risball
ğŸš	kokt, kokt ris, restaurant, ris
ğŸ›	curry, karriris, restaurant, ris
ğŸœ	matbolle som damper, nudelbolle, restaurant
ğŸ	pasta, restaurant, spagetti
ğŸ 	bakt sÃ¸tpotet, potet, restaurant, sÃ¸tpotet
ğŸ¢	oden, restaurant, sjÃ¸mat, sjÃ¸mat pÃ¥ pinne, sjÃ¸matspyd
ğŸ£	restaurant, sushi
ğŸ¤	fritert reke, grillet scampi, kongereke, restaurant, scampi, tempura
ğŸ¥	fisk, fiskekake med mÃ¸nster, restaurant
ğŸ¥®	festival, hÃ¸st, mÃ¥nekake, yuebing
ğŸ¡	dango, japansk, restaurant, riskonfekt
ğŸ¥Ÿ	dumpling, empanada, gyoza, jiaozi, pirog
ğŸ¥ 	fortune cookie, lykkekake, spÃ¥dom
ğŸ¥¡	takeaway-boks, takeaway-eske
ğŸ¦€	dyr, krabbe, krepsen, stjernebilde, stjernetegn
ğŸ¦	bisque, hummer, klÃ¸r, sjÃ¸mat, skalldyr
ğŸ¦	dyr, liten, mat, reke
ğŸ¦‘	akkar, blekk, blekksprut, blÃ¸tdyr, dyr, sprut
ğŸ¦ª	dykking, perle, Ã¸sters
ğŸ¦	dessert, is, iskrem, restaurant, soft-is, softis
ğŸ§	dessert, is, restaurant, shave-ice, slush-is
ğŸ¨	dessert, is, iskrem, restaurant
ğŸ©	dessert, donut, restaurant, smultring
ğŸª	cookie, dessert, kjeks, restaurant
ğŸ‚	bursdag, bursdagskake, dessert, feiring, fÃ¸dselsdag, kake
ğŸ°	dessert, formkake, kake, kakestykke
ğŸ§	bakst, cupcake, sÃ¸t
ğŸ¥§	butterdeig, fyll, pai
ğŸ«	sjokoladeplate
ğŸ¬	godteri, karamell, smÃ¥godt, sukkertÃ¸y, sÃ¸tsaker
ğŸ­	kjÃ¦rlighet pÃ¥ pinne, sukkertÃ¸y
ğŸ®	dessert, karamellpudding, pudding
ğŸ¯	honningkrukke, krukke
ğŸ¼	babyflaske, drikke, melk, tÃ¥teflaske
ğŸ¥›	drikke, glass, melk, melkeglass
â˜•ï¸	drikke, kaffe, rykende, te, varm, varm drikke
ğŸµ	drikke, suppe, te, tekopp
ğŸ¶	drikke, flaske, karaffel, mugge og kopp, sake
ğŸ¾	bar, drikke, flaske, flaske med sprettkork, kork, sprette
ğŸ·	drikke, glass, rÃ¸dvin, vin, vinglass
ğŸ¸ï¸	bar, cocktaildrink, cocktailglass, drink
ğŸ¹	bar, drink, juice, tropisk drink
ğŸº	bar, halvliter, pils, pilsner, Ã¸lglass, Ã¸lkrus
ğŸ»	bar, halvliter, pils, pilsner, Ã¸l, Ã¸lglass, Ã¸lkrus, Ã¸lkrus som skÃ¥ler
ğŸ¥‚	drink, feiring, glass, glass som skÃ¥ler, skÃ¥l
ğŸ¥ƒ	brennevin, glass, shot, sprit, whisky, whiskyglass
ğŸ¥¤	brus, juice, jus, kopp med sugerÃ¸r
ğŸ§ƒ	drikkekartong, juicekartong, juskartong
ğŸ§‰	drikke, mate
ğŸ§Š	isbit, isterning, kald
ğŸ¥¢	hashi, spisepinner
ğŸ½ï¸	gaffel, kniv, matlaging, tallerken, tallerken med kniv og gaffel
ğŸ´	gaffel, kniv, kniv og gaffel, matlaging
ğŸ¥„	bestikk, skje
ğŸ”ª	kniv, kokkekniv, matlaging, verktÃ¸y, vÃ¥pen
ğŸº	amfora, drikke, krukke, matlaging, stjernebilde, stjernetegn, vannmannen
ğŸŒ	Afrika, Europa, jorden, jordklode med Europa og Afrika
ğŸŒï¸	Amerika, USA, jorden, jordklode med Amerika
ğŸŒ	Asia, Australia, jorden, jordklode med Asia og Australia
ğŸŒ	jorden, jordklode med meridianer, lengde- og breddegrader
ğŸ—ºï¸	kart, verden, verdenskart
ğŸ—¾	Japan, kart, kart over Japan
ğŸ§­	kompass, magnetisk, navigasjon, orientering
ğŸ”ï¸	fjell, kaldt, snÃ¸, snÃ¸dekt fjell
â›°ï¸	berg, fjell
ğŸŒ‹	utbrudd, vulkan, vulkanutbrudd
ğŸ—»	Fuji-fjellet, fjell, fuji
ğŸ•ï¸	camping, telttur
ğŸ–ï¸	parasoll, strand, strand med parasoll
ğŸœï¸	Ã¸rken
ğŸï¸	Ã¸de, Ã¸de Ã¸y, Ã¸y
ğŸï¸	nasjonalpark, park
ğŸŸï¸	arena, stadion
ğŸ›ï¸	bygning, klassisk, klassisk bygning
ğŸ—ï¸	bygg, byggearbeid, bygging, bygning, bygning under konstruksjon
ğŸ§±	murstein, mÃ¸rtel, sement, vegg
ğŸ˜ï¸	boliger, bygning, hus
ğŸšï¸	bygning, falleferdig, falleferdig hus, forlatt, hus
ğŸ ï¸	bygning, hjem, hus
ğŸ¡	bygning, hjem, hus, hus med hage
ğŸ¢	bygning, kontor, kontorbygg
ğŸ£	bygning, japansk, japansk postkontor, post
ğŸ¤	bygning, europeisk, post, postkontor
ğŸ¥	lege, medisin, sykehus
ğŸ¦	bank, bygning
ğŸ¨	bygning, hotell
ğŸ©	bygning, hotell, kjÃ¦rlighetshotell
ğŸª	butikk, bygning, dagligvare, dagligvarebutikk, storkiosk
ğŸ«	bygning, skole, skolebygning
ğŸ¬	butikk, kjÃ¸pesenter, varehus
ğŸ­ï¸	bygning, fabrikk
ğŸ¯	bygning, japansk, japansk slott, slott
ğŸ°	borg, bygning, europeisk slott, festning, slott
ğŸ’’	bryllup, kapell, romantikk
ğŸ—¼	Tokyo, Tokyo-tÃ¥rnet, tÃ¥rn
ğŸ—½	Frihetsgudinnen, frihet, statue
â›ªï¸	bygning, kirke, kors, kristen, religion
ğŸ•Œ	bygning, islam, moskÃ©, muslim, religion
ğŸ›•	hindu, hindutempel, tempel
ğŸ•	bygning, jÃ¸de, jÃ¸disk, religion, synagoge, tempel
â›©ï¸	Shinto-alter, alter, religion, shinto
ğŸ•‹	Kaba, islam, muslim, religion
â›²ï¸	fontene
â›ºï¸	camping, telt, telttur
ğŸŒ	tÃ¥ke, tÃ¥kete, vÃ¦r
ğŸŒƒ	natt, stjernenatt, stjerner
ğŸ™ï¸	by, bylandskap
ğŸŒ„	fjell, fjellsol, morgen, morgensol, sol, soloppgang over fjell
ğŸŒ…	morgen, morgensol, sol, soloppgang
ğŸŒ†	by, bygning, byhorisont, bylandskap i skumring, skumring, sol, solnedgang
ğŸŒ‡	bygning, skumring, sol, solnedgang, solnedgang over byhorisont
ğŸŒ‰	bro, bro om natten, natt
â™¨ï¸	kilder, rykende, vame kilder, varm, varme kilder
ğŸ 	fornÃ¸yelsespark, hest, karusell, karusellhest, tivoli
ğŸ¡	fornÃ¸yelsespark, pariserhjul, tivoli
ğŸ¢	berg-og-dal-bane, fornÃ¸yelsespark, tivoli
ğŸ’ˆ	barberer, barberersÃ¸yle, barberskilt, frisÃ¸r, frisÃ¸rsalong
ğŸª	sirkus, sirkustelt, telt, underholdning
ğŸš‚	fremkomstmiddel, lokmotiv, lokomotiv, tog
ğŸšƒ	elektrisk, fremkomstmiddel, tog, togvogn, trikk
ğŸš„	fremkomstmiddel, hÃ¸yhastighetstog, lyntog, tog
ğŸš…	fremkomstmiddel, hÃ¸yhastighetstog med kulenese, lyntog, shinkansen, tog
ğŸš†	fremkomstmiddel, jernbane, tog
ğŸš‡ï¸	fremkomstmiddel, metro, t-bane, tunnelbane, undergrunnsbane
ğŸšˆ	fremkomstmiddel, jernbane, lokaltog
ğŸš‰	jernbane, stasjon, tog, togstasjon
ğŸšŠ	fremkomstmiddel, trikk
ğŸš	fremkomstmiddel, monorail
ğŸš	fjellbane, fremkomstmiddel
ğŸš‹	fremkomstmiddel, trikk, trikkevogn, vogn
ğŸšŒ	buss, fremkomstmiddel
ğŸšï¸	fremkomstmiddel, motgÃ¥ende buss
ğŸš	buss, fremkomstmiddel, trolleybuss
ğŸš	buss, kjÃ¸retÃ¸y, minibuss, van
ğŸš‘ï¸	ambulanse, bil, kjÃ¸retÃ¸y
ğŸš’	bil, brannbil, kjÃ¸retÃ¸y
ğŸš“	bil, kjÃ¸retÃ¸y, politibil
ğŸš”ï¸	bil, kjÃ¸retÃ¸y, motgÃ¥ende politibil
ğŸš•	bil, kjÃ¸retÃ¸y, taxi
ğŸš–	bil, kjÃ¸retÃ¸y, motgÃ¥ende taxi
ğŸš—	bil, kjÃ¸retÃ¸y
ğŸš˜ï¸	bil, kjÃ¸retÃ¸y, motgÃ¥ende bil
ğŸš™	SUV, bil, kjÃ¸retÃ¸y
ğŸšš	bil, kjÃ¸retÃ¸y, varebil
ğŸš›	bil, kjÃ¸retÃ¸y, lastebil
ğŸšœ	kjÃ¸retÃ¸y, traktor
ğŸï¸	bil, millÃ¸p, motorsport, racerbil
ğŸï¸	motorsport, motorsykkel, motorsyklist
ğŸ›µ	motor, motorsykkel, scooter
ğŸ¦½	manuell rullestol, tilgjengelighet
ğŸ¦¼	motorisert rullestol, tilgjengelighet
ğŸ›º	autorickshaw, mototaxi, trehjuling, tuk-tuk
ğŸš²ï¸	kjÃ¸retÃ¸y, sykkel
ğŸ›´	spark, sparkesykkel, sykkel
ğŸ›¹	brett, rullebrett, skateboard
ğŸš	buss, busstopp, holdeplass
ğŸ›£ï¸	motorvei, vei
ğŸ›¤ï¸	jernbane, jernbanespor, tog
ğŸ›¢ï¸	fat, olje, oljefat, tÃ¸nne
â›½ï¸	bensin, bensinpumpe, bensinstasjon, diesel, stasjon
ğŸš¨	bil, kjÃ¸retÃ¸y, lys, politi, politilys, roterende, signal
ğŸš¥	horisontale lys, horisontale trafikklys, trafikk
ğŸš¦	trafikk, vertikale lys, vertikale trafiklys
ğŸ›‘	skilt, stopp, stoppskilt, Ã¥ttekantet
ğŸš§	anleggsarbeid, byggeplass, byggeskilt, skilt
âš“ï¸	anker, bÃ¥t, skip, verktÃ¸y
â›µï¸	bÃ¥t, seilbÃ¥t
ğŸ›¶	bÃ¥t, kano
ğŸš¤	bÃ¥t, fartÃ¸y, speedbÃ¥t
ğŸ›³ï¸	bÃ¥t, fremkomstmiddel, passasjer, passasjerskip, skip
â›´ï¸	bÃ¥t, ferge
ğŸ›¥ï¸	bÃ¥t, fremkomstmiddel, motorbÃ¥t
ğŸš¢	bÃ¥t, fartÃ¸y, fremkomstmiddel, skip
âœˆï¸	fly, fremkomstmiddel
ğŸ›©ï¸	fly, fremkomstmiddel, lite fly
ğŸ›«	avgang, avganger, fly, fly som tar av, fremkomstmiddel, innsjekk
ğŸ›¬	ankomme, ankomst, ankomster, fly, fly som lander, fremkomstmiddel, lande, landing
ğŸª‚	fallskjerm, fallskjermhopp, hangglider, hengeglider, paragliding
ğŸ’º	sete, stol
ğŸš	fremkomstmiddel, helikopter
ğŸšŸ	fremkomstmiddel, svevebane
ğŸš 	fremkomstmiddel, kabelbane
ğŸš¡	fremkomstmiddel, gondolbane, taubane
ğŸ›°ï¸	satellitt, verdensrommet
ğŸš€	fremkomstmiddel, rakett, verdensrommet
ğŸ›¸	UFO, flygende tallerken
ğŸ›ï¸	hotell, klokke, pikkolo, resepsjonsklokke
ğŸ§³	bagasje, pakking, reise
âŒ›ï¸	ferdig timeglass, sand, tidtaker
â³ï¸	sand, startet timeglass, tidtaker
âŒšï¸	armbÃ¥ndsur, ur
â°	alarm, klokke, vekkerklokke
â±ï¸	klokke, stoppeklokke
â²ï¸	klokke, tidtaker
ğŸ•°ï¸	klokke, peisur
ğŸ•›ï¸	0:00, 12:00, 24:00, klokka, klokken tolv, tolv
ğŸ•§	0:30, 12:30, klokka, klokken halv ett
ğŸ•ï¸	13:00, 1:00, ett, klokka, klokken ett
ğŸ•œ	13:30, 1:30, klokka, klokken halv to
ğŸ•‘ï¸	14:00, 2:00, klokka, klokken to, to
ğŸ•	14:30, 2:30, klokka, klokken halv tre
ğŸ•’ï¸	15:00, 3:00, klokka, klokken tre
ğŸ•	15:30, 3:30, klokka, klokken halv fire
ğŸ•“ï¸	16:00, 4:00, fire, klokka, klokken fire
ğŸ•Ÿ	16:30, 4:30, klokka, klokken halv fem
ğŸ•”ï¸	17:00, 5:00, fem, klokka, klokken fem
ğŸ• 	17:30, 5:30, klokka, klokken halv seks
ğŸ••ï¸	18:00, 6:00, klokka, klokken seks, seks
ğŸ•¡	18:30, 6:30, halv syv, klokka, klokken halv sju
ğŸ•–ï¸	19:00, 7:00, klokka, klokken sju, syv
ğŸ•¢	19:30, 7:30, klokka, klokken halv Ã¥tte
ğŸ•—ï¸	20:00, 8:00, klokka, klokken Ã¥tte, Ã¥tte
ğŸ•£	20:30, 8:30, klokka, klokken halv ni
ğŸ•˜ï¸	21:00, 9:00, klokka, klokken ni, ni
ğŸ•¤	09:30, 21:30, klokka, klokken halv ti
ğŸ•™ï¸	10:00, 22:00, klokka, klokken ti, ti
ğŸ•¥	10:30, 22:30, klokka, klokken halv elleve
ğŸ•šï¸	11:00, 23:00, elleve, klokka, klokken elleve
ğŸ•¦	11:30, 23:30, klokka, klokken halv tolv
ğŸŒ‘	mÃ¥ne, mÃ¸rk, nymÃ¥ne
ğŸŒ’	mÃ¥nefase, tiltakende mÃ¥ne, voksende nymÃ¥ne
ğŸŒ“	fÃ¸rste kvarter, mÃ¥nefase, voksende halvmÃ¥ne
ğŸŒ”	mÃ¥nefase, tiltakende mÃ¥ne, voksende fullmÃ¥ne
ğŸŒ•ï¸	full, fullmÃ¥ne, hel mÃ¥ne, mÃ¥ne
ğŸŒ–	avtakende fullmÃ¥ne, avtakende mÃ¥ne, mÃ¥nefase
ğŸŒ—	avtakende halvmÃ¥ne, mÃ¥nefase, siste kvarter
ğŸŒ˜	avtakende mÃ¥ne, avtakende nemÃ¥ne, mÃ¥nefase
ğŸŒ™	mÃ¥ne, mÃ¥nesigd
ğŸŒš	ansikt, mÃ¥ne, nymÃ¥ne, nymÃ¥ne med ansikt, nymÃ¥neansikt
ğŸŒ›	kvartmÃ¥ne med ansikt, mÃ¥neansikt, nymÃ¥ne med ansikt
ğŸŒœï¸	kvartmÃ¥ne med ansikt, mÃ¥neansikt, nemÃ¥ne med ansikt
ğŸŒ¡ï¸	temperatur, termometer, vÃ¦r
â˜€ï¸	lys, lyst, sol, solfylt, strÃ¥ler, verdensrommet, vÃ¦r
ğŸŒ	ansikt, fullmÃ¥ne, fullmÃ¥ne med ansikt, fullmÃ¥neansikt, mÃ¥ne, mÃ¥ne med ansikt
ğŸŒ	ansikt, lys, sol, solansikt
ğŸª	planet med ringer, saturn
â­ï¸	hvit mellomstor stjerne, stjerne
ğŸŒŸ	glitrende, lysende stjerne, skinnende, stjerne
ğŸŒ 	fallende stjerne, stjerne, stjerneskudd
ğŸŒŒ	galakse, melkeveien, verdensrommet
â˜ï¸	sky, vÃ¦r
â›…ï¸	sky, sol, sol bak sky, sol og sky
â›ˆï¸	regn, sky, sky med lyn og regn, torden, vÃ¦r
ğŸŒ¤ï¸	sky, sol, sol bak liten sky, vÃ¦r
ğŸŒ¥ï¸	sky, sol, sol bak stor sky, vÃ¦r
ğŸŒ¦ï¸	regn, sky, sol, sol bak sky med regn, vÃ¦r
ğŸŒ§ï¸	regn, sky, sky med regn, vÃ¦r
ğŸŒ¨ï¸	kaldt, sky, sky med snÃ¸, snÃ¸, vÃ¦r
ğŸŒ©ï¸	lyn, sky, sky med lyn, vÃ¦r
ğŸŒªï¸	sky, tornado, vÃ¦r
ğŸŒ«ï¸	sky, tÃ¥ke, vÃ¦r
ğŸŒ¬ï¸	blÃ¥se, fjes, sky, vind, vindansikt, vÃ¦r
ğŸŒ€	svimmel, syklon, tornado
ğŸŒˆ	regn, regnbue, vÃ¦r
ğŸŒ‚	lukket paraply, regn, regnvÃ¦r
â˜‚ï¸	klÃ¦r, paraply, regn, vÃ¦r
â˜”ï¸	drÃ¥pe, klÃ¦r, paraply, paraply med regndrÃ¥per, regn, vÃ¦r
â›±ï¸	paraply, parasoll pÃ¥ bakken, regn, sol, vÃ¦r
âš¡ï¸	fare, hÃ¸y, hÃ¸yspenning, hÃ¸yspent, lyn, spenning
â„ï¸	kaldt, snÃ¸, snÃ¸fnugg, vÃ¦r
â˜ƒï¸	kaldt, snÃ¸, snÃ¸mann, vÃ¦r
â›„ï¸	snÃ¸, snÃ¸mann uten snÃ¸
â˜„ï¸	komet, verdensrommet
ğŸ”¥	flamme, ild
ğŸ’§	drypp, drÃ¥pe, tegneserie, vann
ğŸŒŠ	bÃ¸lge, bÃ¸lgesprut, hav
ğŸƒ	Halloween, gresskar, gresskarlykt, halloweenlykt
ğŸ„	hÃ¸ytid, jul, julefeiring, juletre, tre
ğŸ†	feiring, fyrverkeri, nyttÃ¥r
ğŸ‡	feiring, fyrverkeri, nyttÃ¥r, stjerneskudd pÃ¥ pinne
ğŸ§¨	dynamitt, eksplosiver, fyrverkeri, kinaputt
âœ¨	*, glitrende, skinnende, stjerner
ğŸˆ	ballong, feiring
ğŸ‰	feiring, fest, serpentin, smell-bon-bon
ğŸŠ	feiring, fest, konfettiball, konfettikule
ğŸ‹	feiring, papirremser, stjernefestival, tanabata, tanabatatre, tre
ğŸ	feiring, furudekorasjon, japansk hÃ¸ytid, nyttÃ¥r
ğŸ	festival, japansk hÃ¸ytid, japanske dukker
ğŸ	feiring, japansk hÃ¸ytid, karpe, koinobori, papirfisk
ğŸ	bjelle, drÃ¸mmefanger, feiring, vind, vindspill
ğŸ‘	feiring, hÃ¸ytid, mÃ¥ne, mÃ¥nebeskuelsesseremoni, mÃ¥nefeiring, mÃ¥neseremoni
ğŸ§§	flaks, gave, hell og lykke, hong bao, lai see, penger, rÃ¸d konvolutt
ğŸ€	bÃ¥nd, gavebÃ¥nd, slÃ¸yfe
ğŸ	bursdag, feiring, gave, innpakket gave, julegave
ğŸ—ï¸	bÃ¥nd, feiring, minne, minneslÃ¸yfe, pÃ¥minnelse
ğŸŸï¸	adgang, billett, inngang, inngangsbilletter
ğŸ«	adgang, billett, inngang, underholdning
ğŸ–ï¸	feiring, medalje, militÃ¦ret, militÃ¦rmedalje
ğŸ†ï¸	premie, trofÃ©
ğŸ…	idrettsmedalje, medalje
ğŸ¥‡	fÃ¸rsteplass, gull, gullmedalje, medalje
ğŸ¥ˆ	andreplass, medalje, sÃ¸lv, sÃ¸lvmedalje
ğŸ¥‰	bronse, bronsemedalje, medalje, tredjeplass
âš½ï¸	ball, fotball
âš¾ï¸	ball, baseball, sydd
ğŸ¥	ball, hanske, softball, underarm
ğŸ€	ball, basketball, kurv, sport
ğŸ	ball, kamp, volleyball
ğŸˆ	amerikansk fotball, ball, sport
ğŸ‰	rugby, rugbyball, sport
ğŸ¾	ball, racket, sport, tenninsball, tennis
ğŸ¥	frisbee, ultimate
ğŸ³	bowling, bowlingkule, kule, spill
ğŸ	ball, balltre, cricket, kamp
ğŸ‘	ball, hockey, kamp, kÃ¸lle, land, landhockey
ğŸ’	hockey, is, ishockey, kamp, kÃ¸lle, puck
ğŸ¥	ball, kÃ¸lle, lacrosse, mÃ¥l
ğŸ“	ball, balltre, bord, bordtennis, kamp, racket, tennis
ğŸ¸	badminton, birdie, fjÃ¦rball, kamp, racket
ğŸ¥Š	bokse, boksehanske, boksing, hanske, sport
ğŸ¥‹	drakt, judo, kampkunst, kampsport, kampsportdrakt, karate, selvforsvar, taekwondo
ğŸ¥…	mÃ¥l, mÃ¥lnett, nett, sport
â›³ï¸	golf, golfflagg, golfhull, hull
â›¸ï¸	is, skÃ¸yte, skÃ¸yter
ğŸ£	fisk, fiskestang, fisking, fritid, natur
ğŸ¤¿	dykker, dykkermaske, dykking, froskemann, snorkling
ğŸ½	singlet, sport, t-skjorte, treningstopp, treningstrÃ¸ye
ğŸ¿	ski, ski og staver, snÃ¸, staver, vintersport
ğŸ›·	kjelke, slede
ğŸ¥Œ	curlingstein, sport, stein
ğŸ¯	blink, dart, midt i blinken, mÃ¥l, pilspill, treff
ğŸª€	jojo, leke, opp og ned
ğŸª	fly, papirdrage, sveve
ğŸ±	biljard, spill, Ã¥tterkule
ğŸ”®	krystallkule, spÃ¥dom, spÃ¥dommer
ğŸ§¿	amulett, charm, nazar, ondt Ã¸ye, talisman
ğŸ®ï¸	konsoll, kontroller, spill, spillkonsoll, spillkontroller, videospill
ğŸ•¹ï¸	joystick, spill, styrespak, styrespake, videospill
ğŸ°	spill, spilleautomat
ğŸ²	spill, terning, terningkast, terningspill
ğŸ§©	bit, brikke, del, pekepinn, puslespill, puslespillbrikke
ğŸ§¸	bamse, leke, teddybjÃ¸rn
â™ ï¸	farge, kort, spar, spill
â™¥ï¸	farge, hjerter, kort, spill
â™¦ï¸	diamant, farge, kort, ruter, spill
â™£ï¸	farge, klÃ¸ver, kort, spill
â™Ÿï¸	bonde, brikke, sjakk
ğŸƒ	joker, jokerkort, kort, spillkort
ğŸ€„ï¸	mahjong, mahjongbrikke med rÃ¸d drage, rÃ¸d, spill
ğŸ´	kort, kortspill, spillkort
ğŸ­ï¸	kunst, scenekunst, teater, teatermasker, underholdning
ğŸ–¼ï¸	bilde, innrammet bilde, kunst, maleri, museum, ramme
ğŸ¨	kunst, malerpalett, maling
ğŸ§µ	nÃ¥l, snelle, sy, trÃ¥d, trÃ¥dsnelle
ğŸ§¶	ball, garn, nÃ¸ste
ğŸ‘“ï¸	briller, klÃ¦r, lesebriller
ğŸ•¶ï¸	briller, mÃ¸rkt, solbriller, Ã¸ye
ğŸ¥½	beskyttelsesbriller, sveising, svÃ¸mming, Ã¸yevern
ğŸ¥¼	doktor, eksperiment, forsker, labfrakk, lege
ğŸ¦º	nÃ¸dssituasjon, refleks, refleksvest, sikkerhet, vest
ğŸ‘”	klÃ¦r, slips
ğŸ‘•	klÃ¦r, skjorte, t-skjorte
ğŸ‘–	bukser, jeans, klÃ¦r
ğŸ§£	hals, klÃ¦r, skjerf
ğŸ§¤	hansker, hÃ¥nd, klÃ¦r
ğŸ§¥	frakk, jakke, klÃ¦r, kÃ¥pe
ğŸ§¦	klÃ¦r, labber, sokker, strÃ¸mper
ğŸ‘—	kjole, klÃ¦r
ğŸ‘˜	kimono, kjole, klÃ¦r
ğŸ¥»	kjole, klÃ¦r, sari
ğŸ©±	badedrakt, badetÃ¸y
ğŸ©²	badebukse, badetÃ¸y, bikinitruse, truse, undertÃ¸y
ğŸ©³	badeshorts, badetÃ¸y, bukse, shorts, underbukse, undertÃ¸y
ğŸ‘™	badedrakt, badetÃ¸y, bikini, klÃ¦r
ğŸ‘š	dameklÃ¦r, klÃ¦r
ğŸ‘›	klÃ¦r, portemonÃ©, pung
ğŸ‘œ	hÃ¥ndveske, klÃ¦r, veske
ğŸ‘	clutch-veske, klÃ¦r, liten veske
ğŸ›ï¸	handleposer, hotell, pose, shopping
ğŸ’	ransel, ryggsekk, skolesekk
ğŸ‘	herresko, klÃ¦r, sko
ğŸ‘Ÿ	fritidssko, joggesko, klÃ¦r, sko, tennissko
ğŸ¥¾	fjelltur, gÃ¥tur, stÃ¸vel, telttur, tur, turstÃ¸vel
ğŸ¥¿	flate sko, pumps, uten hÃ¦l
ğŸ‘ 	hÃ¸yhÃ¦lt sko, klÃ¦r, sko
ğŸ‘¡	dame, damesandal, klÃ¦r, sandal, sko
ğŸ©°	ballett, ballettsko, dans
ğŸ‘¢	dame, damestÃ¸vlett, klÃ¦r, sko, stÃ¸vlett
ğŸ‘‘	dronning, klÃ¦r, konge, krone
ğŸ‘’	damehatt, hatt, klÃ¦r
ğŸ©	flosshatt, hatt, klÃ¦r
ğŸ“ï¸	feiring, hatt, klÃ¦r, studentlue, uteksaminering
ğŸ§¢	caps, kaps, skyggelue
â›‘ï¸	fjes, hatt, hjelm, hjelm med hvitt kors, hjelp, kors
ğŸ“¿	bÃ¸nn, bÃ¸nnekrans, halssmykke, klÃ¦r, perler, religion
ğŸ’„	kosmetikk, leppestift, sminke
ğŸ’	diamant, ring, romantikk
ğŸ’	diamant, edelsten, romantikk, smykkestein
ğŸ”‡	dempet, dempet hÃ¸yttaler, hÃ¸yttaler med strek over, ingen prating, stille
ğŸ”ˆï¸	hÃ¸yttaler med lavt volum, lav, lyd, ropert
ğŸ”‰	hÃ¸yttaler med middels volum, lyd, middels, ropert
ğŸ”Š	hÃ¸y, hÃ¸yttaler med hÃ¸yt volum, lyd, ropert
ğŸ“¢	hÃ¸y, hÃ¸yttaler, kommunikasjon, megafon, ropert
ğŸ“£	heiing, kommunikasjon, megafon
ğŸ“¯	horn, post, posthorn
ğŸ””	bjelle, klokke, ringing
ğŸ”•	bjelle med strek over, ingen lyd, klokke, lydlÃ¸s, overstreket bjelle, stille
ğŸ¼	g-nÃ¸kkel, musikk, notetegn
ğŸµ	musikk, musikknote, note
ğŸ¶	musikk, musikknoter, noter
ğŸ™ï¸	mikrofon, musikk, studio, studiomikrofon
ğŸšï¸	glidebryter, musikk, nivÃ¥, skyveknapp
ğŸ›ï¸	knott, kontroll, kontrollbrytere, musikk
ğŸ¤	karaoke, mik, mikrofon, musikk, underholdning
ğŸ§ï¸	headset, hodetelefoner, underholdning, Ã¸retelefoner
ğŸ“»ï¸	radio, radiosignaler, teknologi
ğŸ·	instrument, musikk, musikkinstrument, saksofon, sax
ğŸ¸	gitar, instrument, musikk, musikkinstrument
ğŸ¹	instrument, keyboard, musikk, musikkinstrument, piano, tangenter
ğŸº	instrument, musikk, musikkinstrument, trompet
ğŸ»	fele, fiolin, instrument, musikk, musikkinstrument
ğŸª•	banjo, musikk, strenginstrument
ğŸ¥	musikk, tromme, trommestikker
ğŸ“±	mobil, mobiltelefon, telefon
ğŸ“²	mobiltelefon, mobiltelefon med pil, ring, telefon
â˜ï¸	fasttelefon, ringe, telefon
ğŸ“	kommunikasjon, telefon, telefonrÃ¸r
ğŸ“Ÿï¸	kommunikasjon, personsÃ¸ker, telefon
ğŸ“ 	faksmaskin, kommunikasjon, telefon
ğŸ”‹	batteri, energilagring, strÃ¸m
ğŸ”Œ	elektrisitet, elektrisk, plugg, stÃ¸psel
ğŸ’»ï¸	PC, bÃ¦rbar datamaskin, datamaskin, maskin
ğŸ–¥ï¸	PC, datamaskin, stasjonÃ¦r, stasjonÃ¦r datamaskin
ğŸ–¨ï¸	datamaskin, printer, skriver
âŒ¨ï¸	datamaskin, tastatur
ğŸ–±ï¸	datamaskin, datamus, knapp, mus
ğŸ–²ï¸	datamaskin, styrekule
ğŸ’½	MD, datadisk, disk, lagring, minidisk
ğŸ’¾	datamaskin, disk, diskett, lagring
ğŸ’¿ï¸	CD, DVD, blu-ray, disk, lagring, optisk plate
ğŸ“€	DVD, DVD-plate, disk, lagring, optisk, plate
ğŸ§®	abakus, kuleramme, regning
ğŸ¥	film, filmkamera, kamera, kino, underholdning
ğŸï¸	film, filmruter, kino, ruter
ğŸ“½ï¸	film, filmframviser, kino, projektor, video
ğŸ¬ï¸	action, film, filming, filmklapper, klapper, underholdning
ğŸ“ºï¸	TV, fjernsyn, video
ğŸ“·ï¸	foto, kamera, kamerateknikk, video
ğŸ“¸	blits, foto, kamera, kamera med blits, video
ğŸ“¹ï¸	kamera, video, videokamera
ğŸ“¼	kassett, opptak, vhs, video, videokassett
ğŸ”	forstÃ¸rrelse, forstÃ¸rrelsesglass mot venstre, glass, lupe, sÃ¸k
ğŸ”	forstÃ¸rrelse, forstÃ¸rrelsesglass mot hÃ¸yre, glass, lupe, sÃ¸k
ğŸ•¯ï¸	lys, stearinlys
ğŸ’¡	elektrisitet, idÃ©, lys, lyspÃ¦re, pÃ¦re, tegneserie
ğŸ”¦	elektrisk, lommelykt, lykt, lys
ğŸ®	bar, izakaya, lampe, lanterne, lykt, rÃ¸d, rÃ¸d papirlykt
ğŸª”	diya, lampe, olje, Ã¥pen oljelampe
ğŸ“”	dekorert notatbok, notatbok, omslag
ğŸ“•	bok, lukket bok
ğŸ“–	bok, Ã¥pen bok
ğŸ“—	bok, grÃ¸nn bok
ğŸ“˜	blÃ¥ bok, bok
ğŸ“™	bok, oransje bok
ğŸ“šï¸	bok, bÃ¸ker
ğŸ““	kladdebok, kontorrekvisita, notatbok
ğŸ“’	kontorrekvisita, notatbok, spiralblokk
ğŸ“ƒ	ark, opprullet, side, side med bÃ¸y
ğŸ“œ	papir, papirrull, papyrus, pergament, pergamentrull, rull
ğŸ“„	ark, papir, side, side som vender opp
ğŸ“°	avis, nyheter, publikasjon
ğŸ—	avis, nyheter, opprullet, papir, sammenrullet avis
ğŸ“‘	bokmerke, bokmerkefane, faner, markÃ¸r
ğŸ”–	bokmerke, merke
ğŸ·ï¸	etikett, merke
ğŸ’°ï¸	penger, pengesekk, sekk
ğŸ’´	penger, seddel, yen, yenseddel
ğŸ’µ	dollar, dollarseddel, penger, seddel
ğŸ’¶	euro, euroseddel, penger, seddel
ğŸ’·	penger, pund, pundseddel, seddel
ğŸ’¸	bank, flygende seddel, penger, penger med vinger, seddel
ğŸ’³ï¸	bankkort, betalingskort, kort, kreditt, kredittkort, visa
ğŸ§¾	arkiv, bilag, dokumentasjon, kvittering, regnskap
ğŸ’¹	graf, marked, oppover, penger, stigende diagram med yen, stigende graf, trend, yen
ğŸ’±	penger, valuta, valutaveksling, veksling
ğŸ’²	dollar, dollartegn, penger, stort dollartegn
âœ‰ï¸	brev, e-post, konvolutt
ğŸ“§	brev, e-post, kommunikasjon, post
ğŸ“¨	brev, e-post, epost, innkommende, innkommende konvolutt, konvolutt, motta
ğŸ“©	brev, e-post, epost, konvolutt, konvolutt med pil, sende, sendt, utgÃ¥ende
ğŸ“¤ï¸	brev, e-post, kommunikasjon, sendt, skuff, utboks
ğŸ“¥ï¸	brev, e-post, innboks, kommunikasjon, mottatt, skuff
ğŸ“¦ï¸	eske, levering, pakke
ğŸ“«ï¸	flagg, lukket postkasse med flagget oppe, post
ğŸ“ªï¸	flagg, lukket postkasse med flagget nede, post
ğŸ“¬ï¸	flagg, post, Ã¥pen postkasse med flagget oppe
ğŸ“­ï¸	flagg, post, Ã¥pen postkasse med flagget nede
ğŸ“®	post, postkasse
ğŸ—³ï¸	boks, stemmeseddel, urne med stemmeseddel
âœï¸	blyant
âœ’ï¸	penn, pennespiss, svart pennesplitt
ğŸ–‹ï¸	fyllepenn, penn
ğŸ–Šï¸	kulepenn, penn
ğŸ–Œï¸	maling, pensel
ğŸ–ï¸	fargestift, tegning
ğŸ“	blyant, bok, kommunikasjon, notat
ğŸ’¼	dokumentmappe, stresskoffert
ğŸ“	arkiv, arkivmappe, fil, mappe
ğŸ“‚	fil, mappe, Ã¥pen, Ã¥pen arkivmappe, Ã¥pen filmappe
ğŸ—‚ï¸	indeks, kort, skillekort, skillere
ğŸ“…	dato, kalender
ğŸ“†	kalender, riv-av-kalender, veggkalender
ğŸ—’ï¸	blokk, notat, spiral, spiralhefte
ğŸ—“ï¸	blokk, kalender, spiral, spiralkalender
ğŸ“‡	indeks, kartotek, register
ğŸ“ˆ	chart, diagram som peker oppover, graf, opp, positiv, stigende
ğŸ“‰	diagram som peker nedover, fallende, graf, ned, negativ, synkende
ğŸ“Š	diagram, histogram, stolpediagram, sÃ¸ylediagram
ğŸ“‹ï¸	ordrebrett, skriveplate, tavle, utklippstavle
ğŸ“Œ	kontorrekvisita, stift
ğŸ“	kontorrekvisita, markÃ¸rnÃ¥l, rund stift
ğŸ“	binders, kontorrekvisita
ğŸ–‡ï¸	binders, kjede, sammenlenkede binders
ğŸ“	linjal, rett
ğŸ“	linjal, trekant, trekantlinjal
âœ‚ï¸	saks, verktÃ¸y
ğŸ—ƒï¸	arkiv, boks, fil, kartotekboks, kort
ğŸ—„ï¸	arkivskap, fil, kabinett, mapper
ğŸ—‘ï¸	papirkurv, sÃ¸ppelkasse, sÃ¸ppelkurv
ğŸ”’ï¸	lÃ¥st
ğŸ”“ï¸	hengelÃ¥s, lÃ¥s, ulÃ¥st, Ã¥pen
ğŸ”	lÃ¥st med penn, penn, personvern
ğŸ”	lÃ¥s med nÃ¸kkel, lÃ¥st med nÃ¸kkel, sikker
ğŸ”‘	lÃ¥s, nÃ¸kkel, passord
ğŸ—ï¸	gammel, gammeldags nÃ¸kkel, ledetrÃ¥d, lÃ¥s, nÃ¸kkel
ğŸ”¨	hammer, verktÃ¸y
ğŸª“	dele, hogge, hugge, klÃ¸yve, ved, Ã¸ks
â›ï¸	gruvedrift, hakke, verktÃ¸y
âš’ï¸	hakke, hammer, hammer og hakke, verktÃ¸y
ğŸ› ï¸	hammer, hammer og fastnÃ¸kkel, skiftenÃ¸kkel, verktÃ¸y
ğŸ—¡ï¸	dolk, kniv, vÃ¥pen
âš”ï¸	kryss, sverd, sverd i kryss, vÃ¥pen
ğŸ”«	pistol, revolver, vÃ¥pen
ğŸ¹	bue, bueskytter, pil, pil og bue, skytten, stjernebilde, stjernetegn, vÃ¥pen
ğŸ›¡ï¸	skjold, vÃ¥pen
ğŸ”§	fastnÃ¸kkel, skrunÃ¸kkel, verktÃ¸y
ğŸ”©	mutter, mutter og skrue, skrue, verktÃ¸y
âš™ï¸	tannhjul, verktÃ¸y
ğŸ—œï¸	klemme, skruetvinge, skrustikke, skrutvinge, verktÃ¸y
âš–ï¸	balanse, likearmet skÃ¥lvekt, rettferdighet, stjernetegn, vekt, vekten, verktÃ¸y
ğŸ¦¯	blind, blindestokk, tilgjengelighet
ğŸ”—	lenke, link, to ringer
â›“ï¸	kjede, kjetting
ğŸ§°	kasse, skrin, verktÃ¸y, verktÃ¸ykasse
ğŸ§²	hestesko, magnet, magnetisk, tiltrekning
âš—ï¸	destillasjonskolbe, destillerkolbe, kjemi, verktÃ¸y
ğŸ§ª	eksperiment, forskning, kjemi, kjemiker, lab, prÃ¸verÃ¸r, reagensrÃ¸r
ğŸ§«	bakterie, biolog, biologi, kultur, lab, petriskÃ¥l
ğŸ§¬	biolog, dna, evolusjon, gen, gener, genetikk, liv
ğŸ”¬	mikroskop, verktÃ¸y, vitenskap
ğŸ”­	astronomi, teleskop, verktÃ¸y, vitenskap
ğŸ“¡	antenne, kommunikasjon, parabol, parabolantenne, satellitt, satellittantenne
ğŸ’‰	lege, medisin, nÃ¥l, sprÃ¸yte, vaksine
ğŸ©¸	bloddrÃ¥pe, blodgiver, medisin, mens, menstruasjon
ğŸ’Š	lege, medisin, pille, tablett
ğŸ©¹	behandling, plaster, sÃ¥r
ğŸ©º	hjerte, lege, medisin, stetoskop
ğŸšª	dÃ¸r
ğŸ›ï¸	hotell, seng, sove
ğŸ›‹ï¸	hotell, lampe, sofa, sofa og lampe
ğŸª‘	sete, sitte, sitteplass, stol
ğŸš½	dass, do, toalett, vannklosett, wc
ğŸš¿	dusj, vann
ğŸ›	bad, badekar, badestamp
ğŸª’	barbere, barbering, barberkniv, skarp
ğŸ§´	fuktighetskrem, lotion, lotionflaske, shampoo, sjampo, solkrem
ğŸ§·	bleie, punk, sikkerhetsnÃ¥l
ğŸ§¹	feie, feiekost, heks, rengjÃ¸re
ğŸ§º	jordbruk, klesvask, kurv, piknik
ğŸ§»	rull med papir, toalettpapir, tÃ¸rkepapir, tÃ¸rkerull
ğŸ§¼	bad, skum, sÃ¥pe, sÃ¥peskÃ¥l, sÃ¥pestykke, vaske
ğŸ§½	absorberende, porÃ¸s, rengjÃ¸re, svamp, vaske
ğŸ§¯	brann, brannslokkingsapparat, brannslukningsapparat, slokke, slukke
ğŸ›’	handle, handlevogn, innkjÃ¸p, tralle, vogn
ğŸš¬	rÃ¸yking, rÃ¸yking tillatt, sigarett, skilt
âš°ï¸	begravelse, dÃ¸d, kiste
âš±ï¸	begravelse, dÃ¸d, kremasjon, urne
ğŸ—¿	moai, moai-statue, statue
ğŸ§	automatisk, bank, minibank, minibankskilt, penger
ğŸš®	avfall, avfallsskilt, skilt, sÃ¸ppel
ğŸš°	drikke, drikkevann, vann
â™¿ï¸	handikaptilgang, rullestol, rullestolbruker, rullestolsymbol
ğŸš¹ï¸	do, herrer, herretoalett, mannesymbol, toalett, wc
ğŸšºï¸	damer, dametoalett, do, kvinnesymbol, toalett, wc
ğŸš»	WC, do, toalett, toalettskilt
ğŸš¼ï¸	babyskilt, babysymbol, stellestasjon
ğŸš¾	WC, do, toalett
ğŸ›‚	kontroll, pass, passkontroll
ğŸ›ƒ	grense, toll
ğŸ›„	bagasje, bagasjebÃ¥nd, rullebÃ¥nd
ğŸ›…	bagasje, bagasjeoppbevaring, oppbevaring, oppbevaringsboks
âš ï¸	OBS, advarsel
ğŸš¸	barn, barn krysser veien, krysser, skilt
â›”ï¸	adgang forbudt, enveiskjÃ¸ring, ingen adgang, skilt, stopp
ğŸš«	adgang forbudt, forbudt, ikke, nei, skilt
ğŸš³	ingen sykler, kjÃ¸retÃ¸y, sykkel, sykkel ikke tillatt, sykler forbudt
ğŸš­ï¸	ingen rÃ¸yking, rÃ¸yking forbudt, skilt
ğŸš¯	forsÃ¸pling ikke tillatt, ikke avfall, ingen kasting, skilt
ğŸš±	ikke drikkbart, ikke drikkevann, vann
ğŸš·	fotgjenger, fotgjengere forbudt, fotgjengere ikke tillatt, gÃ¥ende, ingen fotgjengere, skilt
ğŸ“µ	ingen telefonsamtaler, mobil ikke tillatt, mobiltelefon ikke tillatt, telefon
ğŸ”	18, aldersgrense 18 Ã¥r, attenÃ¥rsgrense, ingen under 18, under 18
â˜¢ï¸	radioaktiv, radioaktivitet, radioaktivt
â˜£ï¸	advarsel, biologisk fare, farlig biologisk materiale, skilt
â¬†ï¸	nord, oppoverpil, pil, pil opp, retning
â†—ï¸	nordÃ¸st, pil, pil opp-hÃ¸yre, retning
â¡ï¸	hÃ¸yrepil, pil, pil hÃ¸yre, retning, Ã¸st
â†˜ï¸	pil, pil ned-hÃ¸yre, retning, sÃ¸rÃ¸st
â¬‡ï¸	nedoverpil, pil, pil ned, retning, sÃ¸r
â†™ï¸	pil, pil ned-venstre, retning, sÃ¸rvest
â¬…ï¸	pil, pil venstre, retning, venstrepil, vest
â†–ï¸	nordvest, pil, pil opp-venstre, retning
â†•ï¸	pil, pil opp og ned
â†”ï¸	pil, pil venstre-hÃ¸yre
â†©ï¸	pil, pil som bÃ¸yer mot venstre
â†ªï¸	pil, pil som bÃ¸yer mot hÃ¸yre
â¤´ï¸	pil, pil som bÃ¸yer opp
â¤µï¸	ned, pil, pil som bÃ¸yer ned
ğŸ”ƒ	last inn pÃ¥ nytt, piler, vertikale piler med klokken
ğŸ”„	mot klokken, piler, piler mot klokken
ğŸ”™	BACK-pil, pil, pil til venstre, tilbake, tilbakepil
ğŸ”š	END-pil, pil, pil til venstre, slutt, slutt med pil, sluttpil
ğŸ”›	ON, ON!-pil, PÃ…, pil, utrop, utropstegn
ğŸ”œ	SOON-pil, pil, snart, snart med pil
ğŸ”	TOP, TOP-pil, opp, pil opp, topp, topp med pil
ğŸ›	religion, religiÃ¸st samlingssted, tilbedelse
âš›ï¸	ateist, atom, atomsymbol
ğŸ•‰ï¸	hindu, om, religion
âœ¡ï¸	Davidstjerne, david, jÃ¸de, jÃ¸disk, religion, stjerne
â˜¸ï¸	buddhist, dharma, dharmas hjul, hjul, religion
â˜¯ï¸	religion, tao, taoist, yang, yin, yin yang
âœï¸	kors, kristen, latinsk kors, religion
â˜¦ï¸	kors, kristen, ortodoks, ortodokst kors, religion
â˜ªï¸	islam, muslim, religion, stjerne og halvmÃ¥ne
â˜®ï¸	fred, fredssymbol
ğŸ•	lysestake, menora, religion
ğŸ”¯	magi, sekskantet, sekstagget stjerne med prikk, stjerne
â™ˆï¸	VÃ¦ren, stjernetegn
â™‰ï¸	Tyren, stjernetegn
â™Šï¸	Tvillingene, stjernetegn
â™‹ï¸	Krepsen, stjernetegn
â™Œï¸	LÃ¸ven, stjernetegn
â™ï¸	Jomfruen, stjernetegn
â™ï¸	Vekten, stjernetegn
â™ï¸	Skorpionen, stjernetegn
â™ï¸	Skytten, stjernetegn
â™‘ï¸	Steinbukken, stjernetegn
â™’ï¸	Vannmannen, stjernetegn
â™“ï¸	Fiskene, stjernetegn
â›	SlangebÃ¦reren, stjernetegn
ğŸ”€	bland spor-symbol, kryssede piler mot hÃ¸yre, piler
ğŸ”	gjenta-knapp, med klokken, piler
ğŸ”‚	1 gang, gjenta ett spor-knapp, med klokken, piler, Ã©n gang
â–¶	avspillingsknapp, hÃ¸yre, pil, trekant
â©	dobbel pil, hÃ¸yre, spol framover-knapp, spoling
â­	neste scene, neste spor, neste spor-knapp, pil, trekant
â¯	hÃ¸yre, pause, pil, spill av, spill av/pause-knapp, trekant
â—€	bakover-knapp, pil, tilbake, trekant, venstre
âª	dobbel pil, spol tilbake-knapp, spoling, venstre
â®	forrige scene, forrige spor-knapp, pil, trekant
ğŸ”¼	oppover, oppover-knapp, pil
â«	dobbel, opp, pil, raskt opp-knapp
ğŸ”½	ned, nedover, nedover-knapp
â¬	dobbelt pil ned, ned, pil, raskt ned-knapp
â¸ï¸	dobbel, pause-knapp, strek, vertikal
â¹ï¸	firkant, stopp, stopp-knapp
âºï¸	innspilling, sirkel, spill inn-knapp, ta opp
âï¸	eject, knapp, lÃ¸se ut, mat ut-knapp, mate ut
ğŸ¦	film, filmkamera, kamera, kino, underholdning
ğŸ”…	lav, lite lys-knapp, lysstyrke
ğŸ”†	hÃ¸y, lysstyrke, mye lys-knapp
ğŸ“¶	antenne, mobil, mobilsignaler, signal, signalstyrke, telefon
ğŸ“³	mobil, mobiltelefon, modus, vibrasjon, vibrering, vibreringsmodus
ğŸ“´	av, mobil, mobiltelefon av
â™€ï¸	kvinne, kvinnesymbol
â™‚ï¸	mann, mannssymbol
âš•ï¸	asklepiosstav, lege, legesymbol, medisin
â™¾ï¸	for alltid, grenselÃ¸s, uendelig, universal
â™»ï¸	resirkulering, resirkuleringssymbol, symbol, universelt
âšœ	fleur-de-lis, fransk lilje
ğŸ”±	anker, emblem, treenighet, treforkemblem, tridentsymbol
ğŸ“›	navn, navneskilt, skilt
ğŸ”°	grÃ¸nn og gul, grÃ¸nt og gult blad, japansk, japansk tegn for nybegynner, nybegynner
â­•ï¸	o, rÃ¸d, sirkel, stor, tykk rÃ¸d sirkel
âœ…	avkryssing, avmerking, hake, hakemerke i firkant, âœ“
â˜‘ï¸	avkrysset boks, boks, boks med hakemerke, hakemerke, âœ“
âœ”ï¸	hake, hakemerke, merke, âœ“
âœ–ï¸	avbryt, gangetegn, multiplikasjon, multiplisere, x, Ã—
âŒ	X, kryss, rÃ¸dt kryss, x, Ã—
â	kryss, kryss i firkant, kvadrat, x, Ã—
â•	+, fortegn, matte, pluss, plusstegn
â–	-, fortegn, matte, minus, minustegn, âˆ’
â—	dele, deletegn, deling, divisjon, divisjonstegn, Ã·
â°	lÃ¸kke, lÃ¸kketegn
â¿	dobbel lÃ¸kke, dobbel lÃ¸kke-tegn
ã€½ï¸	merke, merke for nytt parti, nytt, parti
âœ³ï¸	*, asterisk, asterisk med Ã¥tte spisser, stjerne
âœ´ï¸	*, stjerne, Ã¥ttetagget stjerne
â‡ï¸	*, gnist
â€¼ï¸	!, !!, bangbang, dobbelt utropstegn, tegn, tegnsetting, utropstegn
â‰ï¸	!, !?, ?, spÃ¸rrende, spÃ¸rsmÃ¥l, spÃ¸rsmÃ¥lstegn, tegn, tegnsetting, utrop, utropstegn, utropstegn og spÃ¸rsmÃ¥lstegn
â“ï¸	?, spÃ¸rsmÃ¥l, spÃ¸rsmÃ¥lstegn
â”	?, hvitt spÃ¸rsmÃ¥lstegn, spÃ¸rsmÃ¥l
â•	!, hvitt utropstegn, utrop
â—ï¸	!, tegn, tegnsetting, utrop, utropstegn
ã€°ï¸	bÃ¸lge, bÃ¸lgestrek, bÃ¸lget bindestrek, tegn for lang lyd
Â©ï¸	copyright, opphavsrett
Â®ï¸	r, registrert varemerke, varemerkesymbol
â„¢ï¸	tm, trademark, varemerke
#âƒ£	taster, taster: #
*âƒ£	taster, taster: *
0âƒ£	taster, taster: 0
1âƒ£	taster, taster: 1
2âƒ£	taster, taster: 2
3âƒ£	taster, taster: 3
4âƒ£	taster, taster: 4
5âƒ£	taster, taster: 5
6âƒ£	taster, taster: 6
7âƒ£	taster, taster: 7
8âƒ£	taster, taster: 8
9âƒ£	taster, taster: 9
ğŸ”Ÿ	taster, taster: 10
ğŸ” 	ABCD, bokstaver, inndata, store bokstaver
ğŸ”¡	abcd, bokstaver, inndata, smÃ¥ bokstaver
ğŸ”¢	1234, inndata, numeriske data, tall
ğŸ”£	inndata, symboler
ğŸ”¤	ABC, inndata, latinsk alfabet
ğŸ…°ï¸	A, A-knapp (blodtype), blod, blodtype, type A
ğŸ†	AB, AB-knapp (blodtype), blod, blodtype, type AB
ğŸ…±ï¸	B, B-knapp (blodtype), blod, blodtype, type B
ğŸ†‘	CL-knapp, clear, slett, tÃ¸m
ğŸ†’	COOL-knapp, cool
ğŸ†“	FREE-knapp, free, free-symbol, gratis
â„¹ï¸	i, info, informasjon
ğŸ†”	ID-knapp, ID-symbol, identitet
â“‚ï¸	M med ring rundt, m, sirkel
ğŸ†•	NEW-knapp, new, new-symbol, ny, nyhet
ğŸ†–	NG, NG-knapp, NG-symbol, ikke bra, no good
ğŸ…¾ï¸	O, O-knapp (blodtype), blod, blodtype, type O
ğŸ†—	OK-knapp, OK-symbol
ğŸ…¿ï¸	P-knapp, parkering, parkeringsplass
ğŸ†˜	SOS-knapp, SOS-symbol, hjelp, hjelp-symbol
ğŸ†™	UP!-knapp, UP!-symbol, opp, opp-symbol
ğŸ†š	VS-knapp, versus, vs-symbol
ğŸˆ	her, japansk, katakana, Â«herÂ» pÃ¥ japansk, Â«kokoÂ», ã‚³ã‚³
ğŸˆ‚ï¸	gebyr, japansk, katakana, Â«gebyrÂ» pÃ¥ japansk, Â«saÂ», ã‚µ
ğŸˆ·	ideograf, japansk, mÃ¥nedlig belÃ¸p, Â«mÃ¥nedlig belÃ¸pÂ» pÃ¥ japansk, æœˆ
ğŸˆ¶	ideograf, ikke gratis, japansk, Â«ikke gratisÂ» pÃ¥ japansk, æœ‰
ğŸˆ¯	ideograf, japansk, reservert, Â«reservertÂ» pÃ¥ japansk, æŒ‡
ğŸ‰	ideograf, japansk, spesialtilbud, Â«spesialtilbudÂ» pÃ¥ japansk, å¾—
ğŸˆ¹	ideograf, japansk, rabatt, Â«rabattÂ» pÃ¥ japansk, å‰²
ğŸˆš	gratis, ideograf, japansk, Â«gratisÂ» pÃ¥ japansk, ç„¡
ğŸˆ²	forbudt, ideograf, japansk, Â«forbudtÂ» pÃ¥ japansk, ç¦
ğŸ‰‘	akseptabelt, ideograf, japansk, Â«akseptabeltÂ» pÃ¥ japansk, å¯
ğŸˆ¸	ideograf, japansk, sÃ¸knad, Â«sÃ¸knadÂ» pÃ¥ japansk, ç”³
ğŸˆ´	bestÃ¥tt, ideograf, japansk, Â«bestÃ¥ttÂ» pÃ¥ japansk, åˆ
ğŸˆ³	ideograf, japansk, ledig, Â«ledigÂ» pÃ¥ japansk, ç©º
ãŠ—ï¸	gratulerer, ideograf, japansk, Â«gratulererÂ» pÃ¥ japansk, ç¥
ãŠ™ï¸	hemmelig, ideograf, japansk, Â«hemmeligÂ» pÃ¥ japansk, ç§˜
ğŸˆº	ideograf, japansk, Â«Ã¥pen for handelÂ» pÃ¥ japansk, Ã¥pen for handel, å–¶
ğŸˆµ	fullt, ideograf, japansk, Â«fulltÂ» pÃ¥ japansk, æº€
ğŸ”´	geometrisk, rÃ¸d, rÃ¸d sirkel, sirkel
ğŸŸ 	oransje, oransje sirkel, sirkel
ğŸŸ¡	gul, gul sirkel, sirkel
ğŸŸ¢	grÃ¸nn, grÃ¸nn sirkel, sirkel
ğŸ”µ	blÃ¥, blÃ¥ sirkel, geometrisk, sirkel
ğŸŸ£	lilla, lilla sirkel, sirkel
ğŸŸ¤	brun, brun sirkel, sirkel
âš«ï¸	geometrisk, sirkel, svart sirkel
âšªï¸	geometrisk, hvit sirkel, sirkel
ğŸŸ¥	kvadrat, rÃ¸d, rÃ¸dt, rÃ¸dt kvadrat
ğŸŸ§	kvadrat, oransje, oransje kvadrat
ğŸŸ¨	gul, gult, gult kvadrat, kvadrat
ğŸŸ©	grÃ¸nn, grÃ¸nt, grÃ¸nt kvadrat, kvadrat
ğŸŸ¦	blÃ¥, blÃ¥tt, blÃ¥tt kvadrat, kvadrat
ğŸŸª	kvadrat, lilla, lilla kvadrat
ğŸŸ«	brun, brunt, brunt kvadrat, kvadrat
â¬›ï¸	firkant, geometrisk, kvadrat, stor svart firkant
â¬œï¸	firkant, geometrisk, kvadrat, stor hvit firkant
â—¼ï¸	firkant, geometrisk, kvadrat, mellomstor svart firkant
â—»ï¸	firkant, geometrisk, kvadrat, mellomstor hvit firkant
â—¾ï¸	firkant, geometrisk, kvadrat, liten/mellomstor svart firkant
â—½ï¸	firkant, geometrisk, kvadrat, liten/mellomstor hvit firkant
â–ªï¸	firkant, geometrisk, kvadrat, liten svart firkant
â–«ï¸	firkant, geometrisk, kvadratt, liten hvit firkant
ğŸ”¶	geometrisk, oransje, ruter, stort oransje rutersymbol
ğŸ”·	blÃ¥, geometrisk, ruter, stort blÃ¥tt rutersymbol
ğŸ”¸	geometrisk, lite oransje rutersymbol, oransje, ruter
ğŸ”¹	blÃ¥, geometrisk, lite blÃ¥tt rutersymbol, ruter
ğŸ”º	geometrisk, oppover, rÃ¸d trekant som peker opp, trekant
ğŸ”»	geometrisk, nedover, rÃ¸d trekant som peker ned, trekant
ğŸ’ 	blomst, diamant, diamant med prikk, sÃ¸tt
ğŸ”˜	knapp, radio, radioknapp
ğŸ”³	firkant, hvit firkantet knapp, knapp
ğŸ”²	firkant, knapp, svart firkantet knapp
ğŸ	formel 1, motorsport, mÃ¥l, racingflagg, rutete flagg
ğŸš©	golf, posisjon, trekantet, vimpel
ğŸŒ	feiring, flagg, kryssede flagg, kryssede japanske flagg, krysset
ğŸ´	flagg, flagring, svart, svart flagg
ğŸ³ï¸	flagg, flagring, hvitt, hvitt flagg
ğŸ³â€ğŸŒˆ	flagg, regnbue, regnbueflagg
ğŸ´â€â˜ 	Kaptein Sabeltann, pirat, plyndre, sjÃ¸rÃ¸verflagg, skatt
ğŸ‡¦ğŸ‡¨	flagg, flagg: Ascension
ğŸ‡¦ğŸ‡©	flagg, flagg: Andorra
ğŸ‡¦ğŸ‡ª	flagg, flagg: De forente arabiske emirater
ğŸ‡¦ğŸ‡«	flagg, flagg: Afghanistan
ğŸ‡¦ğŸ‡¬	flagg, flagg: Antigua og Barbuda
ğŸ‡¦ğŸ‡®	flagg, flagg: Anguilla
ğŸ‡¦ğŸ‡±	flagg, flagg: Albania
ğŸ‡¦ğŸ‡²	flagg, flagg: Armenia
ğŸ‡¦ğŸ‡´	flagg, flagg: Angola
ğŸ‡¦ğŸ‡¶	flagg, flagg: Antarktis
ğŸ‡¦ğŸ‡·	flagg, flagg: Argentina
ğŸ‡¦ğŸ‡¸	flagg, flagg: Amerikansk Samoa
ğŸ‡¦ğŸ‡¹	flagg, flagg: Ã˜sterrike
ğŸ‡¦ğŸ‡º	flagg, flagg: Australia
ğŸ‡¦ğŸ‡¼	flagg, flagg: Aruba
ğŸ‡¦ğŸ‡½	flagg, flagg: Ã…land
ğŸ‡¦ğŸ‡¿	flagg, flagg: Aserbajdsjan
ğŸ‡§ğŸ‡¦	flagg, flagg: Bosnia-Hercegovina
ğŸ‡§ğŸ‡§	flagg, flagg: Barbados
ğŸ‡§ğŸ‡©	flagg, flagg: Bangladesh
ğŸ‡§ğŸ‡ª	flagg, flagg: Belgia
ğŸ‡§ğŸ‡«	flagg, flagg: Burkina Faso
ğŸ‡§ğŸ‡¬	flagg, flagg: Bulgaria
ğŸ‡§ğŸ‡­	flagg, flagg: Bahrain
ğŸ‡§ğŸ‡®	flagg, flagg: Burundi
ğŸ‡§ğŸ‡¯	flagg, flagg: Benin
ğŸ‡§ğŸ‡±	flagg, flagg: Saint-BarthÃ©lemy
ğŸ‡§ğŸ‡²	flagg, flagg: Bermuda
ğŸ‡§ğŸ‡³	flagg, flagg: Brunei
ğŸ‡§ğŸ‡´	flagg, flagg: Bolivia
ğŸ‡§ğŸ‡¶	flagg, flagg: Karibisk Nederland
ğŸ‡§ğŸ‡·	flagg, flagg: Brasil
ğŸ‡§ğŸ‡¸	flagg, flagg: Bahamas
ğŸ‡§ğŸ‡¹	flagg, flagg: Bhutan
ğŸ‡§ğŸ‡»	flagg, flagg: BouvetÃ¸ya
ğŸ‡§ğŸ‡¼	flagg, flagg: Botswana
ğŸ‡§ğŸ‡¾	flagg, flagg: Hviterussland
ğŸ‡§ğŸ‡¿	flagg, flagg: Belize
ğŸ‡¨ğŸ‡¦	flagg, flagg: Canada
ğŸ‡¨ğŸ‡¨	flagg, flagg: KokosÃ¸yene
ğŸ‡¨ğŸ‡©	flagg, flagg: Kongo-Kinshasa
ğŸ‡¨ğŸ‡«	flagg, flagg: Den sentralafrikanske republikk
ğŸ‡¨ğŸ‡¬	flagg, flagg: Kongo-Brazzaville
ğŸ‡¨ğŸ‡­	flagg, flagg: Sveits
ğŸ‡¨ğŸ‡®	flagg, flagg: Elfenbenskysten
ğŸ‡¨ğŸ‡°	flagg, flagg: CookÃ¸yene
ğŸ‡¨ğŸ‡±	flagg, flagg: Chile
ğŸ‡¨ğŸ‡²	flagg, flagg: Kamerun
ğŸ‡¨ğŸ‡³	flagg, flagg: Kina
ğŸ‡¨ğŸ‡´	flagg, flagg: Colombia
ğŸ‡¨ğŸ‡µ	flagg, flagg: ClippertonÃ¸ya
ğŸ‡¨ğŸ‡·	flagg, flagg: Costa Rica
ğŸ‡¨ğŸ‡º	flagg, flagg: Cuba
ğŸ‡¨ğŸ‡»	flagg, flagg: Kapp Verde
ğŸ‡¨ğŸ‡¼	flagg, flagg: CuraÃ§ao
ğŸ‡¨ğŸ‡½	flagg, flagg: ChristmasÃ¸ya
ğŸ‡¨ğŸ‡¾	flagg, flagg: Kypros
ğŸ‡¨ğŸ‡¿	flagg, flagg: Tsjekkia
ğŸ‡©ğŸ‡ª	flagg, flagg: Tyskland
ğŸ‡©ğŸ‡¬	flagg, flagg: Diego Garcia
ğŸ‡©ğŸ‡¯	flagg, flagg: Djibouti
ğŸ‡©ğŸ‡°	flagg, flagg: Danmark
ğŸ‡©ğŸ‡²	flagg, flagg: Dominica
ğŸ‡©ğŸ‡´	flagg, flagg: Den dominikanske republikk
ğŸ‡©ğŸ‡¿	flagg, flagg: Algerie
ğŸ‡ªğŸ‡¦	flagg, flagg: Ceuta og Melilla
ğŸ‡ªğŸ‡¨	flagg, flagg: Ecuador
ğŸ‡ªğŸ‡ª	flagg, flagg: Estland
ğŸ‡ªğŸ‡¬	flagg, flagg: Egypt
ğŸ‡ªğŸ‡­	flagg, flagg: Vest-Sahara
ğŸ‡ªğŸ‡·	flagg, flagg: Eritrea
ğŸ‡ªğŸ‡¸	flagg, flagg: Spania
ğŸ‡ªğŸ‡¹	flagg, flagg: Etiopia
ğŸ‡ªğŸ‡º	flagg, flagg: EU
ğŸ‡«ğŸ‡®	flagg, flagg: Finland
ğŸ‡«ğŸ‡¯	flagg, flagg: Fiji
ğŸ‡«ğŸ‡°	flagg, flagg: FalklandsÃ¸yene
ğŸ‡«ğŸ‡²	flagg, flagg: MikronesiafÃ¸derasjonen
ğŸ‡«ğŸ‡´	flagg, flagg: FÃ¦rÃ¸yene
ğŸ‡«ğŸ‡·	flagg, flagg: Frankrike
ğŸ‡¬ğŸ‡¦	flagg, flagg: Gabon
ğŸ‡¬ğŸ‡§	flagg, flagg: Storbritannia
ğŸ‡¬ğŸ‡©	flagg, flagg: Grenada
ğŸ‡¬ğŸ‡ª	flagg, flagg: Georgia
ğŸ‡¬ğŸ‡«	flagg, flagg: Fransk Guyana
ğŸ‡¬ğŸ‡¬	flagg, flagg: Guernsey
ğŸ‡¬ğŸ‡­	flagg, flagg: Ghana
ğŸ‡¬ğŸ‡®	flagg, flagg: Gibraltar
ğŸ‡¬ğŸ‡±	flagg, flagg: GrÃ¸nland
ğŸ‡¬ğŸ‡²	flagg, flagg: Gambia
ğŸ‡¬ğŸ‡³	flagg, flagg: Guinea
ğŸ‡¬ğŸ‡µ	flagg, flagg: Guadeloupe
ğŸ‡¬ğŸ‡¶	flagg, flagg: Ekvatorial-Guinea
ğŸ‡¬ğŸ‡·	flagg, flagg: Hellas
ğŸ‡¬ğŸ‡¸	flagg, flagg: SÃ¸r-Georgia og SÃ¸r-SandwichÃ¸yene
ğŸ‡¬ğŸ‡¹	flagg, flagg: Guatemala
ğŸ‡¬ğŸ‡º	flagg, flagg: Guam
ğŸ‡¬ğŸ‡¼	flagg, flagg: Guinea-Bissau
ğŸ‡¬ğŸ‡¾	flagg, flagg: Guyana
ğŸ‡­ğŸ‡°	flagg, flagg: Hongkong S.A.R. Kina
ğŸ‡­ğŸ‡²	flagg, flagg: Heard- og McDonaldÃ¸yene
ğŸ‡­ğŸ‡³	flagg, flagg: Honduras
ğŸ‡­ğŸ‡·	flagg, flagg: Kroatia
ğŸ‡­ğŸ‡¹	flagg, flagg: Haiti
ğŸ‡­ğŸ‡º	flagg, flagg: Ungarn
ğŸ‡®ğŸ‡¨	flagg, flagg: KanariÃ¸yene
ğŸ‡®ğŸ‡©	flagg, flagg: Indonesia
ğŸ‡®ğŸ‡ª	flagg, flagg: Irland
ğŸ‡®ğŸ‡±	flagg, flagg: Israel
ğŸ‡®ğŸ‡²	flagg, flagg: Man
ğŸ‡®ğŸ‡³	flagg, flagg: India
ğŸ‡®ğŸ‡´	flagg, flagg: Det britiske territoriet i Indiahavet
ğŸ‡®ğŸ‡¶	flagg, flagg: Irak
ğŸ‡®ğŸ‡·	flagg, flagg: Iran
ğŸ‡®ğŸ‡¸	flagg, flagg: Island
ğŸ‡®ğŸ‡¹	flagg, flagg: Italia
ğŸ‡¯ğŸ‡ª	flagg, flagg: Jersey
ğŸ‡¯ğŸ‡²	flagg, flagg: Jamaica
ğŸ‡¯ğŸ‡´	flagg, flagg: Jordan
ğŸ‡¯ğŸ‡µ	flagg, flagg: Japan
ğŸ‡°ğŸ‡ª	flagg, flagg: Kenya
ğŸ‡°ğŸ‡¬	flagg, flagg: Kirgisistan
ğŸ‡°ğŸ‡­	flagg, flagg: Kambodsja
ğŸ‡°ğŸ‡®	flagg, flagg: Kiribati
ğŸ‡°ğŸ‡²	flagg, flagg: Komorene
ğŸ‡°ğŸ‡³	flagg, flagg: Saint Kitts og Nevis
ğŸ‡°ğŸ‡µ	flagg, flagg: Nord-Korea
ğŸ‡°ğŸ‡·	flagg, flagg: SÃ¸r-Korea
ğŸ‡°ğŸ‡¼	flagg, flagg: Kuwait
ğŸ‡°ğŸ‡¾	flagg, flagg: CaymanÃ¸yene
ğŸ‡°ğŸ‡¿	flagg, flagg: Kasakhstan
ğŸ‡±ğŸ‡¦	flagg, flagg: Laos
ğŸ‡±ğŸ‡§	flagg, flagg: Libanon
ğŸ‡±ğŸ‡¨	flagg, flagg: St. Lucia
ğŸ‡±ğŸ‡®	flagg, flagg: Liechtenstein
ğŸ‡±ğŸ‡°	flagg, flagg: Sri Lanka
ğŸ‡±ğŸ‡·	flagg, flagg: Liberia
ğŸ‡±ğŸ‡¸	flagg, flagg: Lesotho
ğŸ‡±ğŸ‡¹	flagg, flagg: Litauen
ğŸ‡±ğŸ‡º	flagg, flagg: Luxemburg
ğŸ‡±ğŸ‡»	flagg, flagg: Latvia
ğŸ‡±ğŸ‡¾	flagg, flagg: Libya
ğŸ‡²ğŸ‡¦	flagg, flagg: Marokko
ğŸ‡²ğŸ‡¨	flagg, flagg: Monaco
ğŸ‡²ğŸ‡©	flagg, flagg: Moldova
ğŸ‡²ğŸ‡ª	flagg, flagg: Montenegro
ğŸ‡²ğŸ‡«	flagg, flagg: Saint-Martin
ğŸ‡²ğŸ‡¬	flagg, flagg: Madagaskar
ğŸ‡²ğŸ‡­	flagg, flagg: MarshallÃ¸yene
ğŸ‡²ğŸ‡°	flagg, flagg: Nord-Makedonia
ğŸ‡²ğŸ‡±	flagg, flagg: Mali
ğŸ‡²ğŸ‡²	flagg, flagg: Myanmar (Burma)
ğŸ‡²ğŸ‡³	flagg, flagg: Mongolia
ğŸ‡²ğŸ‡´	flagg, flagg: Macao S.A.R. Kina
ğŸ‡²ğŸ‡µ	flagg, flagg: Nord-Marianene
ğŸ‡²ğŸ‡¶	flagg, flagg: Martinique
ğŸ‡²ğŸ‡·	flagg, flagg: Mauritania
ğŸ‡²ğŸ‡¸	flagg, flagg: Montserrat
ğŸ‡²ğŸ‡¹	flagg, flagg: Malta
ğŸ‡²ğŸ‡º	flagg, flagg: Mauritius
ğŸ‡²ğŸ‡»	flagg, flagg: Maldivene
ğŸ‡²ğŸ‡¼	flagg, flagg: Malawi
ğŸ‡²ğŸ‡½	flagg, flagg: Mexico
ğŸ‡²ğŸ‡¾	flagg, flagg: Malaysia
ğŸ‡²ğŸ‡¿	flagg, flagg: Mosambik
ğŸ‡³ğŸ‡¦	flagg, flagg: Namibia
ğŸ‡³ğŸ‡¨	flagg, flagg: Ny-Caledonia
ğŸ‡³ğŸ‡ª	flagg, flagg: Niger
ğŸ‡³ğŸ‡«	flagg, flagg: NorfolkÃ¸ya
ğŸ‡³ğŸ‡¬	flagg, flagg: Nigeria
ğŸ‡³ğŸ‡®	flagg, flagg: Nicaragua
ğŸ‡³ğŸ‡±	flagg, flagg: Nederland
ğŸ‡³ğŸ‡´	flagg, flagg: Norge
ğŸ‡³ğŸ‡µ	flagg, flagg: Nepal
ğŸ‡³ğŸ‡·	flagg, flagg: Nauru
ğŸ‡³ğŸ‡º	flagg, flagg: Niue
ğŸ‡³ğŸ‡¿	flagg, flagg: New Zealand
ğŸ‡´ğŸ‡²	flagg, flagg: Oman
ğŸ‡µğŸ‡¦	flagg, flagg: Panama
ğŸ‡µğŸ‡ª	flagg, flagg: Peru
ğŸ‡µğŸ‡«	flagg, flagg: Fransk Polynesia
ğŸ‡µğŸ‡¬	flagg, flagg: Papua Ny-Guinea
ğŸ‡µğŸ‡­	flagg, flagg: Filippinene
ğŸ‡µğŸ‡°	flagg, flagg: Pakistan
ğŸ‡µğŸ‡±	flagg, flagg: Polen
ğŸ‡µğŸ‡²	flagg, flagg: Saint-Pierre-et-Miquelon
ğŸ‡µğŸ‡³	flagg, flagg: PitcairnÃ¸yene
ğŸ‡µğŸ‡·	flagg, flagg: Puerto Rico
ğŸ‡µğŸ‡¸	flagg, flagg: Det palestinske omrÃ¥det
ğŸ‡µğŸ‡¹	flagg, flagg: Portugal
ğŸ‡µğŸ‡¼	flagg, flagg: Palau
ğŸ‡µğŸ‡¾	flagg, flagg: Paraguay
ğŸ‡¶ğŸ‡¦	flagg, flagg: Qatar
ğŸ‡·ğŸ‡ª	flagg, flagg: RÃ©union
ğŸ‡·ğŸ‡´	flagg, flagg: Romania
ğŸ‡·ğŸ‡¸	flagg, flagg: Serbia
ğŸ‡·ğŸ‡º	flagg, flagg: Russland
ğŸ‡·ğŸ‡¼	flagg, flagg: Rwanda
ğŸ‡¸ğŸ‡¦	flagg, flagg: Saudi-Arabia
ğŸ‡¸ğŸ‡§	flagg, flagg: SalomonÃ¸yene
ğŸ‡¸ğŸ‡¨	flagg, flagg: Seychellene
ğŸ‡¸ğŸ‡©	flagg, flagg: Sudan
ğŸ‡¸ğŸ‡ª	flagg, flagg: Sverige
ğŸ‡¸ğŸ‡¬	flagg, flagg: Singapore
ğŸ‡¸ğŸ‡­	flagg, flagg: St. Helena
ğŸ‡¸ğŸ‡®	flagg, flagg: Slovenia
ğŸ‡¸ğŸ‡¯	flagg, flagg: Svalbard og Jan Mayen
ğŸ‡¸ğŸ‡°	flagg, flagg: Slovakia
ğŸ‡¸ğŸ‡±	flagg, flagg: Sierra Leone
ğŸ‡¸ğŸ‡²	flagg, flagg: San Marino
ğŸ‡¸ğŸ‡³	flagg, flagg: Senegal
ğŸ‡¸ğŸ‡´	flagg, flagg: Somalia
ğŸ‡¸ğŸ‡·	flagg, flagg: Surinam
ğŸ‡¸ğŸ‡¸	flagg, flagg: SÃ¸r-Sudan
ğŸ‡¸ğŸ‡¹	flagg, flagg: SÃ£o TomÃ© og PrÃ­ncipe
ğŸ‡¸ğŸ‡»	flagg, flagg: El Salvador
ğŸ‡¸ğŸ‡½	flagg, flagg: Sint Maarten
ğŸ‡¸ğŸ‡¾	flagg, flagg: Syria
ğŸ‡¸ğŸ‡¿	flagg, flagg: Eswatini
ğŸ‡¹ğŸ‡¦	flagg, flagg: Tristan da Cunha
ğŸ‡¹ğŸ‡¨	flagg, flagg: Turks- og CaicosÃ¸yene
ğŸ‡¹ğŸ‡©	flagg, flagg: Tsjad
ğŸ‡¹ğŸ‡«	flagg, flagg: De franske sÃ¸rterritorier
ğŸ‡¹ğŸ‡¬	flagg, flagg: Togo
ğŸ‡¹ğŸ‡­	flagg, flagg: Thailand
ğŸ‡¹ğŸ‡¯	flagg, flagg: Tadsjikistan
ğŸ‡¹ğŸ‡°	flagg, flagg: Tokelau
ğŸ‡¹ğŸ‡±	flagg, flagg: Ã˜st-Timor
ğŸ‡¹ğŸ‡²	flagg, flagg: Turkmenistan
ğŸ‡¹ğŸ‡³	flagg, flagg: Tunisia
ğŸ‡¹ğŸ‡´	flagg, flagg: Tonga
ğŸ‡¹ğŸ‡·	flagg, flagg: Tyrkia
ğŸ‡¹ğŸ‡¹	flagg, flagg: Trinidad og Tobago
ğŸ‡¹ğŸ‡»	flagg, flagg: Tuvalu
ğŸ‡¹ğŸ‡¼	flagg, flagg: Taiwan
ğŸ‡¹ğŸ‡¿	flagg, flagg: Tanzania
ğŸ‡ºğŸ‡¦	flagg, flagg: Ukraina
ğŸ‡ºğŸ‡¬	flagg, flagg: Uganda
ğŸ‡ºğŸ‡²	flagg, flagg: USAs ytre Ã¸yer
ğŸ‡ºğŸ‡³	flagg, flagg: FN
ğŸ‡ºğŸ‡¸	flagg, flagg: USA
ğŸ‡ºğŸ‡¾	flagg, flagg: Uruguay
ğŸ‡ºğŸ‡¿	flagg, flagg: Usbekistan
ğŸ‡»ğŸ‡¦	flagg, flagg: Vatikanstaten
ğŸ‡»ğŸ‡¨	flagg, flagg: St. Vincent og Grenadinene
ğŸ‡»ğŸ‡ª	flagg, flagg: Venezuela
ğŸ‡»ğŸ‡¬	flagg, flagg: De britiske jomfruÃ¸yene
ğŸ‡»ğŸ‡®	flagg, flagg: De amerikanske jomfruÃ¸yene
ğŸ‡»ğŸ‡³	flagg, flagg: Vietnam
ğŸ‡»ğŸ‡º	flagg, flagg: Vanuatu
ğŸ‡¼ğŸ‡«	flagg, flagg: Wallis og Futuna
ğŸ‡¼ğŸ‡¸	flagg, flagg: Samoa
ğŸ‡½ğŸ‡°	flagg, flagg: Kosovo
ğŸ‡¾ğŸ‡ª	flagg, flagg: Jemen
ğŸ‡¾ğŸ‡¹	flagg, flagg: Mayotte
ğŸ‡¿ğŸ‡¦	flagg, flagg: SÃ¸r-Afrika
ğŸ‡¿ğŸ‡²	flagg, flagg: Zambia
ğŸ‡¿ğŸ‡¼	flagg, flagg: Zimbabwe
ğŸ´ó §ó ¢ó ¥ó ®ó §ó ¿	flagg, flagg: England
ğŸ´ó §ó ¢ó ³ó £ó ´ó ¿	flagg, flagg: Skottland
ğŸ´ó §ó ¢ó ·ó ¬ó ³ó ¿	flagg, flagg: Wales
ğŸ»	emojimodifikator, fitzpatrick, hud, hudfarge, hudtype 1â€“2, type 1â€“2
ğŸ¼	emojimodifikator, fitzpatrick, hud, hudfarge, hudtype 3, type 3
ğŸ½	emojimodifikator, fitzpatrick, hud, hudfarge, hudtype 4, type 4
ğŸ¾	emojimodifikator, fitzpatrick, hud, hudfarge, hudtype 5, type 5
ğŸ¿	emojimodifikator, fitzpatrick, hud, hudfarge, hudtype 6, type 6
