ğŸ˜€	mata fiefia
ğŸ˜ƒ	mata fiefia moe kanoÊ»imata lalahi
ğŸ˜„	mata fiefia moe kanoÊ»imata malimali
ğŸ˜	mata ina moe kanoÊ»imata malimali
ğŸ˜†	mata
ğŸ˜…	mata fiefia moe tautaÊ»a
ğŸ¤£	mata kata moe teka faliki
ğŸ˜‚	mata moe loÊ»imata fiefia
ğŸ™‚	mata kiÊ»i malimali
ğŸ™ƒ	mata fulihi
ğŸ˜‰	mata fakakuitaha
ğŸ˜Š	mata malimali moe kanoÊ»imata malimali
ğŸ˜‡	mata malimali moe takaniko
ğŸ¥°	mata malimali moe mafu Ê»e 3
ğŸ˜	mata malimali moe kanoÊ»imata mafu
ğŸ¤©	mata fetuÊ»u
ğŸ˜˜	mata Ê»oku puhi Ê»ae Ê»uma
ğŸ˜—	mata Ê»uma
â˜ºï¸	mata malimali
ğŸ˜š	mata Ê»uma moe kanoÊ»imata kuikui
ğŸ˜™	mata Ê»uma moe kanoÊ»imata malimali
ğŸ˜‹	mataÊ»i Ê»uakai
ğŸ˜›	mata moe Ê»elelo
ğŸ˜œ	mata kuitaha moe Ê»elelo
ğŸ¤ª	mata masoli
ğŸ˜	mata kuikui moe Ê»elelo
ğŸ¤‘	mata ngutu-paÊ»anga
ğŸ¤—	mata fÄÊ»ufua
ğŸ¤­	mata moe nima Ê»i muÊ»a Ê»oe ngutu
ğŸ¤«	mata fiemaÊ»u fakalongolongo
ğŸ¤”	mataÊ»i fakakaukau
ğŸ¤	mata moe ngutu meÊ»a-fakamaÊ»u-fusi
ğŸ¤¨	mata moe kemo mahiki
ğŸ˜ï¸	mata noa pÄ“
ğŸ˜‘	mata matanoa
ğŸ˜¶	mata taÊ»e ngutu
ğŸ˜	mata katakata manuki
ğŸ˜’	mata taÊ»efiefia
ğŸ™„	mata kilokilo
ğŸ˜¬	mata mioÊ»i
ğŸ¤¥	mata moe ihu lÅloa
ğŸ˜Œ	mata fakanongononga
ğŸ˜”	mata fakalaulauloto
ğŸ˜ª	mata fiemohea
ğŸ¤¤	mata ngutu hafu fÄvai
ğŸ˜´	mata mohe
ğŸ˜·	mata moe pÅ«loa fakafaitoÊ»o
ğŸ¤’	mata moe meÊ»afuamafana
ğŸ¤•	mata moe haÊ»i lavea
ğŸ¤¢	mata kavahia
ğŸ¤®	mata lua
ğŸ¤§	mata mafatua
ğŸ¥µ	mata vevela
ğŸ¥¶	mata momoko
ğŸ¥´	mata konÄ
ğŸ˜µ	mata ninimo
ğŸ¤¯	mata pahÅ«
ğŸ¤ 	mata moe tatÄ fakakaupoe
ğŸ¥³	mata paati
ğŸ˜	mata malimali moe matasioÊ»atalaÊ»Ä
ğŸ¤“	mata moe matasioÊ»ata lahi
ğŸ§	mata moe matasioÊ»ata tafaÊ»aki taha
ğŸ˜•	mata puputuÊ»u
ğŸ˜Ÿ	mata lotohohaÊ»a
ğŸ™	mata kiÊ»i fingo
â˜¹ï¸	mata fingo
ğŸ˜®	mata moe ngutu fakamanga
ğŸ˜¯	mata longo
ğŸ˜²	mata Ê»ohovale
ğŸ˜³	mata pahapaha
ğŸ¥º	mata kole
ğŸ˜¦	mata fingo moe ngutu fakamanga
ğŸ˜§	mata lotomamahi
ğŸ˜¨	mata fakamanavahÄ“
ğŸ˜°	mata lotomoÊ»ua moe tautaÊ»a
ğŸ˜¥	mata lotomamahi kÄ fakanongononga
ğŸ˜¢	mata loÊ»imata
ğŸ˜­	mata loÊ»imata lahi
ğŸ˜±	mata Ê»oku kekekeke he manavahÄ“
ğŸ˜–	mata fakapuputuÊ»u
ğŸ˜£	mata lotokÄ«taki
ğŸ˜	mata fakalotomamahi
ğŸ˜“	mata lototaÊ»otaÊ»omia moe tautaÊ»a
ğŸ˜©	mata ongosia
ğŸ˜«	mata helaÊ»ia
ğŸ˜¤	mata moe mao meihe ihu
ğŸ˜¡	mata taÊ»efiemÄlie
ğŸ˜ 	mata Ê»ita
ğŸ¤¬	mata kapekape
ğŸ˜ˆ	mata malimali moe meÊ»atui
ğŸ‘¿	mata Ê»ita moe meÊ»atui
ğŸ’€	Ê»ulupoko
â˜ ï¸	Ê»ulupoko moe ongo hui fehauaki
ğŸ’©	tuÊ»unga meÊ»akovi
ğŸ¤¡	mata tokotaha-fieoli
ğŸ‘¹	pÄ«nÅnÅ
ğŸ‘º	nifoloa
ğŸ‘»	fakapÅ«loa
ğŸ‘½ï¸	meÊ»amoÊ»uikehe
ğŸ‘¾	meÊ»amoÊ»uikehe fakamanavahÄ“
ğŸ¤–	mata tangata-ukamea
ğŸ˜º	mataÊ»ipusi fiefia
ğŸ˜¸	mataÊ»ipusi fiefia moe kanoÊ»imata malimali
ğŸ˜¹	mataÊ»ipusi moe loÊ»imata fiefia
ğŸ˜»	mataÊ»ipusi malimali moe kanoÊ»imata mafu
ğŸ˜¼	mataÊ»ipusi moe malimali feÊ»u
ğŸ˜½	mataÊ»ipusi Ê»uma
ğŸ™€	mataÊ»ipusi ongosia
ğŸ˜¿	mataÊ»ipusi loÊ»imata
ğŸ˜¾	mataÊ»ipusi taÊ»efiemÄlie
ğŸ™ˆ	ngeli Ê»ikai sio kovi
ğŸ™‰	ngeli Ê»ikai fanongo kovi
ğŸ™Š	ngeli Ê»ikai lea kovi
ğŸ’‹	Ê»ilonga loungutu
ğŸ’Œ	tohi Ê»ofa
ğŸ’˜	mafu moe ngahau
ğŸ’	mafu moe lipine
ğŸ’–	mafu ngingila
ğŸ’—	mafu tupu
ğŸ’“	mafu Ê»oku tÄ
ğŸ’	ongo mafu takai
ğŸ’•	ongo mafu
ğŸ’Ÿ	mafu teuteuÊ»i
â£ï¸	mafu fakaÊ»ilonga kalanga
ğŸ’”	loto lavea
â¤ï¸	mafu kulokula
ğŸ§¡	mafu lanumoli
ğŸ’›	mafu engeenga
ğŸ’š	mafu lanumata
ğŸ’™	mafu lanupulÅ«
ğŸ’œ	mafu lanufesiÊ»ifekika
ğŸ–¤	mafu Ê»uliÊ»uli
ğŸ’¯	poini Ê»e teau
ğŸ’¢	fakaÊ»ilonga Ê»ita
ğŸ’¥	fepaki
ğŸ’«	ninimo
ğŸ’¦	tautaÊ»a tulutÄ
ğŸ’¨	Ê»oho atu
ğŸ•³ï¸	ava
ğŸ’£ï¸	pulukÅkÅ
ğŸ’¬	pulalea
ğŸ‘â€ğŸ—¨	kanoÊ»imata Ê»i ha pulalea
ğŸ—¨ï¸	pulalea Ê»i hema
ğŸ—¯ï¸	pulalea Ê»ita
ğŸ’­	pulalea fakakaukau
ğŸ’¤	mohe
ğŸ‘‹	nima taÊ»ataÊ»alo
ğŸ‘‹ğŸ»	kili hinehina, nima taÊ»ataÊ»alo, nima taÊ»ataÊ»alo: kili hinehina
ğŸ‘‹ğŸ¼	kili kelokelo, nima taÊ»ataÊ»alo, nima taÊ»ataÊ»alo: kili kelokelo
ğŸ‘‹ğŸ½	kili melomelo, nima taÊ»ataÊ»alo, nima taÊ»ataÊ»alo: kili melomelo
ğŸ‘‹ğŸ¾	kili melomelo-Ê»uliÊ»uli, nima taÊ»ataÊ»alo, nima taÊ»ataÊ»alo: kili melomelo-Ê»uliÊ»uli
ğŸ‘‹ğŸ¿	kili Ê»uliÊ»uli, nima taÊ»ataÊ»alo, nima taÊ»ataÊ»alo: kili Ê»uliÊ»uli
ğŸ¤š	tuÊ»anima hiki ki Ê»olunga
ğŸ¤šğŸ»	kili hinehina, tuÊ»anima hiki ki Ê»olunga, tuÊ»anima hiki ki Ê»olunga: kili hinehina
ğŸ¤šğŸ¼	kili kelokelo, tuÊ»anima hiki ki Ê»olunga, tuÊ»anima hiki ki Ê»olunga: kili kelokelo
ğŸ¤šğŸ½	kili melomelo, tuÊ»anima hiki ki Ê»olunga, tuÊ»anima hiki ki Ê»olunga: kili melomelo
ğŸ¤šğŸ¾	kili melomelo-Ê»uliÊ»uli, tuÊ»anima hiki ki Ê»olunga, tuÊ»anima hiki ki Ê»olunga: kili melomelo-Ê»uliÊ»uli
ğŸ¤šğŸ¿	kili Ê»uliÊ»uli, tuÊ»anima hiki ki Ê»olunga, tuÊ»anima hiki ki Ê»olunga: kili Ê»uliÊ»uli
ğŸ–ï¸	nima fÄlalahi
ğŸ–ğŸ»	kili hinehina, nima fÄlalahi, nima fÄlalahi: kili hinehina
ğŸ–ğŸ¼	kili kelokelo, nima fÄlalahi, nima fÄlalahi: kili kelokelo
ğŸ–ğŸ½	kili melomelo, nima fÄlalahi, nima fÄlalahi: kili melomelo
ğŸ–ğŸ¾	kili melomelo-Ê»uliÊ»uli, nima fÄlalahi, nima fÄlalahi: kili melomelo-Ê»uliÊ»uli
ğŸ–ğŸ¿	kili Ê»uliÊ»uli, nima fÄlalahi, nima fÄlalahi: kili Ê»uliÊ»uli
âœ‹	nima hiki ki Ê»olunga
âœ‹ğŸ»	kili hinehina, nima hiki ki Ê»olunga, nima hiki ki Ê»olunga: kili hinehina
âœ‹ğŸ¼	kili kelokelo, nima hiki ki Ê»olunga, nima hiki ki Ê»olunga: kili kelokelo
âœ‹ğŸ½	kili melomelo, nima hiki ki Ê»olunga, nima hiki ki Ê»olunga: kili melomelo
âœ‹ğŸ¾	kili melomelo-Ê»uliÊ»uli, nima hiki ki Ê»olunga, nima hiki ki Ê»olunga: kili melomelo-Ê»uliÊ»uli
âœ‹ğŸ¿	kili Ê»uliÊ»uli, nima hiki ki Ê»olunga, nima hiki ki Ê»olunga: kili Ê»uliÊ»uli
ğŸ––	nima mavaeua
ğŸ––ğŸ»	kili hinehina, nima mavaeua, nima mavaeua: kili hinehina
ğŸ––ğŸ¼	kili kelokelo, nima mavaeua, nima mavaeua: kili kelokelo
ğŸ––ğŸ½	kili melomelo, nima mavaeua, nima mavaeua: kili melomelo
ğŸ––ğŸ¾	kili melomelo-Ê»uliÊ»uli, nima mavaeua, nima mavaeua: kili melomelo-Ê»uliÊ»uli
ğŸ––ğŸ¿	kili Ê»uliÊ»uli, nima mavaeua, nima mavaeua: kili Ê»uliÊ»uli
ğŸ‘Œ	nima fakaÊ»ilonga sai
ğŸ‘ŒğŸ»	kili hinehina, nima fakaÊ»ilonga sai, nima fakaÊ»ilonga sai: kili hinehina
ğŸ‘ŒğŸ¼	kili kelokelo, nima fakaÊ»ilonga sai, nima fakaÊ»ilonga sai: kili kelokelo
ğŸ‘ŒğŸ½	kili melomelo, nima fakaÊ»ilonga sai, nima fakaÊ»ilonga sai: kili melomelo
ğŸ‘ŒğŸ¾	kili melomelo-Ê»uliÊ»uli, nima fakaÊ»ilonga sai, nima fakaÊ»ilonga sai: kili melomelo-Ê»uliÊ»uli
ğŸ‘ŒğŸ¿	kili Ê»uliÊ»uli, nima fakaÊ»ilonga sai, nima fakaÊ»ilonga sai: kili Ê»uliÊ»uli
âœŒï¸	nima ikuna
âœŒğŸ»	kili hinehina, nima ikuna, nima ikuna: kili hinehina
âœŒğŸ¼	kili kelokelo, nima ikuna, nima ikuna: kili kelokelo
âœŒğŸ½	kili melomelo, nima ikuna, nima ikuna: kili melomelo
âœŒğŸ¾	kili melomelo-Ê»uliÊ»uli, nima ikuna, nima ikuna: kili melomelo-Ê»uliÊ»uli
âœŒğŸ¿	kili Ê»uliÊ»uli, nima ikuna, nima ikuna: kili Ê»uliÊ»uli
ğŸ¤	louhiÊ»inima fehauaki
ğŸ¤ğŸ»	kili hinehina, louhiÊ»inima fehauaki, louhiÊ»inima fehauaki: kili hinehina
ğŸ¤ğŸ¼	kili kelokelo, louhiÊ»inima fehauaki, louhiÊ»inima fehauaki: kili kelokelo
ğŸ¤ğŸ½	kili melomelo, louhiÊ»inima fehauaki, louhiÊ»inima fehauaki: kili melomelo
ğŸ¤ğŸ¾	kili melomelo-Ê»uliÊ»uli, louhiÊ»inima fehauaki, louhiÊ»inima fehauaki: kili melomelo-Ê»uliÊ»uli
ğŸ¤ğŸ¿	kili Ê»uliÊ»uli, louhiÊ»inima fehauaki, louhiÊ»inima fehauaki: kili Ê»uliÊ»uli
ğŸ¤Ÿ	nima fakaÊ»ilonga mafu
ğŸ¤ŸğŸ»	kili hinehina, nima fakaÊ»ilonga mafu, nima fakaÊ»ilonga mafu: kili hinehina
ğŸ¤ŸğŸ¼	kili kelokelo, nima fakaÊ»ilonga mafu, nima fakaÊ»ilonga mafu: kili kelokelo
ğŸ¤ŸğŸ½	kili melomelo, nima fakaÊ»ilonga mafu, nima fakaÊ»ilonga mafu: kili melomelo
ğŸ¤ŸğŸ¾	kili melomelo-Ê»uliÊ»uli, nima fakaÊ»ilonga mafu, nima fakaÊ»ilonga mafu: kili melomelo-Ê»uliÊ»uli
ğŸ¤ŸğŸ¿	kili Ê»uliÊ»uli, nima fakaÊ»ilonga mafu, nima fakaÊ»ilonga mafu: kili Ê»uliÊ»uli
ğŸ¤˜	nima fakaÊ»ilonga fakatÄ“volo
ğŸ¤˜ğŸ»	kili hinehina, nima fakaÊ»ilonga fakatÄ“volo, nima fakaÊ»ilonga fakatÄ“volo: kili hinehina
ğŸ¤˜ğŸ¼	kili kelokelo, nima fakaÊ»ilonga fakatÄ“volo, nima fakaÊ»ilonga fakatÄ“volo: kili kelokelo
ğŸ¤˜ğŸ½	kili melomelo, nima fakaÊ»ilonga fakatÄ“volo, nima fakaÊ»ilonga fakatÄ“volo: kili melomelo
ğŸ¤˜ğŸ¾	kili melomelo-Ê»uliÊ»uli, nima fakaÊ»ilonga fakatÄ“volo, nima fakaÊ»ilonga fakatÄ“volo: kili melomelo-Ê»uliÊ»uli
ğŸ¤˜ğŸ¿	kili Ê»uliÊ»uli, nima fakaÊ»ilonga fakatÄ“volo, nima fakaÊ»ilonga fakatÄ“volo: kili Ê»uliÊ»uli
ğŸ¤™	nima fakaÊ»ilonga tÄ mai
ğŸ¤™ğŸ»	kili hinehina, nima fakaÊ»ilonga tÄ mai, nima fakaÊ»ilonga tÄ mai: kili hinehina
ğŸ¤™ğŸ¼	kili kelokelo, nima fakaÊ»ilonga tÄ mai, nima fakaÊ»ilonga tÄ mai: kili kelokelo
ğŸ¤™ğŸ½	kili melomelo, nima fakaÊ»ilonga tÄ mai, nima fakaÊ»ilonga tÄ mai: kili melomelo
ğŸ¤™ğŸ¾	kili melomelo-Ê»uliÊ»uli, nima fakaÊ»ilonga tÄ mai, nima fakaÊ»ilonga tÄ mai: kili melomelo-Ê»uliÊ»uli
ğŸ¤™ğŸ¿	kili Ê»uliÊ»uli, nima fakaÊ»ilonga tÄ mai, nima fakaÊ»ilonga tÄ mai: kili Ê»uliÊ»uli
ğŸ‘ˆï¸	tuhu tuÊ»anima tonu ki hema
ğŸ‘ˆğŸ»	kili hinehina, tuhu tuÊ»anima tonu ki hema, tuhu tuÊ»anima tonu ki hema: kili hinehina
ğŸ‘ˆğŸ¼	kili kelokelo, tuhu tuÊ»anima tonu ki hema, tuhu tuÊ»anima tonu ki hema: kili kelokelo
ğŸ‘ˆğŸ½	kili melomelo, tuhu tuÊ»anima tonu ki hema, tuhu tuÊ»anima tonu ki hema: kili melomelo
ğŸ‘ˆğŸ¾	kili melomelo-Ê»uliÊ»uli, tuhu tuÊ»anima tonu ki hema, tuhu tuÊ»anima tonu ki hema: kili melomelo-Ê»uliÊ»uli
ğŸ‘ˆğŸ¿	kili Ê»uliÊ»uli, tuhu tuÊ»anima tonu ki hema, tuhu tuÊ»anima tonu ki hema: kili Ê»uliÊ»uli
ğŸ‘‰ï¸	tuhu tuÊ»anima tonu ki mataÊ»u
ğŸ‘‰ğŸ»	kili hinehina, tuhu tuÊ»anima tonu ki mataÊ»u, tuhu tuÊ»anima tonu ki mataÊ»u: kili hinehina
ğŸ‘‰ğŸ¼	kili kelokelo, tuhu tuÊ»anima tonu ki mataÊ»u, tuhu tuÊ»anima tonu ki mataÊ»u: kili kelokelo
ğŸ‘‰ğŸ½	kili melomelo, tuhu tuÊ»anima tonu ki mataÊ»u, tuhu tuÊ»anima tonu ki mataÊ»u: kili melomelo
ğŸ‘‰ğŸ¾	kili melomelo-Ê»uliÊ»uli, tuhu tuÊ»anima tonu ki mataÊ»u, tuhu tuÊ»anima tonu ki mataÊ»u: kili melomelo-Ê»uliÊ»uli
ğŸ‘‰ğŸ¿	kili Ê»uliÊ»uli, tuhu tuÊ»anima tonu ki mataÊ»u, tuhu tuÊ»anima tonu ki mataÊ»u: kili Ê»uliÊ»uli
ğŸ‘†ï¸	tuhu tuÊ»anima tonu ki Ê»olunga
ğŸ‘†ğŸ»	kili hinehina, tuhu tuÊ»anima tonu ki Ê»olunga, tuhu tuÊ»anima tonu ki Ê»olunga: kili hinehina
ğŸ‘†ğŸ¼	kili kelokelo, tuhu tuÊ»anima tonu ki Ê»olunga, tuhu tuÊ»anima tonu ki Ê»olunga: kili kelokelo
ğŸ‘†ğŸ½	kili melomelo, tuhu tuÊ»anima tonu ki Ê»olunga, tuhu tuÊ»anima tonu ki Ê»olunga: kili melomelo
ğŸ‘†ğŸ¾	kili melomelo-Ê»uliÊ»uli, tuhu tuÊ»anima tonu ki Ê»olunga, tuhu tuÊ»anima tonu ki Ê»olunga: kili melomelo-Ê»uliÊ»uli
ğŸ‘†ğŸ¿	kili Ê»uliÊ»uli, tuhu tuÊ»anima tonu ki Ê»olunga, tuhu tuÊ»anima tonu ki Ê»olunga: kili Ê»uliÊ»uli
ğŸ–•	tuhu Ê»i loto
ğŸ–•ğŸ»	kili hinehina, tuhu Ê»i loto, tuhu Ê»i loto: kili hinehina
ğŸ–•ğŸ¼	kili kelokelo, tuhu Ê»i loto, tuhu Ê»i loto: kili kelokelo
ğŸ–•ğŸ½	kili melomelo, tuhu Ê»i loto, tuhu Ê»i loto: kili melomelo
ğŸ–•ğŸ¾	kili melomelo-Ê»uliÊ»uli, tuhu Ê»i loto, tuhu Ê»i loto: kili melomelo-Ê»uliÊ»uli
ğŸ–•ğŸ¿	kili Ê»uliÊ»uli, tuhu Ê»i loto, tuhu Ê»i loto: kili Ê»uliÊ»uli
ğŸ‘‡ï¸	tuhu tuÊ»anima tonu ki lalo
ğŸ‘‡ğŸ»	kili hinehina, tuhu tuÊ»anima tonu ki lalo, tuhu tuÊ»anima tonu ki lalo: kili hinehina
ğŸ‘‡ğŸ¼	kili kelokelo, tuhu tuÊ»anima tonu ki lalo, tuhu tuÊ»anima tonu ki lalo: kili kelokelo
ğŸ‘‡ğŸ½	kili melomelo, tuhu tuÊ»anima tonu ki lalo, tuhu tuÊ»anima tonu ki lalo: kili melomelo
ğŸ‘‡ğŸ¾	kili melomelo-Ê»uliÊ»uli, tuhu tuÊ»anima tonu ki lalo, tuhu tuÊ»anima tonu ki lalo: kili melomelo-Ê»uliÊ»uli
ğŸ‘‡ğŸ¿	kili Ê»uliÊ»uli, tuhu tuÊ»anima tonu ki lalo, tuhu tuÊ»anima tonu ki lalo: kili Ê»uliÊ»uli
â˜ï¸	tuhu tonu ki Ê»olunga
â˜ğŸ»	kili hinehina, tuhu tonu ki Ê»olunga, tuhu tonu ki Ê»olunga: kili hinehina
â˜ğŸ¼	kili kelokelo, tuhu tonu ki Ê»olunga, tuhu tonu ki Ê»olunga: kili kelokelo
â˜ğŸ½	kili melomelo, tuhu tonu ki Ê»olunga, tuhu tonu ki Ê»olunga: kili melomelo
â˜ğŸ¾	kili melomelo-Ê»uliÊ»uli, tuhu tonu ki Ê»olunga, tuhu tonu ki Ê»olunga: kili melomelo-Ê»uliÊ»uli
â˜ğŸ¿	kili Ê»uliÊ»uli, tuhu tonu ki Ê»olunga, tuhu tonu ki Ê»olunga: kili Ê»uliÊ»uli
ğŸ‘ï¸	motuÊ»atuhu ki Ê»olunga
ğŸ‘ğŸ»	kili hinehina, motuÊ»atuhu ki Ê»olunga, motuÊ»atuhu ki Ê»olunga: kili hinehina
ğŸ‘ğŸ¼	kili kelokelo, motuÊ»atuhu ki Ê»olunga, motuÊ»atuhu ki Ê»olunga: kili kelokelo
ğŸ‘ğŸ½	kili melomelo, motuÊ»atuhu ki Ê»olunga, motuÊ»atuhu ki Ê»olunga: kili melomelo
ğŸ‘ğŸ¾	kili melomelo-Ê»uliÊ»uli, motuÊ»atuhu ki Ê»olunga, motuÊ»atuhu ki Ê»olunga: kili melomelo-Ê»uliÊ»uli
ğŸ‘ğŸ¿	kili Ê»uliÊ»uli, motuÊ»atuhu ki Ê»olunga, motuÊ»atuhu ki Ê»olunga: kili Ê»uliÊ»uli
ğŸ‘ï¸	motuÊ»atuhu ki lalo
ğŸ‘ğŸ»	kili hinehina, motuÊ»atuhu ki lalo, motuÊ»atuhu ki lalo: kili hinehina
ğŸ‘ğŸ¼	kili kelokelo, motuÊ»atuhu ki lalo, motuÊ»atuhu ki lalo: kili kelokelo
ğŸ‘ğŸ½	kili melomelo, motuÊ»atuhu ki lalo, motuÊ»atuhu ki lalo: kili melomelo
ğŸ‘ğŸ¾	kili melomelo-Ê»uliÊ»uli, motuÊ»atuhu ki lalo, motuÊ»atuhu ki lalo: kili melomelo-Ê»uliÊ»uli
ğŸ‘ğŸ¿	kili Ê»uliÊ»uli, motuÊ»atuhu ki lalo, motuÊ»atuhu ki lalo: kili Ê»uliÊ»uli
âœŠ	tuke hiki ki Ê»olunga
âœŠğŸ»	kili hinehina, tuke hiki ki Ê»olunga, tuke hiki ki Ê»olunga: kili hinehina
âœŠğŸ¼	kili kelokelo, tuke hiki ki Ê»olunga, tuke hiki ki Ê»olunga: kili kelokelo
âœŠğŸ½	kili melomelo, tuke hiki ki Ê»olunga, tuke hiki ki Ê»olunga: kili melomelo
âœŠğŸ¾	kili melomelo-Ê»uliÊ»uli, tuke hiki ki Ê»olunga, tuke hiki ki Ê»olunga: kili melomelo-Ê»uliÊ»uli
âœŠğŸ¿	kili Ê»uliÊ»uli, tuke hiki ki Ê»olunga, tuke hiki ki Ê»olunga: kili Ê»uliÊ»uli
ğŸ‘Š	tuke ki muÊ»a
ğŸ‘ŠğŸ»	kili hinehina, tuke ki muÊ»a, tuke ki muÊ»a: kili hinehina
ğŸ‘ŠğŸ¼	kili kelokelo, tuke ki muÊ»a, tuke ki muÊ»a: kili kelokelo
ğŸ‘ŠğŸ½	kili melomelo, tuke ki muÊ»a, tuke ki muÊ»a: kili melomelo
ğŸ‘ŠğŸ¾	kili melomelo-Ê»uliÊ»uli, tuke ki muÊ»a, tuke ki muÊ»a: kili melomelo-Ê»uliÊ»uli
ğŸ‘ŠğŸ¿	kili Ê»uliÊ»uli, tuke ki muÊ»a, tuke ki muÊ»a: kili Ê»uliÊ»uli
ğŸ¤›	tuke ki hema
ğŸ¤›ğŸ»	kili hinehina, tuke ki hema, tuke ki hema: kili hinehina
ğŸ¤›ğŸ¼	kili kelokelo, tuke ki hema, tuke ki hema: kili kelokelo
ğŸ¤›ğŸ½	kili melomelo, tuke ki hema, tuke ki hema: kili melomelo
ğŸ¤›ğŸ¾	kili melomelo-Ê»uliÊ»uli, tuke ki hema, tuke ki hema: kili melomelo-Ê»uliÊ»uli
ğŸ¤›ğŸ¿	kili Ê»uliÊ»uli, tuke ki hema, tuke ki hema: kili Ê»uliÊ»uli
ğŸ¤œ	tuke ki mataÊ»u
ğŸ¤œğŸ»	kili hinehina, tuke ki mataÊ»u, tuke ki mataÊ»u: kili hinehina
ğŸ¤œğŸ¼	kili kelokelo, tuke ki mataÊ»u, tuke ki mataÊ»u: kili kelokelo
ğŸ¤œğŸ½	kili melomelo, tuke ki mataÊ»u, tuke ki mataÊ»u: kili melomelo
ğŸ¤œğŸ¾	kili melomelo-Ê»uliÊ»uli, tuke ki mataÊ»u, tuke ki mataÊ»u: kili melomelo-Ê»uliÊ»uli
ğŸ¤œğŸ¿	kili Ê»uliÊ»uli, tuke ki mataÊ»u, tuke ki mataÊ»u: kili Ê»uliÊ»uli
ğŸ‘	nima pasipasi
ğŸ‘ğŸ»	kili hinehina, nima pasipasi, nima pasipasi: kili hinehina
ğŸ‘ğŸ¼	kili kelokelo, nima pasipasi, nima pasipasi: kili kelokelo
ğŸ‘ğŸ½	kili melomelo, nima pasipasi, nima pasipasi: kili melomelo
ğŸ‘ğŸ¾	kili melomelo-Ê»uliÊ»uli, nima pasipasi, nima pasipasi: kili melomelo-Ê»uliÊ»uli
ğŸ‘ğŸ¿	kili Ê»uliÊ»uli, nima pasipasi, nima pasipasi: kili Ê»uliÊ»uli
ğŸ™Œ	ongo nima hiki ki Ê»olunga
ğŸ™ŒğŸ»	kili hinehina, ongo nima hiki ki Ê»olunga, ongo nima hiki ki Ê»olunga: kili hinehina
ğŸ™ŒğŸ¼	kili kelokelo, ongo nima hiki ki Ê»olunga, ongo nima hiki ki Ê»olunga: kili kelokelo
ğŸ™ŒğŸ½	kili melomelo, ongo nima hiki ki Ê»olunga, ongo nima hiki ki Ê»olunga: kili melomelo
ğŸ™ŒğŸ¾	kili melomelo-Ê»uliÊ»uli, ongo nima hiki ki Ê»olunga, ongo nima hiki ki Ê»olunga: kili melomelo-Ê»uliÊ»uli
ğŸ™ŒğŸ¿	kili Ê»uliÊ»uli, ongo nima hiki ki Ê»olunga, ongo nima hiki ki Ê»olunga: kili Ê»uliÊ»uli
ğŸ‘	nima homo
ğŸ‘ğŸ»	kili hinehina, nima homo, nima homo: kili hinehina
ğŸ‘ğŸ¼	kili kelokelo, nima homo, nima homo: kili kelokelo
ğŸ‘ğŸ½	kili melomelo, nima homo, nima homo: kili melomelo
ğŸ‘ğŸ¾	kili melomelo-Ê»uliÊ»uli, nima homo, nima homo: kili melomelo-Ê»uliÊ»uli
ğŸ‘ğŸ¿	kili Ê»uliÊ»uli, nima homo, nima homo: kili Ê»uliÊ»uli
ğŸ¤²	ongo aofinima hiki ki Ê»olunga
ğŸ¤²ğŸ»	kili hinehina, ongo aofinima hiki ki Ê»olunga, ongo aofinima hiki ki Ê»olunga: kili hinehina
ğŸ¤²ğŸ¼	kili kelokelo, ongo aofinima hiki ki Ê»olunga, ongo aofinima hiki ki Ê»olunga: kili kelokelo
ğŸ¤²ğŸ½	kili melomelo, ongo aofinima hiki ki Ê»olunga, ongo aofinima hiki ki Ê»olunga: kili melomelo
ğŸ¤²ğŸ¾	kili melomelo-Ê»uliÊ»uli, ongo aofinima hiki ki Ê»olunga, ongo aofinima hiki ki Ê»olunga: kili melomelo-Ê»uliÊ»uli
ğŸ¤²ğŸ¿	kili Ê»uliÊ»uli, ongo aofinima hiki ki Ê»olunga, ongo aofinima hiki ki Ê»olunga: kili Ê»uliÊ»uli
ğŸ¤	lulululu
ğŸ™	ongo nima tataÊ»o
ğŸ™ğŸ»	kili hinehina, ongo nima tataÊ»o, ongo nima tataÊ»o: kili hinehina
ğŸ™ğŸ¼	kili kelokelo, ongo nima tataÊ»o, ongo nima tataÊ»o: kili kelokelo
ğŸ™ğŸ½	kili melomelo, ongo nima tataÊ»o, ongo nima tataÊ»o: kili melomelo
ğŸ™ğŸ¾	kili melomelo-Ê»uliÊ»uli, ongo nima tataÊ»o, ongo nima tataÊ»o: kili melomelo-Ê»uliÊ»uli
ğŸ™ğŸ¿	kili Ê»uliÊ»uli, ongo nima tataÊ»o, ongo nima tataÊ»o: kili Ê»uliÊ»uli
âœï¸	nima Ê»oku tohi
âœğŸ»	kili hinehina, nima Ê»oku tohi, nima Ê»oku tohi: kili hinehina
âœğŸ¼	kili kelokelo, nima Ê»oku tohi, nima Ê»oku tohi: kili kelokelo
âœğŸ½	kili melomelo, nima Ê»oku tohi, nima Ê»oku tohi: kili melomelo
âœğŸ¾	kili melomelo-Ê»uliÊ»uli, nima Ê»oku tohi, nima Ê»oku tohi: kili melomelo-Ê»uliÊ»uli
âœğŸ¿	kili Ê»uliÊ»uli, nima Ê»oku tohi, nima Ê»oku tohi: kili Ê»uliÊ»uli
ğŸ’…	valivali ngeÊ»esinima
ğŸ’…ğŸ»	kili hinehina, valivali ngeÊ»esinima, valivali ngeÊ»esinima: kili hinehina
ğŸ’…ğŸ¼	kili kelokelo, valivali ngeÊ»esinima, valivali ngeÊ»esinima: kili kelokelo
ğŸ’…ğŸ½	kili melomelo, valivali ngeÊ»esinima, valivali ngeÊ»esinima: kili melomelo
ğŸ’…ğŸ¾	kili melomelo-Ê»uliÊ»uli, valivali ngeÊ»esinima, valivali ngeÊ»esinima: kili melomelo-Ê»uliÊ»uli
ğŸ’…ğŸ¿	kili Ê»uliÊ»uli, valivali ngeÊ»esinima, valivali ngeÊ»esinima: kili Ê»uliÊ»uli
ğŸ¤³	faitaaÊ»i pÄ“ kita
ğŸ¤³ğŸ»	faitaaÊ»i pÄ“ kita, faitaaÊ»i pÄ“ kita: kili hinehina, kili hinehina
ğŸ¤³ğŸ¼	faitaaÊ»i pÄ“ kita, faitaaÊ»i pÄ“ kita: kili kelokelo, kili kelokelo
ğŸ¤³ğŸ½	faitaaÊ»i pÄ“ kita, faitaaÊ»i pÄ“ kita: kili melomelo, kili melomelo
ğŸ¤³ğŸ¾	faitaaÊ»i pÄ“ kita, faitaaÊ»i pÄ“ kita: kili melomelo-Ê»uliÊ»uli, kili melomelo-Ê»uliÊ»uli
ğŸ¤³ğŸ¿	faitaaÊ»i pÄ“ kita, faitaaÊ»i pÄ“ kita: kili Ê»uliÊ»uli, kili Ê»uliÊ»uli
ğŸ’ª	pÄpela Ê»oku pelu
ğŸ’ªğŸ»	kili hinehina, pÄpela Ê»oku pelu, pÄpela Ê»oku pelu: kili hinehina
ğŸ’ªğŸ¼	kili kelokelo, pÄpela Ê»oku pelu, pÄpela Ê»oku pelu: kili kelokelo
ğŸ’ªğŸ½	kili melomelo, pÄpela Ê»oku pelu, pÄpela Ê»oku pelu: kili melomelo
ğŸ’ªğŸ¾	kili melomelo-Ê»uliÊ»uli, pÄpela Ê»oku pelu, pÄpela Ê»oku pelu: kili melomelo-Ê»uliÊ»uli
ğŸ’ªğŸ¿	kili Ê»uliÊ»uli, pÄpela Ê»oku pelu, pÄpela Ê»oku pelu: kili Ê»uliÊ»uli
ğŸ¦µ	vaÊ»e
ğŸ¦µğŸ»	kili hinehina, vaÊ»e, vaÊ»e: kili hinehina
ğŸ¦µğŸ¼	kili kelokelo, vaÊ»e, vaÊ»e: kili kelokelo
ğŸ¦µğŸ½	kili melomelo, vaÊ»e, vaÊ»e: kili melomelo
ğŸ¦µğŸ¾	kili melomelo-Ê»uliÊ»uli, vaÊ»e, vaÊ»e: kili melomelo-Ê»uliÊ»uli
ğŸ¦µğŸ¿	kili Ê»uliÊ»uli, vaÊ»e, vaÊ»e: kili Ê»uliÊ»uli
ğŸ¦¶	lauÊ»ivaÊ»e
ğŸ¦¶ğŸ»	kili hinehina, lauÊ»ivaÊ»e, lauÊ»ivaÊ»e: kili hinehina
ğŸ¦¶ğŸ¼	kili kelokelo, lauÊ»ivaÊ»e, lauÊ»ivaÊ»e: kili kelokelo
ğŸ¦¶ğŸ½	kili melomelo, lauÊ»ivaÊ»e, lauÊ»ivaÊ»e: kili melomelo
ğŸ¦¶ğŸ¾	kili melomelo-Ê»uliÊ»uli, lauÊ»ivaÊ»e, lauÊ»ivaÊ»e: kili melomelo-Ê»uliÊ»uli
ğŸ¦¶ğŸ¿	kili Ê»uliÊ»uli, lauÊ»ivaÊ»e, lauÊ»ivaÊ»e: kili Ê»uliÊ»uli
ğŸ‘‚ï¸	telinga
ğŸ‘‚ğŸ»	kili hinehina, telinga, telinga: kili hinehina
ğŸ‘‚ğŸ¼	kili kelokelo, telinga, telinga: kili kelokelo
ğŸ‘‚ğŸ½	kili melomelo, telinga, telinga: kili melomelo
ğŸ‘‚ğŸ¾	kili melomelo-Ê»uliÊ»uli, telinga, telinga: kili melomelo-Ê»uliÊ»uli
ğŸ‘‚ğŸ¿	kili Ê»uliÊ»uli, telinga, telinga: kili Ê»uliÊ»uli
ğŸ‘ƒ	ihu
ğŸ‘ƒğŸ»	ihu, ihu: kili hinehina, kili hinehina
ğŸ‘ƒğŸ¼	ihu, ihu: kili kelokelo, kili kelokelo
ğŸ‘ƒğŸ½	ihu, ihu: kili melomelo, kili melomelo
ğŸ‘ƒğŸ¾	ihu, ihu: kili melomelo-Ê»uliÊ»uli, kili melomelo-Ê»uliÊ»uli
ğŸ‘ƒğŸ¿	ihu, ihu: kili Ê»uliÊ»uli, kili Ê»uliÊ»uli
ğŸ§ 	Ê»uto
ğŸ¦·	nifo
ğŸ¦´	hui
ğŸ‘€	ongo kanoÊ»imata
ğŸ‘ï¸	kanoÊ»imata
ğŸ‘…	Ê»elelo
ğŸ‘„	ngutu
ğŸ‘¶	valevale
ğŸ‘¶ğŸ»	kili hinehina, valevale, valevale: kili hinehina
ğŸ‘¶ğŸ¼	kili kelokelo, valevale, valevale: kili kelokelo
ğŸ‘¶ğŸ½	kili melomelo, valevale, valevale: kili melomelo
ğŸ‘¶ğŸ¾	kili melomelo-Ê»uliÊ»uli, valevale, valevale: kili melomelo-Ê»uliÊ»uli
ğŸ‘¶ğŸ¿	kili Ê»uliÊ»uli, valevale, valevale: kili Ê»uliÊ»uli
ğŸ§’	fÄnau
ğŸ§’ğŸ»	fÄnau, fÄnau: kili hinehina, kili hinehina
ğŸ§’ğŸ¼	fÄnau, fÄnau: kili kelokelo, kili kelokelo
ğŸ§’ğŸ½	fÄnau, fÄnau: kili melomelo, kili melomelo
ğŸ§’ğŸ¾	fÄnau, fÄnau: kili melomelo-Ê»uliÊ»uli, kili melomelo-Ê»uliÊ»uli
ğŸ§’ğŸ¿	fÄnau, fÄnau: kili Ê»uliÊ»uli, kili Ê»uliÊ»uli
ğŸ‘¦	tamasiÊ»i
ğŸ‘¦ğŸ»	kili hinehina, tamasiÊ»i, tamasiÊ»i: kili hinehina
ğŸ‘¦ğŸ¼	kili kelokelo, tamasiÊ»i, tamasiÊ»i: kili kelokelo
ğŸ‘¦ğŸ½	kili melomelo, tamasiÊ»i, tamasiÊ»i: kili melomelo
ğŸ‘¦ğŸ¾	kili melomelo-Ê»uliÊ»uli, tamasiÊ»i, tamasiÊ»i: kili melomelo-Ê»uliÊ»uli
ğŸ‘¦ğŸ¿	kili Ê»uliÊ»uli, tamasiÊ»i, tamasiÊ»i: kili Ê»uliÊ»uli
ğŸ‘§	taÊ»ahine
ğŸ‘§ğŸ»	kili hinehina, taÊ»ahine, taÊ»ahine: kili hinehina
ğŸ‘§ğŸ¼	kili kelokelo, taÊ»ahine, taÊ»ahine: kili kelokelo
ğŸ‘§ğŸ½	kili melomelo, taÊ»ahine, taÊ»ahine: kili melomelo
ğŸ‘§ğŸ¾	kili melomelo-Ê»uliÊ»uli, taÊ»ahine, taÊ»ahine: kili melomelo-Ê»uliÊ»uli
ğŸ‘§ğŸ¿	kili Ê»uliÊ»uli, taÊ»ahine, taÊ»ahine: kili Ê»uliÊ»uli
ğŸ§‘	kakai lalahi
ğŸ§‘ğŸ»	kakai lalahi, kakai lalahi: kili hinehina, kili hinehina
ğŸ§‘ğŸ¼	kakai lalahi, kakai lalahi: kili kelokelo, kili kelokelo
ğŸ§‘ğŸ½	kakai lalahi, kakai lalahi: kili melomelo, kili melomelo
ğŸ§‘ğŸ¾	kakai lalahi, kakai lalahi: kili melomelo-Ê»uliÊ»uli, kili melomelo-Ê»uliÊ»uli
ğŸ§‘ğŸ¿	kakai lalahi, kakai lalahi: kili Ê»uliÊ»uli, kili Ê»uliÊ»uli
ğŸ‘±	tokotaha Ê»ulu kelo
ğŸ‘±ğŸ»	kili hinehina, tokotaha Ê»ulu kelo, tokotaha Ê»ulu kelo: kili hinehina
ğŸ‘±ğŸ¼	kili kelokelo, tokotaha Ê»ulu kelo, tokotaha Ê»ulu kelo: kili kelokelo
ğŸ‘±ğŸ½	kili melomelo, tokotaha Ê»ulu kelo, tokotaha Ê»ulu kelo: kili melomelo
ğŸ‘±ğŸ¾	kili melomelo-Ê»uliÊ»uli, tokotaha Ê»ulu kelo, tokotaha Ê»ulu kelo: kili melomelo-Ê»uliÊ»uli
ğŸ‘±ğŸ¿	kili Ê»uliÊ»uli, tokotaha Ê»ulu kelo, tokotaha Ê»ulu kelo: kili Ê»uliÊ»uli
ğŸ‘¨	tangata
ğŸ‘¨ğŸ»	kili hinehina, tangata, tangata: kili hinehina
ğŸ‘¨ğŸ¼	kili kelokelo, tangata, tangata: kili kelokelo
ğŸ‘¨ğŸ½	kili melomelo, tangata, tangata: kili melomelo
ğŸ‘¨ğŸ¾	kili melomelo-Ê»uliÊ»uli, tangata, tangata: kili melomelo-Ê»uliÊ»uli
ğŸ‘¨ğŸ¿	kili Ê»uliÊ»uli, tangata, tangata: kili Ê»uliÊ»uli
ğŸ§”	tangata kava
ğŸ§”ğŸ»	kili hinehina, tangata kava, tangata kava: kili hinehina
ğŸ§”ğŸ¼	kili kelokelo, tangata kava, tangata kava: kili kelokelo
ğŸ§”ğŸ½	kili melomelo, tangata kava, tangata kava: kili melomelo
ğŸ§”ğŸ¾	kili melomelo-Ê»uliÊ»uli, tangata kava, tangata kava: kili melomelo-Ê»uliÊ»uli
ğŸ§”ğŸ¿	kili Ê»uliÊ»uli, tangata kava, tangata kava: kili Ê»uliÊ»uli
ğŸ‘±â€â™‚	tangata Ê»ulu kelo
ğŸ‘±ğŸ»â€â™‚	kili hinehina, tangata Ê»ulu kelo, tangata Ê»ulu kelo: kili hinehina
ğŸ‘±ğŸ¼â€â™‚	kili kelokelo, tangata Ê»ulu kelo, tangata Ê»ulu kelo: kili kelokelo
ğŸ‘±ğŸ½â€â™‚	kili melomelo, tangata Ê»ulu kelo, tangata Ê»ulu kelo: kili melomelo
ğŸ‘±ğŸ¾â€â™‚	kili melomelo-Ê»uliÊ»uli, tangata Ê»ulu kelo, tangata Ê»ulu kelo: kili melomelo-Ê»uliÊ»uli
ğŸ‘±ğŸ¿â€â™‚	kili Ê»uliÊ»uli, tangata Ê»ulu kelo, tangata Ê»ulu kelo: kili Ê»uliÊ»uli
ğŸ‘¨â€ğŸ¦°	tangata, tangata: Ê»ulu kulokula, Ê»ulu kulokula
ğŸ‘¨ğŸ»â€ğŸ¦°	kili hinehina, tangata, tangata: kili hinehina mo e Ê»ulu kulokula, Ê»ulu kulokula
ğŸ‘¨ğŸ¼â€ğŸ¦°	kili kelokelo, tangata, tangata: kili kelokelo mo e Ê»ulu kulokula, Ê»ulu kulokula
ğŸ‘¨ğŸ½â€ğŸ¦°	kili melomelo, tangata, tangata: kili melomelo mo e Ê»ulu kulokula, Ê»ulu kulokula
ğŸ‘¨ğŸ¾â€ğŸ¦°	kili melomelo-Ê»uliÊ»uli, tangata, tangata: kili melomelo-Ê»uliÊ»uli mo e Ê»ulu kulokula, Ê»ulu kulokula
ğŸ‘¨ğŸ¿â€ğŸ¦°	kili Ê»uliÊ»uli, tangata, tangata: kili Ê»uliÊ»uli mo e Ê»ulu kulokula, Ê»ulu kulokula
ğŸ‘¨â€ğŸ¦±	tangata, tangata: Ê»ulu mingimingi, Ê»ulu mingimingi
ğŸ‘¨ğŸ»â€ğŸ¦±	kili hinehina, tangata, tangata: kili hinehina mo e Ê»ulu mingimingi, Ê»ulu mingimingi
ğŸ‘¨ğŸ¼â€ğŸ¦±	kili kelokelo, tangata, tangata: kili kelokelo mo e Ê»ulu mingimingi, Ê»ulu mingimingi
ğŸ‘¨ğŸ½â€ğŸ¦±	kili melomelo, tangata, tangata: kili melomelo mo e Ê»ulu mingimingi, Ê»ulu mingimingi
ğŸ‘¨ğŸ¾â€ğŸ¦±	kili melomelo-Ê»uliÊ»uli, tangata, tangata: kili melomelo-Ê»uliÊ»uli mo e Ê»ulu mingimingi, Ê»ulu mingimingi
ğŸ‘¨ğŸ¿â€ğŸ¦±	kili Ê»uliÊ»uli, tangata, tangata: kili Ê»uliÊ»uli mo e Ê»ulu mingimingi, Ê»ulu mingimingi
ğŸ‘¨â€ğŸ¦³	tangata, tangata: Ê»ulu hinÄ, Ê»ulu hinÄ
ğŸ‘¨ğŸ»â€ğŸ¦³	kili hinehina, tangata, tangata: kili hinehina mo e Ê»ulu hinÄ, Ê»ulu hinÄ
ğŸ‘¨ğŸ¼â€ğŸ¦³	kili kelokelo, tangata, tangata: kili kelokelo mo e Ê»ulu hinÄ, Ê»ulu hinÄ
ğŸ‘¨ğŸ½â€ğŸ¦³	kili melomelo, tangata, tangata: kili melomelo mo e Ê»ulu hinÄ, Ê»ulu hinÄ
ğŸ‘¨ğŸ¾â€ğŸ¦³	kili melomelo-Ê»uliÊ»uli, tangata, tangata: kili melomelo-Ê»uliÊ»uli mo e Ê»ulu hinÄ, Ê»ulu hinÄ
ğŸ‘¨ğŸ¿â€ğŸ¦³	kili Ê»uliÊ»uli, tangata, tangata: kili Ê»uliÊ»uli mo e Ê»ulu hinÄ, Ê»ulu hinÄ
ğŸ‘¨â€ğŸ¦²	tangata, tangata: Ê»ulu tula, Ê»ulu tula
ğŸ‘¨ğŸ»â€ğŸ¦²	kili hinehina, tangata, tangata: kili hinehina mo e Ê»ulu tula, Ê»ulu tula
ğŸ‘¨ğŸ¼â€ğŸ¦²	kili kelokelo, tangata, tangata: kili kelokelo mo e Ê»ulu tula, Ê»ulu tula
ğŸ‘¨ğŸ½â€ğŸ¦²	kili melomelo, tangata, tangata: kili melomelo mo e Ê»ulu tula, Ê»ulu tula
ğŸ‘¨ğŸ¾â€ğŸ¦²	kili melomelo-Ê»uliÊ»uli, tangata, tangata: kili melomelo-Ê»uliÊ»uli mo e Ê»ulu tula, Ê»ulu tula
ğŸ‘¨ğŸ¿â€ğŸ¦²	kili Ê»uliÊ»uli, tangata, tangata: kili Ê»uliÊ»uli mo e Ê»ulu tula, Ê»ulu tula
ğŸ‘©	fefine
ğŸ‘©ğŸ»	fefine, fefine: kili hinehina, kili hinehina
ğŸ‘©ğŸ¼	fefine, fefine: kili kelokelo, kili kelokelo
ğŸ‘©ğŸ½	fefine, fefine: kili melomelo, kili melomelo
ğŸ‘©ğŸ¾	fefine, fefine: kili melomelo-Ê»uliÊ»uli, kili melomelo-Ê»uliÊ»uli
ğŸ‘©ğŸ¿	fefine, fefine: kili Ê»uliÊ»uli, kili Ê»uliÊ»uli
ğŸ‘±â€â™€	fefine Ê»ulu kelo
ğŸ‘±ğŸ»â€â™€	fefine Ê»ulu kelo, fefine Ê»ulu kelo: kili hinehina, kili hinehina
ğŸ‘±ğŸ¼â€â™€	fefine Ê»ulu kelo, fefine Ê»ulu kelo: kili kelokelo, kili kelokelo
ğŸ‘±ğŸ½â€â™€	fefine Ê»ulu kelo, fefine Ê»ulu kelo: kili melomelo, kili melomelo
ğŸ‘±ğŸ¾â€â™€	fefine Ê»ulu kelo, fefine Ê»ulu kelo: kili melomelo-Ê»uliÊ»uli, kili melomelo-Ê»uliÊ»uli
ğŸ‘±ğŸ¿â€â™€	fefine Ê»ulu kelo, fefine Ê»ulu kelo: kili Ê»uliÊ»uli, kili Ê»uliÊ»uli
ğŸ‘©â€ğŸ¦°	fefine, fefine: Ê»ulu kulokula, Ê»ulu kulokula
ğŸ‘©ğŸ»â€ğŸ¦°	fefine, fefine: kili hinehina mo e Ê»ulu kulokula, kili hinehina, Ê»ulu kulokula
ğŸ‘©ğŸ¼â€ğŸ¦°	fefine, fefine: kili kelokelo mo e Ê»ulu kulokula, kili kelokelo, Ê»ulu kulokula
ğŸ‘©ğŸ½â€ğŸ¦°	fefine, fefine: kili melomelo mo e Ê»ulu kulokula, kili melomelo, Ê»ulu kulokula
ğŸ‘©ğŸ¾â€ğŸ¦°	fefine, fefine: kili melomelo-Ê»uliÊ»uli mo e Ê»ulu kulokula, kili melomelo-Ê»uliÊ»uli, Ê»ulu kulokula
ğŸ‘©ğŸ¿â€ğŸ¦°	fefine, fefine: kili Ê»uliÊ»uli mo e Ê»ulu kulokula, kili Ê»uliÊ»uli, Ê»ulu kulokula
ğŸ‘©â€ğŸ¦±	fefine, fefine: Ê»ulu mingimingi, Ê»ulu mingimingi
ğŸ‘©ğŸ»â€ğŸ¦±	fefine, fefine: kili hinehina mo e Ê»ulu mingimingi, kili hinehina, Ê»ulu mingimingi
ğŸ‘©ğŸ¼â€ğŸ¦±	fefine, fefine: kili kelokelo mo e Ê»ulu mingimingi, kili kelokelo, Ê»ulu mingimingi
ğŸ‘©ğŸ½â€ğŸ¦±	fefine, fefine: kili melomelo mo e Ê»ulu mingimingi, kili melomelo, Ê»ulu mingimingi
ğŸ‘©ğŸ¾â€ğŸ¦±	fefine, fefine: kili melomelo-Ê»uliÊ»uli mo e Ê»ulu mingimingi, kili melomelo-Ê»uliÊ»uli, Ê»ulu mingimingi
ğŸ‘©ğŸ¿â€ğŸ¦±	fefine, fefine: kili Ê»uliÊ»uli mo e Ê»ulu mingimingi, kili Ê»uliÊ»uli, Ê»ulu mingimingi
ğŸ‘©â€ğŸ¦³	fefine, fefine: Ê»ulu hinÄ, Ê»ulu hinÄ
ğŸ‘©ğŸ»â€ğŸ¦³	fefine, fefine: kili hinehina mo e Ê»ulu hinÄ, kili hinehina, Ê»ulu hinÄ
ğŸ‘©ğŸ¼â€ğŸ¦³	fefine, fefine: kili kelokelo mo e Ê»ulu hinÄ, kili kelokelo, Ê»ulu hinÄ
ğŸ‘©ğŸ½â€ğŸ¦³	fefine, fefine: kili melomelo mo e Ê»ulu hinÄ, kili melomelo, Ê»ulu hinÄ
ğŸ‘©ğŸ¾â€ğŸ¦³	fefine, fefine: kili melomelo-Ê»uliÊ»uli mo e Ê»ulu hinÄ, kili melomelo-Ê»uliÊ»uli, Ê»ulu hinÄ
ğŸ‘©ğŸ¿â€ğŸ¦³	fefine, fefine: kili Ê»uliÊ»uli mo e Ê»ulu hinÄ, kili Ê»uliÊ»uli, Ê»ulu hinÄ
ğŸ‘©â€ğŸ¦²	fefine, fefine: Ê»ulu tula, Ê»ulu tula
ğŸ‘©ğŸ»â€ğŸ¦²	fefine, fefine: kili hinehina mo e Ê»ulu tula, kili hinehina, Ê»ulu tula
ğŸ‘©ğŸ¼â€ğŸ¦²	fefine, fefine: kili kelokelo mo e Ê»ulu tula, kili kelokelo, Ê»ulu tula
ğŸ‘©ğŸ½â€ğŸ¦²	fefine, fefine: kili melomelo mo e Ê»ulu tula, kili melomelo, Ê»ulu tula
ğŸ‘©ğŸ¾â€ğŸ¦²	fefine, fefine: kili melomelo-Ê»uliÊ»uli mo e Ê»ulu tula, kili melomelo-Ê»uliÊ»uli, Ê»ulu tula
ğŸ‘©ğŸ¿â€ğŸ¦²	fefine, fefine: kili Ê»uliÊ»uli mo e Ê»ulu tula, kili Ê»uliÊ»uli, Ê»ulu tula
ğŸ§“	tokotaha motuÊ»a
ğŸ§“ğŸ»	kili hinehina, tokotaha motuÊ»a, tokotaha motuÊ»a: kili hinehina
ğŸ§“ğŸ¼	kili kelokelo, tokotaha motuÊ»a, tokotaha motuÊ»a: kili kelokelo
ğŸ§“ğŸ½	kili melomelo, tokotaha motuÊ»a, tokotaha motuÊ»a: kili melomelo
ğŸ§“ğŸ¾	kili melomelo-Ê»uliÊ»uli, tokotaha motuÊ»a, tokotaha motuÊ»a: kili melomelo-Ê»uliÊ»uli
ğŸ§“ğŸ¿	kili Ê»uliÊ»uli, tokotaha motuÊ»a, tokotaha motuÊ»a: kili Ê»uliÊ»uli
ğŸ‘´	motuÊ»a
ğŸ‘´ğŸ»	kili hinehina, motuÊ»a, motuÊ»a: kili hinehina
ğŸ‘´ğŸ¼	kili kelokelo, motuÊ»a, motuÊ»a: kili kelokelo
ğŸ‘´ğŸ½	kili melomelo, motuÊ»a, motuÊ»a: kili melomelo
ğŸ‘´ğŸ¾	kili melomelo-Ê»uliÊ»uli, motuÊ»a, motuÊ»a: kili melomelo-Ê»uliÊ»uli
ğŸ‘´ğŸ¿	kili Ê»uliÊ»uli, motuÊ»a, motuÊ»a: kili Ê»uliÊ»uli
ğŸ‘µ	finemotuÊ»a
ğŸ‘µğŸ»	finemotuÊ»a, finemotuÊ»a: kili hinehina, kili hinehina
ğŸ‘µğŸ¼	finemotuÊ»a, finemotuÊ»a: kili kelokelo, kili kelokelo
ğŸ‘µğŸ½	finemotuÊ»a, finemotuÊ»a: kili melomelo, kili melomelo
ğŸ‘µğŸ¾	finemotuÊ»a, finemotuÊ»a: kili melomelo-Ê»uliÊ»uli, kili melomelo-Ê»uliÊ»uli
ğŸ‘µğŸ¿	finemotuÊ»a, finemotuÊ»a: kili Ê»uliÊ»uli, kili Ê»uliÊ»uli
ğŸ™	tokotaha matamamahi
ğŸ™ğŸ»	kili hinehina, tokotaha matamamahi, tokotaha matamamahi: kili hinehina
ğŸ™ğŸ¼	kili kelokelo, tokotaha matamamahi, tokotaha matamamahi: kili kelokelo
ğŸ™ğŸ½	kili melomelo, tokotaha matamamahi, tokotaha matamamahi: kili melomelo
ğŸ™ğŸ¾	kili melomelo-Ê»uliÊ»uli, tokotaha matamamahi, tokotaha matamamahi: kili melomelo-Ê»uliÊ»uli
ğŸ™ğŸ¿	kili Ê»uliÊ»uli, tokotaha matamamahi, tokotaha matamamahi: kili Ê»uliÊ»uli
ğŸ™â€â™‚	tangata matamamahi
ğŸ™ğŸ»â€â™‚	kili hinehina, tangata matamamahi, tangata matamamahi: kili hinehina
ğŸ™ğŸ¼â€â™‚	kili kelokelo, tangata matamamahi, tangata matamamahi: kili kelokelo
ğŸ™ğŸ½â€â™‚	kili melomelo, tangata matamamahi, tangata matamamahi: kili melomelo
ğŸ™ğŸ¾â€â™‚	kili melomelo-Ê»uliÊ»uli, tangata matamamahi, tangata matamamahi: kili melomelo-Ê»uliÊ»uli
ğŸ™ğŸ¿â€â™‚	kili Ê»uliÊ»uli, tangata matamamahi, tangata matamamahi: kili Ê»uliÊ»uli
ğŸ™â€â™€	fefine matamamahi
ğŸ™ğŸ»â€â™€	fefine matamamahi, fefine matamamahi: kili hinehina, kili hinehina
ğŸ™ğŸ¼â€â™€	fefine matamamahi, fefine matamamahi: kili kelokelo, kili kelokelo
ğŸ™ğŸ½â€â™€	fefine matamamahi, fefine matamamahi: kili melomelo, kili melomelo
ğŸ™ğŸ¾â€â™€	fefine matamamahi, fefine matamamahi: kili melomelo-Ê»uliÊ»uli, kili melomelo-Ê»uliÊ»uli
ğŸ™ğŸ¿â€â™€	fefine matamamahi, fefine matamamahi: kili Ê»uliÊ»uli, kili Ê»uliÊ»uli
ğŸ™	tokotaha mataÊ»ita
ğŸ™ğŸ»	kili hinehina, tokotaha mataÊ»ita, tokotaha mataÊ»ita: kili hinehina
ğŸ™ğŸ¼	kili kelokelo, tokotaha mataÊ»ita, tokotaha mataÊ»ita: kili kelokelo
ğŸ™ğŸ½	kili melomelo, tokotaha mataÊ»ita, tokotaha mataÊ»ita: kili melomelo
ğŸ™ğŸ¾	kili melomelo-Ê»uliÊ»uli, tokotaha mataÊ»ita, tokotaha mataÊ»ita: kili melomelo-Ê»uliÊ»uli
ğŸ™ğŸ¿	kili Ê»uliÊ»uli, tokotaha mataÊ»ita, tokotaha mataÊ»ita: kili Ê»uliÊ»uli
ğŸ™â€â™‚	tangata mataÊ»ita
ğŸ™ğŸ»â€â™‚	kili hinehina, tangata mataÊ»ita, tangata mataÊ»ita: kili hinehina
ğŸ™ğŸ¼â€â™‚	kili kelokelo, tangata mataÊ»ita, tangata mataÊ»ita: kili kelokelo
ğŸ™ğŸ½â€â™‚	kili melomelo, tangata mataÊ»ita, tangata mataÊ»ita: kili melomelo
ğŸ™ğŸ¾â€â™‚	kili melomelo-Ê»uliÊ»uli, tangata mataÊ»ita, tangata mataÊ»ita: kili melomelo-Ê»uliÊ»uli
ğŸ™ğŸ¿â€â™‚	kili Ê»uliÊ»uli, tangata mataÊ»ita, tangata mataÊ»ita: kili Ê»uliÊ»uli
ğŸ™â€â™€	fefine mataÊ»ita
ğŸ™ğŸ»â€â™€	fefine mataÊ»ita, fefine mataÊ»ita: kili hinehina, kili hinehina
ğŸ™ğŸ¼â€â™€	fefine mataÊ»ita, fefine mataÊ»ita: kili kelokelo, kili kelokelo
ğŸ™ğŸ½â€â™€	fefine mataÊ»ita, fefine mataÊ»ita: kili melomelo, kili melomelo
ğŸ™ğŸ¾â€â™€	fefine mataÊ»ita, fefine mataÊ»ita: kili melomelo-Ê»uliÊ»uli, kili melomelo-Ê»uliÊ»uli
ğŸ™ğŸ¿â€â™€	fefine mataÊ»ita, fefine mataÊ»ita: kili Ê»uliÊ»uli, kili Ê»uliÊ»uli
ğŸ™…	tokotaha kaunima fetuiaki
ğŸ™…ğŸ»	kili hinehina, tokotaha kaunima fetuiaki, tokotaha kaunima fetuiaki: kili hinehina
ğŸ™…ğŸ¼	kili kelokelo, tokotaha kaunima fetuiaki, tokotaha kaunima fetuiaki: kili kelokelo
ğŸ™…ğŸ½	kili melomelo, tokotaha kaunima fetuiaki, tokotaha kaunima fetuiaki: kili melomelo
ğŸ™…ğŸ¾	kili melomelo-Ê»uliÊ»uli, tokotaha kaunima fetuiaki, tokotaha kaunima fetuiaki: kili melomelo-Ê»uliÊ»uli
ğŸ™…ğŸ¿	kili Ê»uliÊ»uli, tokotaha kaunima fetuiaki, tokotaha kaunima fetuiaki: kili Ê»uliÊ»uli
ğŸ™…â€â™‚	tangata kaunima fetuiaki
ğŸ™…ğŸ»â€â™‚	kili hinehina, tangata kaunima fetuiaki, tangata kaunima fetuiaki: kili hinehina
ğŸ™…ğŸ¼â€â™‚	kili kelokelo, tangata kaunima fetuiaki, tangata kaunima fetuiaki: kili kelokelo
ğŸ™…ğŸ½â€â™‚	kili melomelo, tangata kaunima fetuiaki, tangata kaunima fetuiaki: kili melomelo
ğŸ™…ğŸ¾â€â™‚	kili melomelo-Ê»uliÊ»uli, tangata kaunima fetuiaki, tangata kaunima fetuiaki: kili melomelo-Ê»uliÊ»uli
ğŸ™…ğŸ¿â€â™‚	kili Ê»uliÊ»uli, tangata kaunima fetuiaki, tangata kaunima fetuiaki: kili Ê»uliÊ»uli
ğŸ™…â€â™€	fefine kaunima fetuiaki
ğŸ™…ğŸ»â€â™€	fefine kaunima fetuiaki, fefine kaunima fetuiaki: kili hinehina, kili hinehina
ğŸ™…ğŸ¼â€â™€	fefine kaunima fetuiaki, fefine kaunima fetuiaki: kili kelokelo, kili kelokelo
ğŸ™…ğŸ½â€â™€	fefine kaunima fetuiaki, fefine kaunima fetuiaki: kili melomelo, kili melomelo
ğŸ™…ğŸ¾â€â™€	fefine kaunima fetuiaki, fefine kaunima fetuiaki: kili melomelo-Ê»uliÊ»uli, kili melomelo-Ê»uliÊ»uli
ğŸ™…ğŸ¿â€â™€	fefine kaunima fetuiaki, fefine kaunima fetuiaki: kili Ê»uliÊ»uli, kili Ê»uliÊ»uli
ğŸ™†	tokotaha kaunima fetuiaki Ê»olunga
ğŸ™†ğŸ»	kili hinehina, tokotaha kaunima fetuiaki Ê»olunga, tokotaha kaunima fetuiaki Ê»olunga: kili hinehina
ğŸ™†ğŸ¼	kili kelokelo, tokotaha kaunima fetuiaki Ê»olunga, tokotaha kaunima fetuiaki Ê»olunga: kili kelokelo
ğŸ™†ğŸ½	kili melomelo, tokotaha kaunima fetuiaki Ê»olunga, tokotaha kaunima fetuiaki Ê»olunga: kili melomelo
ğŸ™†ğŸ¾	kili melomelo-Ê»uliÊ»uli, tokotaha kaunima fetuiaki Ê»olunga, tokotaha kaunima fetuiaki Ê»olunga: kili melomelo-Ê»uliÊ»uli
ğŸ™†ğŸ¿	kili Ê»uliÊ»uli, tokotaha kaunima fetuiaki Ê»olunga, tokotaha kaunima fetuiaki Ê»olunga: kili Ê»uliÊ»uli
ğŸ™†â€â™‚	tangata kaunima fetuiaki Ê»olunga
ğŸ™†ğŸ»â€â™‚	kili hinehina, tangata kaunima fetuiaki Ê»olunga, tangata kaunima fetuiaki Ê»olunga: kili hinehina
ğŸ™†ğŸ¼â€â™‚	kili kelokelo, tangata kaunima fetuiaki Ê»olunga, tangata kaunima fetuiaki Ê»olunga: kili kelokelo
ğŸ™†ğŸ½â€â™‚	kili melomelo, tangata kaunima fetuiaki Ê»olunga, tangata kaunima fetuiaki Ê»olunga: kili melomelo
ğŸ™†ğŸ¾â€â™‚	kili melomelo-Ê»uliÊ»uli, tangata kaunima fetuiaki Ê»olunga, tangata kaunima fetuiaki Ê»olunga: kili melomelo-Ê»uliÊ»uli
ğŸ™†ğŸ¿â€â™‚	kili Ê»uliÊ»uli, tangata kaunima fetuiaki Ê»olunga, tangata kaunima fetuiaki Ê»olunga: kili Ê»uliÊ»uli
ğŸ™†â€â™€	fefine kaunima fetuiaki Ê»olunga
ğŸ™†ğŸ»â€â™€	fefine kaunima fetuiaki Ê»olunga, fefine kaunima fetuiaki Ê»olunga: kili hinehina, kili hinehina
ğŸ™†ğŸ¼â€â™€	fefine kaunima fetuiaki Ê»olunga, fefine kaunima fetuiaki Ê»olunga: kili kelokelo, kili kelokelo
ğŸ™†ğŸ½â€â™€	fefine kaunima fetuiaki Ê»olunga, fefine kaunima fetuiaki Ê»olunga: kili melomelo, kili melomelo
ğŸ™†ğŸ¾â€â™€	fefine kaunima fetuiaki Ê»olunga, fefine kaunima fetuiaki Ê»olunga: kili melomelo-Ê»uliÊ»uli, kili melomelo-Ê»uliÊ»uli
ğŸ™†ğŸ¿â€â™€	fefine kaunima fetuiaki Ê»olunga, fefine kaunima fetuiaki Ê»olunga: kili Ê»uliÊ»uli, kili Ê»uliÊ»uli
ğŸ’	tokotaha nima mafola
ğŸ’ğŸ»	kili hinehina, tokotaha nima mafola, tokotaha nima mafola: kili hinehina
ğŸ’ğŸ¼	kili kelokelo, tokotaha nima mafola, tokotaha nima mafola: kili kelokelo
ğŸ’ğŸ½	kili melomelo, tokotaha nima mafola, tokotaha nima mafola: kili melomelo
ğŸ’ğŸ¾	kili melomelo-Ê»uliÊ»uli, tokotaha nima mafola, tokotaha nima mafola: kili melomelo-Ê»uliÊ»uli
ğŸ’ğŸ¿	kili Ê»uliÊ»uli, tokotaha nima mafola, tokotaha nima mafola: kili Ê»uliÊ»uli
ğŸ’â€â™‚	tangata nima mafola
ğŸ’ğŸ»â€â™‚	kili hinehina, tangata nima mafola, tangata nima mafola: kili hinehina
ğŸ’ğŸ¼â€â™‚	kili kelokelo, tangata nima mafola, tangata nima mafola: kili kelokelo
ğŸ’ğŸ½â€â™‚	kili melomelo, tangata nima mafola, tangata nima mafola: kili melomelo
ğŸ’ğŸ¾â€â™‚	kili melomelo-Ê»uliÊ»uli, tangata nima mafola, tangata nima mafola: kili melomelo-Ê»uliÊ»uli
ğŸ’ğŸ¿â€â™‚	kili Ê»uliÊ»uli, tangata nima mafola, tangata nima mafola: kili Ê»uliÊ»uli
ğŸ’â€â™€	fefine nima mafola
ğŸ’ğŸ»â€â™€	fefine nima mafola, fefine nima mafola: kili hinehina, kili hinehina
ğŸ’ğŸ¼â€â™€	fefine nima mafola, fefine nima mafola: kili kelokelo, kili kelokelo
ğŸ’ğŸ½â€â™€	fefine nima mafola, fefine nima mafola: kili melomelo, kili melomelo
ğŸ’ğŸ¾â€â™€	fefine nima mafola, fefine nima mafola: kili melomelo-Ê»uliÊ»uli, kili melomelo-Ê»uliÊ»uli
ğŸ’ğŸ¿â€â™€	fefine nima mafola, fefine nima mafola: kili Ê»uliÊ»uli, kili Ê»uliÊ»uli
ğŸ™‹	tokotaha nima Ê»i Ê»olunga
ğŸ™‹ğŸ»	kili hinehina, tokotaha nima Ê»i Ê»olunga, tokotaha nima Ê»i Ê»olunga: kili hinehina
ğŸ™‹ğŸ¼	kili kelokelo, tokotaha nima Ê»i Ê»olunga, tokotaha nima Ê»i Ê»olunga: kili kelokelo
ğŸ™‹ğŸ½	kili melomelo, tokotaha nima Ê»i Ê»olunga, tokotaha nima Ê»i Ê»olunga: kili melomelo
ğŸ™‹ğŸ¾	kili melomelo-Ê»uliÊ»uli, tokotaha nima Ê»i Ê»olunga, tokotaha nima Ê»i Ê»olunga: kili melomelo-Ê»uliÊ»uli
ğŸ™‹ğŸ¿	kili Ê»uliÊ»uli, tokotaha nima Ê»i Ê»olunga, tokotaha nima Ê»i Ê»olunga: kili Ê»uliÊ»uli
ğŸ™‹â€â™‚	tangata nima Ê»i Ê»olunga
ğŸ™‹ğŸ»â€â™‚	kili hinehina, tangata nima Ê»i Ê»olunga, tangata nima Ê»i Ê»olunga: kili hinehina
ğŸ™‹ğŸ¼â€â™‚	kili kelokelo, tangata nima Ê»i Ê»olunga, tangata nima Ê»i Ê»olunga: kili kelokelo
ğŸ™‹ğŸ½â€â™‚	kili melomelo, tangata nima Ê»i Ê»olunga, tangata nima Ê»i Ê»olunga: kili melomelo
ğŸ™‹ğŸ¾â€â™‚	kili melomelo-Ê»uliÊ»uli, tangata nima Ê»i Ê»olunga, tangata nima Ê»i Ê»olunga: kili melomelo-Ê»uliÊ»uli
ğŸ™‹ğŸ¿â€â™‚	kili Ê»uliÊ»uli, tangata nima Ê»i Ê»olunga, tangata nima Ê»i Ê»olunga: kili Ê»uliÊ»uli
ğŸ™‹â€â™€	fefine nima Ê»i Ê»olunga
ğŸ™‹ğŸ»â€â™€	fefine nima Ê»i Ê»olunga, fefine nima Ê»i Ê»olunga: kili hinehina, kili hinehina
ğŸ™‹ğŸ¼â€â™€	fefine nima Ê»i Ê»olunga, fefine nima Ê»i Ê»olunga: kili kelokelo, kili kelokelo
ğŸ™‹ğŸ½â€â™€	fefine nima Ê»i Ê»olunga, fefine nima Ê»i Ê»olunga: kili melomelo, kili melomelo
ğŸ™‹ğŸ¾â€â™€	fefine nima Ê»i Ê»olunga, fefine nima Ê»i Ê»olunga: kili melomelo-Ê»uliÊ»uli, kili melomelo-Ê»uliÊ»uli
ğŸ™‹ğŸ¿â€â™€	fefine nima Ê»i Ê»olunga, fefine nima Ê»i Ê»olunga: kili Ê»uliÊ»uli, kili Ê»uliÊ»uli
ğŸ™‡	tokotaha punou
ğŸ™‡ğŸ»	kili hinehina, tokotaha punou, tokotaha punou: kili hinehina
ğŸ™‡ğŸ¼	kili kelokelo, tokotaha punou, tokotaha punou: kili kelokelo
ğŸ™‡ğŸ½	kili melomelo, tokotaha punou, tokotaha punou: kili melomelo
ğŸ™‡ğŸ¾	kili melomelo-Ê»uliÊ»uli, tokotaha punou, tokotaha punou: kili melomelo-Ê»uliÊ»uli
ğŸ™‡ğŸ¿	kili Ê»uliÊ»uli, tokotaha punou, tokotaha punou: kili Ê»uliÊ»uli
ğŸ™‡â€â™‚	tangata punou
ğŸ™‡ğŸ»â€â™‚	kili hinehina, tangata punou, tangata punou: kili hinehina
ğŸ™‡ğŸ¼â€â™‚	kili kelokelo, tangata punou, tangata punou: kili kelokelo
ğŸ™‡ğŸ½â€â™‚	kili melomelo, tangata punou, tangata punou: kili melomelo
ğŸ™‡ğŸ¾â€â™‚	kili melomelo-Ê»uliÊ»uli, tangata punou, tangata punou: kili melomelo-Ê»uliÊ»uli
ğŸ™‡ğŸ¿â€â™‚	kili Ê»uliÊ»uli, tangata punou, tangata punou: kili Ê»uliÊ»uli
ğŸ™‡â€â™€	fefine punou
ğŸ™‡ğŸ»â€â™€	fefine punou, fefine punou: kili hinehina, kili hinehina
ğŸ™‡ğŸ¼â€â™€	fefine punou, fefine punou: kili kelokelo, kili kelokelo
ğŸ™‡ğŸ½â€â™€	fefine punou, fefine punou: kili melomelo, kili melomelo
ğŸ™‡ğŸ¾â€â™€	fefine punou, fefine punou: kili melomelo-Ê»uliÊ»uli, kili melomelo-Ê»uliÊ»uli
ğŸ™‡ğŸ¿â€â™€	fefine punou, fefine punou: kili Ê»uliÊ»uli, kili Ê»uliÊ»uli
ğŸ¤¦	tokotaha nima Ê»ihe mata
ğŸ¤¦ğŸ»	kili hinehina, tokotaha nima Ê»ihe mata, tokotaha nima Ê»ihe mata: kili hinehina
ğŸ¤¦ğŸ¼	kili kelokelo, tokotaha nima Ê»ihe mata, tokotaha nima Ê»ihe mata: kili kelokelo
ğŸ¤¦ğŸ½	kili melomelo, tokotaha nima Ê»ihe mata, tokotaha nima Ê»ihe mata: kili melomelo
ğŸ¤¦ğŸ¾	kili melomelo-Ê»uliÊ»uli, tokotaha nima Ê»ihe mata, tokotaha nima Ê»ihe mata: kili melomelo-Ê»uliÊ»uli
ğŸ¤¦ğŸ¿	kili Ê»uliÊ»uli, tokotaha nima Ê»ihe mata, tokotaha nima Ê»ihe mata: kili Ê»uliÊ»uli
ğŸ¤¦â€â™‚	tangata nima Ê»ihe mata
ğŸ¤¦ğŸ»â€â™‚	kili hinehina, tangata nima Ê»ihe mata, tangata nima Ê»ihe mata: kili hinehina
ğŸ¤¦ğŸ¼â€â™‚	kili kelokelo, tangata nima Ê»ihe mata, tangata nima Ê»ihe mata: kili kelokelo
ğŸ¤¦ğŸ½â€â™‚	kili melomelo, tangata nima Ê»ihe mata, tangata nima Ê»ihe mata: kili melomelo
ğŸ¤¦ğŸ¾â€â™‚	kili melomelo-Ê»uliÊ»uli, tangata nima Ê»ihe mata, tangata nima Ê»ihe mata: kili melomelo-Ê»uliÊ»uli
ğŸ¤¦ğŸ¿â€â™‚	kili Ê»uliÊ»uli, tangata nima Ê»ihe mata, tangata nima Ê»ihe mata: kili Ê»uliÊ»uli
ğŸ¤¦â€â™€	fefine nima Ê»ihe mata
ğŸ¤¦ğŸ»â€â™€	fefine nima Ê»ihe mata, fefine nima Ê»ihe mata: kili hinehina, kili hinehina
ğŸ¤¦ğŸ¼â€â™€	fefine nima Ê»ihe mata, fefine nima Ê»ihe mata: kili kelokelo, kili kelokelo
ğŸ¤¦ğŸ½â€â™€	fefine nima Ê»ihe mata, fefine nima Ê»ihe mata: kili melomelo, kili melomelo
ğŸ¤¦ğŸ¾â€â™€	fefine nima Ê»ihe mata, fefine nima Ê»ihe mata: kili melomelo-Ê»uliÊ»uli, kili melomelo-Ê»uliÊ»uli
ğŸ¤¦ğŸ¿â€â™€	fefine nima Ê»ihe mata, fefine nima Ê»ihe mata: kili Ê»uliÊ»uli, kili Ê»uliÊ»uli
ğŸ¤·	tokotaha fakamahiki
ğŸ¤·ğŸ»	kili hinehina, tokotaha fakamahiki, tokotaha fakamahiki: kili hinehina
ğŸ¤·ğŸ¼	kili kelokelo, tokotaha fakamahiki, tokotaha fakamahiki: kili kelokelo
ğŸ¤·ğŸ½	kili melomelo, tokotaha fakamahiki, tokotaha fakamahiki: kili melomelo
ğŸ¤·ğŸ¾	kili melomelo-Ê»uliÊ»uli, tokotaha fakamahiki, tokotaha fakamahiki: kili melomelo-Ê»uliÊ»uli
ğŸ¤·ğŸ¿	kili Ê»uliÊ»uli, tokotaha fakamahiki, tokotaha fakamahiki: kili Ê»uliÊ»uli
ğŸ¤·â€â™‚	tangata fakamahiki
ğŸ¤·ğŸ»â€â™‚	kili hinehina, tangata fakamahiki, tangata fakamahiki: kili hinehina
ğŸ¤·ğŸ¼â€â™‚	kili kelokelo, tangata fakamahiki, tangata fakamahiki: kili kelokelo
ğŸ¤·ğŸ½â€â™‚	kili melomelo, tangata fakamahiki, tangata fakamahiki: kili melomelo
ğŸ¤·ğŸ¾â€â™‚	kili melomelo-Ê»uliÊ»uli, tangata fakamahiki, tangata fakamahiki: kili melomelo-Ê»uliÊ»uli
ğŸ¤·ğŸ¿â€â™‚	kili Ê»uliÊ»uli, tangata fakamahiki, tangata fakamahiki: kili Ê»uliÊ»uli
ğŸ¤·â€â™€	fefine fakamahiki
ğŸ¤·ğŸ»â€â™€	fefine fakamahiki, fefine fakamahiki: kili hinehina, kili hinehina
ğŸ¤·ğŸ¼â€â™€	fefine fakamahiki, fefine fakamahiki: kili kelokelo, kili kelokelo
ğŸ¤·ğŸ½â€â™€	fefine fakamahiki, fefine fakamahiki: kili melomelo, kili melomelo
ğŸ¤·ğŸ¾â€â™€	fefine fakamahiki, fefine fakamahiki: kili melomelo-Ê»uliÊ»uli, kili melomelo-Ê»uliÊ»uli
ğŸ¤·ğŸ¿â€â™€	fefine fakamahiki, fefine fakamahiki: kili Ê»uliÊ»uli, kili Ê»uliÊ»uli
ğŸ‘¨â€âš•	neesi tangata
ğŸ‘¨ğŸ»â€âš•	kili hinehina, neesi tangata, neesi tangata: kili hinehina
ğŸ‘¨ğŸ¼â€âš•	kili kelokelo, neesi tangata, neesi tangata: kili kelokelo
ğŸ‘¨ğŸ½â€âš•	kili melomelo, neesi tangata, neesi tangata: kili melomelo
ğŸ‘¨ğŸ¾â€âš•	kili melomelo-Ê»uliÊ»uli, neesi tangata, neesi tangata: kili melomelo-Ê»uliÊ»uli
ğŸ‘¨ğŸ¿â€âš•	kili Ê»uliÊ»uli, neesi tangata, neesi tangata: kili Ê»uliÊ»uli
ğŸ‘©â€âš•	neesi fefine
ğŸ‘©ğŸ»â€âš•	kili hinehina, neesi fefine, neesi fefine: kili hinehina
ğŸ‘©ğŸ¼â€âš•	kili kelokelo, neesi fefine, neesi fefine: kili kelokelo
ğŸ‘©ğŸ½â€âš•	kili melomelo, neesi fefine, neesi fefine: kili melomelo
ğŸ‘©ğŸ¾â€âš•	kili melomelo-Ê»uliÊ»uli, neesi fefine, neesi fefine: kili melomelo-Ê»uliÊ»uli
ğŸ‘©ğŸ¿â€âš•	kili Ê»uliÊ»uli, neesi fefine, neesi fefine: kili Ê»uliÊ»uli
ğŸ‘¨â€ğŸ“	tamasiÊ»i ako
ğŸ‘¨ğŸ»â€ğŸ“	kili hinehina, tamasiÊ»i ako, tamasiÊ»i ako: kili hinehina
ğŸ‘¨ğŸ¼â€ğŸ“	kili kelokelo, tamasiÊ»i ako, tamasiÊ»i ako: kili kelokelo
ğŸ‘¨ğŸ½â€ğŸ“	kili melomelo, tamasiÊ»i ako, tamasiÊ»i ako: kili melomelo
ğŸ‘¨ğŸ¾â€ğŸ“	kili melomelo-Ê»uliÊ»uli, tamasiÊ»i ako, tamasiÊ»i ako: kili melomelo-Ê»uliÊ»uli
ğŸ‘¨ğŸ¿â€ğŸ“	kili Ê»uliÊ»uli, tamasiÊ»i ako, tamasiÊ»i ako: kili Ê»uliÊ»uli
ğŸ‘©â€ğŸ“	taÊ»ahine ako
ğŸ‘©ğŸ»â€ğŸ“	kili hinehina, taÊ»ahine ako, taÊ»ahine ako: kili hinehina
ğŸ‘©ğŸ¼â€ğŸ“	kili kelokelo, taÊ»ahine ako, taÊ»ahine ako: kili kelokelo
ğŸ‘©ğŸ½â€ğŸ“	kili melomelo, taÊ»ahine ako, taÊ»ahine ako: kili melomelo
ğŸ‘©ğŸ¾â€ğŸ“	kili melomelo-Ê»uliÊ»uli, taÊ»ahine ako, taÊ»ahine ako: kili melomelo-Ê»uliÊ»uli
ğŸ‘©ğŸ¿â€ğŸ“	kili Ê»uliÊ»uli, taÊ»ahine ako, taÊ»ahine ako: kili Ê»uliÊ»uli
ğŸ‘¨â€ğŸ«	faiako tangata
ğŸ‘¨ğŸ»â€ğŸ«	faiako tangata, faiako tangata: kili hinehina, kili hinehina
ğŸ‘¨ğŸ¼â€ğŸ«	faiako tangata, faiako tangata: kili kelokelo, kili kelokelo
ğŸ‘¨ğŸ½â€ğŸ«	faiako tangata, faiako tangata: kili melomelo, kili melomelo
ğŸ‘¨ğŸ¾â€ğŸ«	faiako tangata, faiako tangata: kili melomelo-Ê»uliÊ»uli, kili melomelo-Ê»uliÊ»uli
ğŸ‘¨ğŸ¿â€ğŸ«	faiako tangata, faiako tangata: kili Ê»uliÊ»uli, kili Ê»uliÊ»uli
ğŸ‘©â€ğŸ«	faiako fefine
ğŸ‘©ğŸ»â€ğŸ«	faiako fefine, faiako fefine: kili hinehina, kili hinehina
ğŸ‘©ğŸ¼â€ğŸ«	faiako fefine, faiako fefine: kili kelokelo, kili kelokelo
ğŸ‘©ğŸ½â€ğŸ«	faiako fefine, faiako fefine: kili melomelo, kili melomelo
ğŸ‘©ğŸ¾â€ğŸ«	faiako fefine, faiako fefine: kili melomelo-Ê»uliÊ»uli, kili melomelo-Ê»uliÊ»uli
ğŸ‘©ğŸ¿â€ğŸ«	faiako fefine, faiako fefine: kili Ê»uliÊ»uli, kili Ê»uliÊ»uli
ğŸ‘¨â€âš–	fakamaau tangata
ğŸ‘¨ğŸ»â€âš–	fakamaau tangata, fakamaau tangata: kili hinehina, kili hinehina
ğŸ‘¨ğŸ¼â€âš–	fakamaau tangata, fakamaau tangata: kili kelokelo, kili kelokelo
ğŸ‘¨ğŸ½â€âš–	fakamaau tangata, fakamaau tangata: kili melomelo, kili melomelo
ğŸ‘¨ğŸ¾â€âš–	fakamaau tangata, fakamaau tangata: kili melomelo-Ê»uliÊ»uli, kili melomelo-Ê»uliÊ»uli
ğŸ‘¨ğŸ¿â€âš–	fakamaau tangata, fakamaau tangata: kili Ê»uliÊ»uli, kili Ê»uliÊ»uli
ğŸ‘©â€âš–	fakamaau fefine
ğŸ‘©ğŸ»â€âš–	fakamaau fefine, fakamaau fefine: kili hinehina, kili hinehina
ğŸ‘©ğŸ¼â€âš–	fakamaau fefine, fakamaau fefine: kili kelokelo, kili kelokelo
ğŸ‘©ğŸ½â€âš–	fakamaau fefine, fakamaau fefine: kili melomelo, kili melomelo
ğŸ‘©ğŸ¾â€âš–	fakamaau fefine, fakamaau fefine: kili melomelo-Ê»uliÊ»uli, kili melomelo-Ê»uliÊ»uli
ğŸ‘©ğŸ¿â€âš–	fakamaau fefine, fakamaau fefine: kili Ê»uliÊ»uli, kili Ê»uliÊ»uli
ğŸ‘¨â€ğŸŒ¾	tangata ngoue
ğŸ‘¨ğŸ»â€ğŸŒ¾	kili hinehina, tangata ngoue, tangata ngoue: kili hinehina
ğŸ‘¨ğŸ¼â€ğŸŒ¾	kili kelokelo, tangata ngoue, tangata ngoue: kili kelokelo
ğŸ‘¨ğŸ½â€ğŸŒ¾	kili melomelo, tangata ngoue, tangata ngoue: kili melomelo
ğŸ‘¨ğŸ¾â€ğŸŒ¾	kili melomelo-Ê»uliÊ»uli, tangata ngoue, tangata ngoue: kili melomelo-Ê»uliÊ»uli
ğŸ‘¨ğŸ¿â€ğŸŒ¾	kili Ê»uliÊ»uli, tangata ngoue, tangata ngoue: kili Ê»uliÊ»uli
ğŸ‘©â€ğŸŒ¾	fefine ngoue
ğŸ‘©ğŸ»â€ğŸŒ¾	fefine ngoue, fefine ngoue: kili hinehina, kili hinehina
ğŸ‘©ğŸ¼â€ğŸŒ¾	fefine ngoue, fefine ngoue: kili kelokelo, kili kelokelo
ğŸ‘©ğŸ½â€ğŸŒ¾	fefine ngoue, fefine ngoue: kili melomelo, kili melomelo
ğŸ‘©ğŸ¾â€ğŸŒ¾	fefine ngoue, fefine ngoue: kili melomelo-Ê»uliÊ»uli, kili melomelo-Ê»uliÊ»uli
ğŸ‘©ğŸ¿â€ğŸŒ¾	fefine ngoue, fefine ngoue: kili Ê»uliÊ»uli, kili Ê»uliÊ»uli
ğŸ‘¨â€ğŸ³	tangata ngaohikai
ğŸ‘¨ğŸ»â€ğŸ³	kili hinehina, tangata ngaohikai, tangata ngaohikai: kili hinehina
ğŸ‘¨ğŸ¼â€ğŸ³	kili kelokelo, tangata ngaohikai, tangata ngaohikai: kili kelokelo
ğŸ‘¨ğŸ½â€ğŸ³	kili melomelo, tangata ngaohikai, tangata ngaohikai: kili melomelo
ğŸ‘¨ğŸ¾â€ğŸ³	kili melomelo-Ê»uliÊ»uli, tangata ngaohikai, tangata ngaohikai: kili melomelo-Ê»uliÊ»uli
ğŸ‘¨ğŸ¿â€ğŸ³	kili Ê»uliÊ»uli, tangata ngaohikai, tangata ngaohikai: kili Ê»uliÊ»uli
ğŸ‘©â€ğŸ³	fefine ngaohikai
ğŸ‘©ğŸ»â€ğŸ³	fefine ngaohikai, fefine ngaohikai: kili hinehina, kili hinehina
ğŸ‘©ğŸ¼â€ğŸ³	fefine ngaohikai, fefine ngaohikai: kili kelokelo, kili kelokelo
ğŸ‘©ğŸ½â€ğŸ³	fefine ngaohikai, fefine ngaohikai: kili melomelo, kili melomelo
ğŸ‘©ğŸ¾â€ğŸ³	fefine ngaohikai, fefine ngaohikai: kili melomelo-Ê»uliÊ»uli, kili melomelo-Ê»uliÊ»uli
ğŸ‘©ğŸ¿â€ğŸ³	fefine ngaohikai, fefine ngaohikai: kili Ê»uliÊ»uli, kili Ê»uliÊ»uli
ğŸ‘¨â€ğŸ”§	Ê»enisinia tangata
ğŸ‘¨ğŸ»â€ğŸ”§	kili hinehina, Ê»enisinia tangata, Ê»enisinia tangata: kili hinehina
ğŸ‘¨ğŸ¼â€ğŸ”§	kili kelokelo, Ê»enisinia tangata, Ê»enisinia tangata: kili kelokelo
ğŸ‘¨ğŸ½â€ğŸ”§	kili melomelo, Ê»enisinia tangata, Ê»enisinia tangata: kili melomelo
ğŸ‘¨ğŸ¾â€ğŸ”§	kili melomelo-Ê»uliÊ»uli, Ê»enisinia tangata, Ê»enisinia tangata: kili melomelo-Ê»uliÊ»uli
ğŸ‘¨ğŸ¿â€ğŸ”§	kili Ê»uliÊ»uli, Ê»enisinia tangata, Ê»enisinia tangata: kili Ê»uliÊ»uli
ğŸ‘©â€ğŸ”§	Ê»enisinia fefine
ğŸ‘©ğŸ»â€ğŸ”§	kili hinehina, Ê»enisinia fefine, Ê»enisinia fefine: kili hinehina
ğŸ‘©ğŸ¼â€ğŸ”§	kili kelokelo, Ê»enisinia fefine, Ê»enisinia fefine: kili kelokelo
ğŸ‘©ğŸ½â€ğŸ”§	kili melomelo, Ê»enisinia fefine, Ê»enisinia fefine: kili melomelo
ğŸ‘©ğŸ¾â€ğŸ”§	kili melomelo-Ê»uliÊ»uli, Ê»enisinia fefine, Ê»enisinia fefine: kili melomelo-Ê»uliÊ»uli
ğŸ‘©ğŸ¿â€ğŸ”§	kili Ê»uliÊ»uli, Ê»enisinia fefine, Ê»enisinia fefine: kili Ê»uliÊ»uli
ğŸ‘¨â€ğŸ­	tangata ngÄue fale faÊ»uÊ»anga
ğŸ‘¨ğŸ»â€ğŸ­	kili hinehina, tangata ngÄue fale faÊ»uÊ»anga, tangata ngÄue fale faÊ»uÊ»anga: kili hinehina
ğŸ‘¨ğŸ¼â€ğŸ­	kili kelokelo, tangata ngÄue fale faÊ»uÊ»anga, tangata ngÄue fale faÊ»uÊ»anga: kili kelokelo
ğŸ‘¨ğŸ½â€ğŸ­	kili melomelo, tangata ngÄue fale faÊ»uÊ»anga, tangata ngÄue fale faÊ»uÊ»anga: kili melomelo
ğŸ‘¨ğŸ¾â€ğŸ­	kili melomelo-Ê»uliÊ»uli, tangata ngÄue fale faÊ»uÊ»anga, tangata ngÄue fale faÊ»uÊ»anga: kili melomelo-Ê»uliÊ»uli
ğŸ‘¨ğŸ¿â€ğŸ­	kili Ê»uliÊ»uli, tangata ngÄue fale faÊ»uÊ»anga, tangata ngÄue fale faÊ»uÊ»anga: kili Ê»uliÊ»uli
ğŸ‘©â€ğŸ­	fefine ngÄue fale faÊ»uÊ»anga
ğŸ‘©ğŸ»â€ğŸ­	fefine ngÄue fale faÊ»uÊ»anga, fefine ngÄue fale faÊ»uÊ»anga: kili hinehina, kili hinehina
ğŸ‘©ğŸ¼â€ğŸ­	fefine ngÄue fale faÊ»uÊ»anga, fefine ngÄue fale faÊ»uÊ»anga: kili kelokelo, kili kelokelo
ğŸ‘©ğŸ½â€ğŸ­	fefine ngÄue fale faÊ»uÊ»anga, fefine ngÄue fale faÊ»uÊ»anga: kili melomelo, kili melomelo
ğŸ‘©ğŸ¾â€ğŸ­	fefine ngÄue fale faÊ»uÊ»anga, fefine ngÄue fale faÊ»uÊ»anga: kili melomelo-Ê»uliÊ»uli, kili melomelo-Ê»uliÊ»uli
ğŸ‘©ğŸ¿â€ğŸ­	fefine ngÄue fale faÊ»uÊ»anga, fefine ngÄue fale faÊ»uÊ»anga: kili Ê»uliÊ»uli, kili Ê»uliÊ»uli
ğŸ‘¨â€ğŸ’¼	tangata ngÄue Ê»Åfisi
ğŸ‘¨ğŸ»â€ğŸ’¼	kili hinehina, tangata ngÄue Ê»Åfisi, tangata ngÄue Ê»Åfisi: kili hinehina
ğŸ‘¨ğŸ¼â€ğŸ’¼	kili kelokelo, tangata ngÄue Ê»Åfisi, tangata ngÄue Ê»Åfisi: kili kelokelo
ğŸ‘¨ğŸ½â€ğŸ’¼	kili melomelo, tangata ngÄue Ê»Åfisi, tangata ngÄue Ê»Åfisi: kili melomelo
ğŸ‘¨ğŸ¾â€ğŸ’¼	kili melomelo-Ê»uliÊ»uli, tangata ngÄue Ê»Åfisi, tangata ngÄue Ê»Åfisi: kili melomelo-Ê»uliÊ»uli
ğŸ‘¨ğŸ¿â€ğŸ’¼	kili Ê»uliÊ»uli, tangata ngÄue Ê»Åfisi, tangata ngÄue Ê»Åfisi: kili Ê»uliÊ»uli
ğŸ‘©â€ğŸ’¼	fefine ngÄue Ê»Åfisi
ğŸ‘©ğŸ»â€ğŸ’¼	fefine ngÄue Ê»Åfisi, fefine ngÄue Ê»Åfisi: kili hinehina, kili hinehina
ğŸ‘©ğŸ¼â€ğŸ’¼	fefine ngÄue Ê»Åfisi, fefine ngÄue Ê»Åfisi: kili kelokelo, kili kelokelo
ğŸ‘©ğŸ½â€ğŸ’¼	fefine ngÄue Ê»Åfisi, fefine ngÄue Ê»Åfisi: kili melomelo, kili melomelo
ğŸ‘©ğŸ¾â€ğŸ’¼	fefine ngÄue Ê»Åfisi, fefine ngÄue Ê»Åfisi: kili melomelo-Ê»uliÊ»uli, kili melomelo-Ê»uliÊ»uli
ğŸ‘©ğŸ¿â€ğŸ’¼	fefine ngÄue Ê»Åfisi, fefine ngÄue Ê»Åfisi: kili Ê»uliÊ»uli, kili Ê»uliÊ»uli
ğŸ‘¨â€ğŸ”¬	tangata faisaienisi
ğŸ‘¨ğŸ»â€ğŸ”¬	kili hinehina, tangata faisaienisi, tangata faisaienisi: kili hinehina
ğŸ‘¨ğŸ¼â€ğŸ”¬	kili kelokelo, tangata faisaienisi, tangata faisaienisi: kili kelokelo
ğŸ‘¨ğŸ½â€ğŸ”¬	kili melomelo, tangata faisaienisi, tangata faisaienisi: kili melomelo
ğŸ‘¨ğŸ¾â€ğŸ”¬	kili melomelo-Ê»uliÊ»uli, tangata faisaienisi, tangata faisaienisi: kili melomelo-Ê»uliÊ»uli
ğŸ‘¨ğŸ¿â€ğŸ”¬	kili Ê»uliÊ»uli, tangata faisaienisi, tangata faisaienisi: kili Ê»uliÊ»uli
ğŸ‘©â€ğŸ”¬	fefine faisaienisi
ğŸ‘©ğŸ»â€ğŸ”¬	fefine faisaienisi, fefine faisaienisi: kili hinehina, kili hinehina
ğŸ‘©ğŸ¼â€ğŸ”¬	fefine faisaienisi, fefine faisaienisi: kili kelokelo, kili kelokelo
ğŸ‘©ğŸ½â€ğŸ”¬	fefine faisaienisi, fefine faisaienisi: kili melomelo, kili melomelo
ğŸ‘©ğŸ¾â€ğŸ”¬	fefine faisaienisi, fefine faisaienisi: kili melomelo-Ê»uliÊ»uli, kili melomelo-Ê»uliÊ»uli
ğŸ‘©ğŸ¿â€ğŸ”¬	fefine faisaienisi, fefine faisaienisi: kili Ê»uliÊ»uli, kili Ê»uliÊ»uli
ğŸ‘¨â€ğŸ’»	tangata fakatekinolosia
ğŸ‘¨ğŸ»â€ğŸ’»	kili hinehina, tangata fakatekinolosia, tangata fakatekinolosia: kili hinehina
ğŸ‘¨ğŸ¼â€ğŸ’»	kili kelokelo, tangata fakatekinolosia, tangata fakatekinolosia: kili kelokelo
ğŸ‘¨ğŸ½â€ğŸ’»	kili melomelo, tangata fakatekinolosia, tangata fakatekinolosia: kili melomelo
ğŸ‘¨ğŸ¾â€ğŸ’»	kili melomelo-Ê»uliÊ»uli, tangata fakatekinolosia, tangata fakatekinolosia: kili melomelo-Ê»uliÊ»uli
ğŸ‘¨ğŸ¿â€ğŸ’»	kili Ê»uliÊ»uli, tangata fakatekinolosia, tangata fakatekinolosia: kili Ê»uliÊ»uli
ğŸ‘©â€ğŸ’»	fefine fakatekinolosia
ğŸ‘©ğŸ»â€ğŸ’»	fefine fakatekinolosia, fefine fakatekinolosia: kili hinehina, kili hinehina
ğŸ‘©ğŸ¼â€ğŸ’»	fefine fakatekinolosia, fefine fakatekinolosia: kili kelokelo, kili kelokelo
ğŸ‘©ğŸ½â€ğŸ’»	fefine fakatekinolosia, fefine fakatekinolosia: kili melomelo, kili melomelo
ğŸ‘©ğŸ¾â€ğŸ’»	fefine fakatekinolosia, fefine fakatekinolosia: kili melomelo-Ê»uliÊ»uli, kili melomelo-Ê»uliÊ»uli
ğŸ‘©ğŸ¿â€ğŸ’»	fefine fakatekinolosia, fefine fakatekinolosia: kili Ê»uliÊ»uli, kili Ê»uliÊ»uli
ğŸ‘¨â€ğŸ¤	tangata hiva
ğŸ‘¨ğŸ»â€ğŸ¤	kili hinehina, tangata hiva, tangata hiva: kili hinehina
ğŸ‘¨ğŸ¼â€ğŸ¤	kili kelokelo, tangata hiva, tangata hiva: kili kelokelo
ğŸ‘¨ğŸ½â€ğŸ¤	kili melomelo, tangata hiva, tangata hiva: kili melomelo
ğŸ‘¨ğŸ¾â€ğŸ¤	kili melomelo-Ê»uliÊ»uli, tangata hiva, tangata hiva: kili melomelo-Ê»uliÊ»uli
ğŸ‘¨ğŸ¿â€ğŸ¤	kili Ê»uliÊ»uli, tangata hiva, tangata hiva: kili Ê»uliÊ»uli
ğŸ‘©â€ğŸ¤	fefine hiva
ğŸ‘©ğŸ»â€ğŸ¤	fefine hiva, fefine hiva: kili hinehina, kili hinehina
ğŸ‘©ğŸ¼â€ğŸ¤	fefine hiva, fefine hiva: kili kelokelo, kili kelokelo
ğŸ‘©ğŸ½â€ğŸ¤	fefine hiva, fefine hiva: kili melomelo, kili melomelo
ğŸ‘©ğŸ¾â€ğŸ¤	fefine hiva, fefine hiva: kili melomelo-Ê»uliÊ»uli, kili melomelo-Ê»uliÊ»uli
ğŸ‘©ğŸ¿â€ğŸ¤	fefine hiva, fefine hiva: kili Ê»uliÊ»uli, kili Ê»uliÊ»uli
ğŸ‘¨â€ğŸ¨	tangata tÄ-fakatÄtÄ
ğŸ‘¨ğŸ»â€ğŸ¨	kili hinehina, tangata tÄ-fakatÄtÄ, tangata tÄ-fakatÄtÄ: kili hinehina
ğŸ‘¨ğŸ¼â€ğŸ¨	kili kelokelo, tangata tÄ-fakatÄtÄ, tangata tÄ-fakatÄtÄ: kili kelokelo
ğŸ‘¨ğŸ½â€ğŸ¨	kili melomelo, tangata tÄ-fakatÄtÄ, tangata tÄ-fakatÄtÄ: kili melomelo
ğŸ‘¨ğŸ¾â€ğŸ¨	kili melomelo-Ê»uliÊ»uli, tangata tÄ-fakatÄtÄ, tangata tÄ-fakatÄtÄ: kili melomelo-Ê»uliÊ»uli
ğŸ‘¨ğŸ¿â€ğŸ¨	kili Ê»uliÊ»uli, tangata tÄ-fakatÄtÄ, tangata tÄ-fakatÄtÄ: kili Ê»uliÊ»uli
ğŸ‘©â€ğŸ¨	fefine tÄ-fakatÄtÄ
ğŸ‘©ğŸ»â€ğŸ¨	fefine tÄ-fakatÄtÄ, fefine tÄ-fakatÄtÄ: kili hinehina, kili hinehina
ğŸ‘©ğŸ¼â€ğŸ¨	fefine tÄ-fakatÄtÄ, fefine tÄ-fakatÄtÄ: kili kelokelo, kili kelokelo
ğŸ‘©ğŸ½â€ğŸ¨	fefine tÄ-fakatÄtÄ, fefine tÄ-fakatÄtÄ: kili melomelo, kili melomelo
ğŸ‘©ğŸ¾â€ğŸ¨	fefine tÄ-fakatÄtÄ, fefine tÄ-fakatÄtÄ: kili melomelo-Ê»uliÊ»uli, kili melomelo-Ê»uliÊ»uli
ğŸ‘©ğŸ¿â€ğŸ¨	fefine tÄ-fakatÄtÄ, fefine tÄ-fakatÄtÄ: kili Ê»uliÊ»uli, kili Ê»uliÊ»uli
ğŸ‘¨â€âœˆ	pailate tangata
ğŸ‘¨ğŸ»â€âœˆ	kili hinehina, pailate tangata, pailate tangata: kili hinehina
ğŸ‘¨ğŸ¼â€âœˆ	kili kelokelo, pailate tangata, pailate tangata: kili kelokelo
ğŸ‘¨ğŸ½â€âœˆ	kili melomelo, pailate tangata, pailate tangata: kili melomelo
ğŸ‘¨ğŸ¾â€âœˆ	kili melomelo-Ê»uliÊ»uli, pailate tangata, pailate tangata: kili melomelo-Ê»uliÊ»uli
ğŸ‘¨ğŸ¿â€âœˆ	kili Ê»uliÊ»uli, pailate tangata, pailate tangata: kili Ê»uliÊ»uli
ğŸ‘©â€âœˆ	pailate fefine
ğŸ‘©ğŸ»â€âœˆ	kili hinehina, pailate fefine, pailate fefine: kili hinehina
ğŸ‘©ğŸ¼â€âœˆ	kili kelokelo, pailate fefine, pailate fefine: kili kelokelo
ğŸ‘©ğŸ½â€âœˆ	kili melomelo, pailate fefine, pailate fefine: kili melomelo
ğŸ‘©ğŸ¾â€âœˆ	kili melomelo-Ê»uliÊ»uli, pailate fefine, pailate fefine: kili melomelo-Ê»uliÊ»uli
ğŸ‘©ğŸ¿â€âœˆ	kili Ê»uliÊ»uli, pailate fefine, pailate fefine: kili Ê»uliÊ»uli
ğŸ‘¨â€ğŸš€	tama folaufetuÊ»u
ğŸ‘¨ğŸ»â€ğŸš€	kili hinehina, tama folaufetuÊ»u, tama folaufetuÊ»u: kili hinehina
ğŸ‘¨ğŸ¼â€ğŸš€	kili kelokelo, tama folaufetuÊ»u, tama folaufetuÊ»u: kili kelokelo
ğŸ‘¨ğŸ½â€ğŸš€	kili melomelo, tama folaufetuÊ»u, tama folaufetuÊ»u: kili melomelo
ğŸ‘¨ğŸ¾â€ğŸš€	kili melomelo-Ê»uliÊ»uli, tama folaufetuÊ»u, tama folaufetuÊ»u: kili melomelo-Ê»uliÊ»uli
ğŸ‘¨ğŸ¿â€ğŸš€	kili Ê»uliÊ»uli, tama folaufetuÊ»u, tama folaufetuÊ»u: kili Ê»uliÊ»uli
ğŸ‘©â€ğŸš€	fefine folaufetuÊ»u
ğŸ‘©ğŸ»â€ğŸš€	fefine folaufetuÊ»u, fefine folaufetuÊ»u: kili hinehina, kili hinehina
ğŸ‘©ğŸ¼â€ğŸš€	fefine folaufetuÊ»u, fefine folaufetuÊ»u: kili kelokelo, kili kelokelo
ğŸ‘©ğŸ½â€ğŸš€	fefine folaufetuÊ»u, fefine folaufetuÊ»u: kili melomelo, kili melomelo
ğŸ‘©ğŸ¾â€ğŸš€	fefine folaufetuÊ»u, fefine folaufetuÊ»u: kili melomelo-Ê»uliÊ»uli, kili melomelo-Ê»uliÊ»uli
ğŸ‘©ğŸ¿â€ğŸš€	fefine folaufetuÊ»u, fefine folaufetuÊ»u: kili Ê»uliÊ»uli, kili Ê»uliÊ»uli
ğŸ‘¨â€ğŸš’	tangata tÄmate-afi
ğŸ‘¨ğŸ»â€ğŸš’	kili hinehina, tangata tÄmate-afi, tangata tÄmate-afi: kili hinehina
ğŸ‘¨ğŸ¼â€ğŸš’	kili kelokelo, tangata tÄmate-afi, tangata tÄmate-afi: kili kelokelo
ğŸ‘¨ğŸ½â€ğŸš’	kili melomelo, tangata tÄmate-afi, tangata tÄmate-afi: kili melomelo
ğŸ‘¨ğŸ¾â€ğŸš’	kili melomelo-Ê»uliÊ»uli, tangata tÄmate-afi, tangata tÄmate-afi: kili melomelo-Ê»uliÊ»uli
ğŸ‘¨ğŸ¿â€ğŸš’	kili Ê»uliÊ»uli, tangata tÄmate-afi, tangata tÄmate-afi: kili Ê»uliÊ»uli
ğŸ‘©â€ğŸš’	fefine tÄmate-afi
ğŸ‘©ğŸ»â€ğŸš’	fefine tÄmate-afi, fefine tÄmate-afi: kili hinehina, kili hinehina
ğŸ‘©ğŸ¼â€ğŸš’	fefine tÄmate-afi, fefine tÄmate-afi: kili kelokelo, kili kelokelo
ğŸ‘©ğŸ½â€ğŸš’	fefine tÄmate-afi, fefine tÄmate-afi: kili melomelo, kili melomelo
ğŸ‘©ğŸ¾â€ğŸš’	fefine tÄmate-afi, fefine tÄmate-afi: kili melomelo-Ê»uliÊ»uli, kili melomelo-Ê»uliÊ»uli
ğŸ‘©ğŸ¿â€ğŸš’	fefine tÄmate-afi, fefine tÄmate-afi: kili Ê»uliÊ»uli, kili Ê»uliÊ»uli
ğŸ‘®	Ê»ofisa polisi
ğŸ‘®ğŸ»	kili hinehina, Ê»ofisa polisi, Ê»ofisa polisi: kili hinehina
ğŸ‘®ğŸ¼	kili kelokelo, Ê»ofisa polisi, Ê»ofisa polisi: kili kelokelo
ğŸ‘®ğŸ½	kili melomelo, Ê»ofisa polisi, Ê»ofisa polisi: kili melomelo
ğŸ‘®ğŸ¾	kili melomelo-Ê»uliÊ»uli, Ê»ofisa polisi, Ê»ofisa polisi: kili melomelo-Ê»uliÊ»uli
ğŸ‘®ğŸ¿	kili Ê»uliÊ»uli, Ê»ofisa polisi, Ê»ofisa polisi: kili Ê»uliÊ»uli
ğŸ‘®â€â™‚	Ê»ofisa polisi tangata
ğŸ‘®ğŸ»â€â™‚	kili hinehina, Ê»ofisa polisi tangata, Ê»ofisa polisi tangata: kili hinehina
ğŸ‘®ğŸ¼â€â™‚	kili kelokelo, Ê»ofisa polisi tangata, Ê»ofisa polisi tangata: kili kelokelo
ğŸ‘®ğŸ½â€â™‚	kili melomelo, Ê»ofisa polisi tangata, Ê»ofisa polisi tangata: kili melomelo
ğŸ‘®ğŸ¾â€â™‚	kili melomelo-Ê»uliÊ»uli, Ê»ofisa polisi tangata, Ê»ofisa polisi tangata: kili melomelo-Ê»uliÊ»uli
ğŸ‘®ğŸ¿â€â™‚	kili Ê»uliÊ»uli, Ê»ofisa polisi tangata, Ê»ofisa polisi tangata: kili Ê»uliÊ»uli
ğŸ‘®â€â™€	Ê»ofisa polisi fefine
ğŸ‘®ğŸ»â€â™€	kili hinehina, Ê»ofisa polisi fefine, Ê»ofisa polisi fefine: kili hinehina
ğŸ‘®ğŸ¼â€â™€	kili kelokelo, Ê»ofisa polisi fefine, Ê»ofisa polisi fefine: kili kelokelo
ğŸ‘®ğŸ½â€â™€	kili melomelo, Ê»ofisa polisi fefine, Ê»ofisa polisi fefine: kili melomelo
ğŸ‘®ğŸ¾â€â™€	kili melomelo-Ê»uliÊ»uli, Ê»ofisa polisi fefine, Ê»ofisa polisi fefine: kili melomelo-Ê»uliÊ»uli
ğŸ‘®ğŸ¿â€â™€	kili Ê»uliÊ»uli, Ê»ofisa polisi fefine, Ê»ofisa polisi fefine: kili Ê»uliÊ»uli
ğŸ•µï¸	tokotaha fakatotolo
ğŸ•µğŸ»	kili hinehina, tokotaha fakatotolo, tokotaha fakatotolo: kili hinehina
ğŸ•µğŸ¼	kili kelokelo, tokotaha fakatotolo, tokotaha fakatotolo: kili kelokelo
ğŸ•µğŸ½	kili melomelo, tokotaha fakatotolo, tokotaha fakatotolo: kili melomelo
ğŸ•µğŸ¾	kili melomelo-Ê»uliÊ»uli, tokotaha fakatotolo, tokotaha fakatotolo: kili melomelo-Ê»uliÊ»uli
ğŸ•µğŸ¿	kili Ê»uliÊ»uli, tokotaha fakatotolo, tokotaha fakatotolo: kili Ê»uliÊ»uli
ğŸ•µâ€â™‚	tangata fakatotolo
ğŸ•µğŸ»â€â™‚	kili hinehina, tangata fakatotolo, tangata fakatotolo: kili hinehina
ğŸ•µğŸ¼â€â™‚	kili kelokelo, tangata fakatotolo, tangata fakatotolo: kili kelokelo
ğŸ•µğŸ½â€â™‚	kili melomelo, tangata fakatotolo, tangata fakatotolo: kili melomelo
ğŸ•µğŸ¾â€â™‚	kili melomelo-Ê»uliÊ»uli, tangata fakatotolo, tangata fakatotolo: kili melomelo-Ê»uliÊ»uli
ğŸ•µğŸ¿â€â™‚	kili Ê»uliÊ»uli, tangata fakatotolo, tangata fakatotolo: kili Ê»uliÊ»uli
ğŸ•µâ€â™€	fefine fakatotolo
ğŸ•µğŸ»â€â™€	fefine fakatotolo, fefine fakatotolo: kili hinehina, kili hinehina
ğŸ•µğŸ¼â€â™€	fefine fakatotolo, fefine fakatotolo: kili kelokelo, kili kelokelo
ğŸ•µğŸ½â€â™€	fefine fakatotolo, fefine fakatotolo: kili melomelo, kili melomelo
ğŸ•µğŸ¾â€â™€	fefine fakatotolo, fefine fakatotolo: kili melomelo-Ê»uliÊ»uli, kili melomelo-Ê»uliÊ»uli
ğŸ•µğŸ¿â€â™€	fefine fakatotolo, fefine fakatotolo: kili Ê»uliÊ»uli, kili Ê»uliÊ»uli
ğŸ’‚	leÊ»o
ğŸ’‚ğŸ»	kili hinehina, leÊ»o, leÊ»o: kili hinehina
ğŸ’‚ğŸ¼	kili kelokelo, leÊ»o, leÊ»o: kili kelokelo
ğŸ’‚ğŸ½	kili melomelo, leÊ»o, leÊ»o: kili melomelo
ğŸ’‚ğŸ¾	kili melomelo-Ê»uliÊ»uli, leÊ»o, leÊ»o: kili melomelo-Ê»uliÊ»uli
ğŸ’‚ğŸ¿	kili Ê»uliÊ»uli, leÊ»o, leÊ»o: kili Ê»uliÊ»uli
ğŸ’‚â€â™‚	leÊ»o tangata
ğŸ’‚ğŸ»â€â™‚	kili hinehina, leÊ»o tangata, leÊ»o tangata: kili hinehina
ğŸ’‚ğŸ¼â€â™‚	kili kelokelo, leÊ»o tangata, leÊ»o tangata: kili kelokelo
ğŸ’‚ğŸ½â€â™‚	kili melomelo, leÊ»o tangata, leÊ»o tangata: kili melomelo
ğŸ’‚ğŸ¾â€â™‚	kili melomelo-Ê»uliÊ»uli, leÊ»o tangata, leÊ»o tangata: kili melomelo-Ê»uliÊ»uli
ğŸ’‚ğŸ¿â€â™‚	kili Ê»uliÊ»uli, leÊ»o tangata, leÊ»o tangata: kili Ê»uliÊ»uli
ğŸ’‚â€â™€	leÊ»o fefine
ğŸ’‚ğŸ»â€â™€	kili hinehina, leÊ»o fefine, leÊ»o fefine: kili hinehina
ğŸ’‚ğŸ¼â€â™€	kili kelokelo, leÊ»o fefine, leÊ»o fefine: kili kelokelo
ğŸ’‚ğŸ½â€â™€	kili melomelo, leÊ»o fefine, leÊ»o fefine: kili melomelo
ğŸ’‚ğŸ¾â€â™€	kili melomelo-Ê»uliÊ»uli, leÊ»o fefine, leÊ»o fefine: kili melomelo-Ê»uliÊ»uli
ğŸ’‚ğŸ¿â€â™€	kili Ê»uliÊ»uli, leÊ»o fefine, leÊ»o fefine: kili Ê»uliÊ»uli
ğŸ‘·	tokotaha ngÄue langa
ğŸ‘·ğŸ»	kili hinehina, tokotaha ngÄue langa, tokotaha ngÄue langa: kili hinehina
ğŸ‘·ğŸ¼	kili kelokelo, tokotaha ngÄue langa, tokotaha ngÄue langa: kili kelokelo
ğŸ‘·ğŸ½	kili melomelo, tokotaha ngÄue langa, tokotaha ngÄue langa: kili melomelo
ğŸ‘·ğŸ¾	kili melomelo-Ê»uliÊ»uli, tokotaha ngÄue langa, tokotaha ngÄue langa: kili melomelo-Ê»uliÊ»uli
ğŸ‘·ğŸ¿	kili Ê»uliÊ»uli, tokotaha ngÄue langa, tokotaha ngÄue langa: kili Ê»uliÊ»uli
ğŸ‘·â€â™‚	tangata ngÄue langa
ğŸ‘·ğŸ»â€â™‚	kili hinehina, tangata ngÄue langa, tangata ngÄue langa: kili hinehina
ğŸ‘·ğŸ¼â€â™‚	kili kelokelo, tangata ngÄue langa, tangata ngÄue langa: kili kelokelo
ğŸ‘·ğŸ½â€â™‚	kili melomelo, tangata ngÄue langa, tangata ngÄue langa: kili melomelo
ğŸ‘·ğŸ¾â€â™‚	kili melomelo-Ê»uliÊ»uli, tangata ngÄue langa, tangata ngÄue langa: kili melomelo-Ê»uliÊ»uli
ğŸ‘·ğŸ¿â€â™‚	kili Ê»uliÊ»uli, tangata ngÄue langa, tangata ngÄue langa: kili Ê»uliÊ»uli
ğŸ‘·â€â™€	fefine ngÄue langa
ğŸ‘·ğŸ»â€â™€	fefine ngÄue langa, fefine ngÄue langa: kili hinehina, kili hinehina
ğŸ‘·ğŸ¼â€â™€	fefine ngÄue langa, fefine ngÄue langa: kili kelokelo, kili kelokelo
ğŸ‘·ğŸ½â€â™€	fefine ngÄue langa, fefine ngÄue langa: kili melomelo, kili melomelo
ğŸ‘·ğŸ¾â€â™€	fefine ngÄue langa, fefine ngÄue langa: kili melomelo-Ê»uliÊ»uli, kili melomelo-Ê»uliÊ»uli
ğŸ‘·ğŸ¿â€â™€	fefine ngÄue langa, fefine ngÄue langa: kili Ê»uliÊ»uli, kili Ê»uliÊ»uli
ğŸ¤´	Ê»alo tangata
ğŸ¤´ğŸ»	kili hinehina, Ê»alo tangata, Ê»alo tangata: kili hinehina
ğŸ¤´ğŸ¼	kili kelokelo, Ê»alo tangata, Ê»alo tangata: kili kelokelo
ğŸ¤´ğŸ½	kili melomelo, Ê»alo tangata, Ê»alo tangata: kili melomelo
ğŸ¤´ğŸ¾	kili melomelo-Ê»uliÊ»uli, Ê»alo tangata, Ê»alo tangata: kili melomelo-Ê»uliÊ»uli
ğŸ¤´ğŸ¿	kili Ê»uliÊ»uli, Ê»alo tangata, Ê»alo tangata: kili Ê»uliÊ»uli
ğŸ‘¸	Ê»alo fefine
ğŸ‘¸ğŸ»	kili hinehina, Ê»alo fefine, Ê»alo fefine: kili hinehina
ğŸ‘¸ğŸ¼	kili kelokelo, Ê»alo fefine, Ê»alo fefine: kili kelokelo
ğŸ‘¸ğŸ½	kili melomelo, Ê»alo fefine, Ê»alo fefine: kili melomelo
ğŸ‘¸ğŸ¾	kili melomelo-Ê»uliÊ»uli, Ê»alo fefine, Ê»alo fefine: kili melomelo-Ê»uliÊ»uli
ğŸ‘¸ğŸ¿	kili Ê»uliÊ»uli, Ê»alo fefine, Ê»alo fefine: kili Ê»uliÊ»uli
ğŸ‘³	tokotaha tui faÊ»u
ğŸ‘³ğŸ»	kili hinehina, tokotaha tui faÊ»u, tokotaha tui faÊ»u: kili hinehina
ğŸ‘³ğŸ¼	kili kelokelo, tokotaha tui faÊ»u, tokotaha tui faÊ»u: kili kelokelo
ğŸ‘³ğŸ½	kili melomelo, tokotaha tui faÊ»u, tokotaha tui faÊ»u: kili melomelo
ğŸ‘³ğŸ¾	kili melomelo-Ê»uliÊ»uli, tokotaha tui faÊ»u, tokotaha tui faÊ»u: kili melomelo-Ê»uliÊ»uli
ğŸ‘³ğŸ¿	kili Ê»uliÊ»uli, tokotaha tui faÊ»u, tokotaha tui faÊ»u: kili Ê»uliÊ»uli
ğŸ‘³â€â™‚	tangata tui faÊ»u
ğŸ‘³ğŸ»â€â™‚	kili hinehina, tangata tui faÊ»u, tangata tui faÊ»u: kili hinehina
ğŸ‘³ğŸ¼â€â™‚	kili kelokelo, tangata tui faÊ»u, tangata tui faÊ»u: kili kelokelo
ğŸ‘³ğŸ½â€â™‚	kili melomelo, tangata tui faÊ»u, tangata tui faÊ»u: kili melomelo
ğŸ‘³ğŸ¾â€â™‚	kili melomelo-Ê»uliÊ»uli, tangata tui faÊ»u, tangata tui faÊ»u: kili melomelo-Ê»uliÊ»uli
ğŸ‘³ğŸ¿â€â™‚	kili Ê»uliÊ»uli, tangata tui faÊ»u, tangata tui faÊ»u: kili Ê»uliÊ»uli
ğŸ‘³â€â™€	fefine tui faÊ»u
ğŸ‘³ğŸ»â€â™€	fefine tui faÊ»u, fefine tui faÊ»u: kili hinehina, kili hinehina
ğŸ‘³ğŸ¼â€â™€	fefine tui faÊ»u, fefine tui faÊ»u: kili kelokelo, kili kelokelo
ğŸ‘³ğŸ½â€â™€	fefine tui faÊ»u, fefine tui faÊ»u: kili melomelo, kili melomelo
ğŸ‘³ğŸ¾â€â™€	fefine tui faÊ»u, fefine tui faÊ»u: kili melomelo-Ê»uliÊ»uli, kili melomelo-Ê»uliÊ»uli
ğŸ‘³ğŸ¿â€â™€	fefine tui faÊ»u, fefine tui faÊ»u: kili Ê»uliÊ»uli, kili Ê»uliÊ»uli
ğŸ‘²	tangata tui tatÄ fakasiaina
ğŸ‘²ğŸ»	kili hinehina, tangata tui tatÄ fakasiaina, tangata tui tatÄ fakasiaina: kili hinehina
ğŸ‘²ğŸ¼	kili kelokelo, tangata tui tatÄ fakasiaina, tangata tui tatÄ fakasiaina: kili kelokelo
ğŸ‘²ğŸ½	kili melomelo, tangata tui tatÄ fakasiaina, tangata tui tatÄ fakasiaina: kili melomelo
ğŸ‘²ğŸ¾	kili melomelo-Ê»uliÊ»uli, tangata tui tatÄ fakasiaina, tangata tui tatÄ fakasiaina: kili melomelo-Ê»uliÊ»uli
ğŸ‘²ğŸ¿	kili Ê»uliÊ»uli, tangata tui tatÄ fakasiaina, tangata tui tatÄ fakasiaina: kili Ê»uliÊ»uli
ğŸ§•	fefine tui sikaafi
ğŸ§•ğŸ»	fefine tui sikaafi, fefine tui sikaafi: kili hinehina, kili hinehina
ğŸ§•ğŸ¼	fefine tui sikaafi, fefine tui sikaafi: kili kelokelo, kili kelokelo
ğŸ§•ğŸ½	fefine tui sikaafi, fefine tui sikaafi: kili melomelo, kili melomelo
ğŸ§•ğŸ¾	fefine tui sikaafi, fefine tui sikaafi: kili melomelo-Ê»uliÊ»uli, kili melomelo-Ê»uliÊ»uli
ğŸ§•ğŸ¿	fefine tui sikaafi, fefine tui sikaafi: kili Ê»uliÊ»uli, kili Ê»uliÊ»uli
ğŸ¤µ	tangata vala kakato
ğŸ¤µğŸ»	kili hinehina, tangata vala kakato, tangata vala kakato: kili hinehina
ğŸ¤µğŸ¼	kili kelokelo, tangata vala kakato, tangata vala kakato: kili kelokelo
ğŸ¤µğŸ½	kili melomelo, tangata vala kakato, tangata vala kakato: kili melomelo
ğŸ¤µğŸ¾	kili melomelo-Ê»uliÊ»uli, tangata vala kakato, tangata vala kakato: kili melomelo-Ê»uliÊ»uli
ğŸ¤µğŸ¿	kili Ê»uliÊ»uli, tangata vala kakato, tangata vala kakato: kili Ê»uliÊ»uli
ğŸ‘°	fefine tui veli
ğŸ‘°ğŸ»	fefine tui veli, fefine tui veli: kili hinehina, kili hinehina
ğŸ‘°ğŸ¼	fefine tui veli, fefine tui veli: kili kelokelo, kili kelokelo
ğŸ‘°ğŸ½	fefine tui veli, fefine tui veli: kili melomelo, kili melomelo
ğŸ‘°ğŸ¾	fefine tui veli, fefine tui veli: kili melomelo-Ê»uliÊ»uli, kili melomelo-Ê»uliÊ»uli
ğŸ‘°ğŸ¿	fefine tui veli, fefine tui veli: kili Ê»uliÊ»uli, kili Ê»uliÊ»uli
ğŸ¤°	feitama
ğŸ¤°ğŸ»	feitama, feitama: kili hinehina, kili hinehina
ğŸ¤°ğŸ¼	feitama, feitama: kili kelokelo, kili kelokelo
ğŸ¤°ğŸ½	feitama, feitama: kili melomelo, kili melomelo
ğŸ¤°ğŸ¾	feitama, feitama: kili melomelo-Ê»uliÊ»uli, kili melomelo-Ê»uliÊ»uli
ğŸ¤°ğŸ¿	feitama, feitama: kili Ê»uliÊ»uli, kili Ê»uliÊ»uli
ğŸ¤±	fakahuhu
ğŸ¤±ğŸ»	fakahuhu, fakahuhu: kili hinehina, kili hinehina
ğŸ¤±ğŸ¼	fakahuhu, fakahuhu: kili kelokelo, kili kelokelo
ğŸ¤±ğŸ½	fakahuhu, fakahuhu: kili melomelo, kili melomelo
ğŸ¤±ğŸ¾	fakahuhu, fakahuhu: kili melomelo-Ê»uliÊ»uli, kili melomelo-Ê»uliÊ»uli
ğŸ¤±ğŸ¿	fakahuhu, fakahuhu: kili Ê»uliÊ»uli, kili Ê»uliÊ»uli
ğŸ‘¼	Ê»angelo valevale
ğŸ‘¼ğŸ»	kili hinehina, Ê»angelo valevale, Ê»angelo valevale: kili hinehina
ğŸ‘¼ğŸ¼	kili kelokelo, Ê»angelo valevale, Ê»angelo valevale: kili kelokelo
ğŸ‘¼ğŸ½	kili melomelo, Ê»angelo valevale, Ê»angelo valevale: kili melomelo
ğŸ‘¼ğŸ¾	kili melomelo-Ê»uliÊ»uli, Ê»angelo valevale, Ê»angelo valevale: kili melomelo-Ê»uliÊ»uli
ğŸ‘¼ğŸ¿	kili Ê»uliÊ»uli, Ê»angelo valevale, Ê»angelo valevale: kili Ê»uliÊ»uli
ğŸ…	SÄnita Kalausi
ğŸ…ğŸ»	SÄnita Kalausi, SÄnita Kalausi: kili hinehina, kili hinehina
ğŸ…ğŸ¼	SÄnita Kalausi, SÄnita Kalausi: kili kelokelo, kili kelokelo
ğŸ…ğŸ½	SÄnita Kalausi, SÄnita Kalausi: kili melomelo, kili melomelo
ğŸ…ğŸ¾	SÄnita Kalausi, SÄnita Kalausi: kili melomelo-Ê»uliÊ»uli, kili melomelo-Ê»uliÊ»uli
ğŸ…ğŸ¿	SÄnita Kalausi, SÄnita Kalausi: kili Ê»uliÊ»uli, kili Ê»uliÊ»uli
ğŸ¤¶	SÄnita Kalausi fefine
ğŸ¤¶ğŸ»	SÄnita Kalausi fefine, SÄnita Kalausi fefine: kili hinehina, kili hinehina
ğŸ¤¶ğŸ¼	SÄnita Kalausi fefine, SÄnita Kalausi fefine: kili kelokelo, kili kelokelo
ğŸ¤¶ğŸ½	SÄnita Kalausi fefine, SÄnita Kalausi fefine: kili melomelo, kili melomelo
ğŸ¤¶ğŸ¾	SÄnita Kalausi fefine, SÄnita Kalausi fefine: kili melomelo-Ê»uliÊ»uli, kili melomelo-Ê»uliÊ»uli
ğŸ¤¶ğŸ¿	SÄnita Kalausi fefine, SÄnita Kalausi fefine: kili Ê»uliÊ»uli, kili Ê»uliÊ»uli
ğŸ¦¸	tokotaha ivimÄlohi
ğŸ¦¸ğŸ»	kili hinehina, tokotaha ivimÄlohi, tokotaha ivimÄlohi: kili hinehina
ğŸ¦¸ğŸ¼	kili kelokelo, tokotaha ivimÄlohi, tokotaha ivimÄlohi: kili kelokelo
ğŸ¦¸ğŸ½	kili melomelo, tokotaha ivimÄlohi, tokotaha ivimÄlohi: kili melomelo
ğŸ¦¸ğŸ¾	kili melomelo-Ê»uliÊ»uli, tokotaha ivimÄlohi, tokotaha ivimÄlohi: kili melomelo-Ê»uliÊ»uli
ğŸ¦¸ğŸ¿	kili Ê»uliÊ»uli, tokotaha ivimÄlohi, tokotaha ivimÄlohi: kili Ê»uliÊ»uli
ğŸ¦¸â€â™‚	tangata ivimÄlohi
ğŸ¦¸ğŸ»â€â™‚	kili hinehina, tangata ivimÄlohi, tangata ivimÄlohi: kili hinehina
ğŸ¦¸ğŸ¼â€â™‚	kili kelokelo, tangata ivimÄlohi, tangata ivimÄlohi: kili kelokelo
ğŸ¦¸ğŸ½â€â™‚	kili melomelo, tangata ivimÄlohi, tangata ivimÄlohi: kili melomelo
ğŸ¦¸ğŸ¾â€â™‚	kili melomelo-Ê»uliÊ»uli, tangata ivimÄlohi, tangata ivimÄlohi: kili melomelo-Ê»uliÊ»uli
ğŸ¦¸ğŸ¿â€â™‚	kili Ê»uliÊ»uli, tangata ivimÄlohi, tangata ivimÄlohi: kili Ê»uliÊ»uli
ğŸ¦¸â€â™€	fefine ivimÄlohi
ğŸ¦¸ğŸ»â€â™€	fefine ivimÄlohi, fefine ivimÄlohi: kili hinehina, kili hinehina
ğŸ¦¸ğŸ¼â€â™€	fefine ivimÄlohi, fefine ivimÄlohi: kili kelokelo, kili kelokelo
ğŸ¦¸ğŸ½â€â™€	fefine ivimÄlohi, fefine ivimÄlohi: kili melomelo, kili melomelo
ğŸ¦¸ğŸ¾â€â™€	fefine ivimÄlohi, fefine ivimÄlohi: kili melomelo-Ê»uliÊ»uli, kili melomelo-Ê»uliÊ»uli
ğŸ¦¸ğŸ¿â€â™€	fefine ivimÄlohi, fefine ivimÄlohi: kili Ê»uliÊ»uli, kili Ê»uliÊ»uli
ğŸ¦¹	tokotaha kÄkÄ
ğŸ¦¹ğŸ»	kili hinehina, tokotaha kÄkÄ, tokotaha kÄkÄ: kili hinehina
ğŸ¦¹ğŸ¼	kili kelokelo, tokotaha kÄkÄ, tokotaha kÄkÄ: kili kelokelo
ğŸ¦¹ğŸ½	kili melomelo, tokotaha kÄkÄ, tokotaha kÄkÄ: kili melomelo
ğŸ¦¹ğŸ¾	kili melomelo-Ê»uliÊ»uli, tokotaha kÄkÄ, tokotaha kÄkÄ: kili melomelo-Ê»uliÊ»uli
ğŸ¦¹ğŸ¿	kili Ê»uliÊ»uli, tokotaha kÄkÄ, tokotaha kÄkÄ: kili Ê»uliÊ»uli
ğŸ¦¹â€â™‚	tangata kÄkÄ
ğŸ¦¹ğŸ»â€â™‚	kili hinehina, tangata kÄkÄ, tangata kÄkÄ: kili hinehina
ğŸ¦¹ğŸ¼â€â™‚	kili kelokelo, tangata kÄkÄ, tangata kÄkÄ: kili kelokelo
ğŸ¦¹ğŸ½â€â™‚	kili melomelo, tangata kÄkÄ, tangata kÄkÄ: kili melomelo
ğŸ¦¹ğŸ¾â€â™‚	kili melomelo-Ê»uliÊ»uli, tangata kÄkÄ, tangata kÄkÄ: kili melomelo-Ê»uliÊ»uli
ğŸ¦¹ğŸ¿â€â™‚	kili Ê»uliÊ»uli, tangata kÄkÄ, tangata kÄkÄ: kili Ê»uliÊ»uli
ğŸ¦¹â€â™€	fefine kÄkÄ
ğŸ¦¹ğŸ»â€â™€	fefine kÄkÄ, fefine kÄkÄ: kili hinehina, kili hinehina
ğŸ¦¹ğŸ¼â€â™€	fefine kÄkÄ, fefine kÄkÄ: kili kelokelo, kili kelokelo
ğŸ¦¹ğŸ½â€â™€	fefine kÄkÄ, fefine kÄkÄ: kili melomelo, kili melomelo
ğŸ¦¹ğŸ¾â€â™€	fefine kÄkÄ, fefine kÄkÄ: kili melomelo-Ê»uliÊ»uli, kili melomelo-Ê»uliÊ»uli
ğŸ¦¹ğŸ¿â€â™€	fefine kÄkÄ, fefine kÄkÄ: kili Ê»uliÊ»uli, kili Ê»uliÊ»uli
ğŸ§™	tokotaha taula-faÊ»ahikehe
ğŸ§™ğŸ»	kili hinehina, tokotaha taula-faÊ»ahikehe, tokotaha taula-faÊ»ahikehe: kili hinehina
ğŸ§™ğŸ¼	kili kelokelo, tokotaha taula-faÊ»ahikehe, tokotaha taula-faÊ»ahikehe: kili kelokelo
ğŸ§™ğŸ½	kili melomelo, tokotaha taula-faÊ»ahikehe, tokotaha taula-faÊ»ahikehe: kili melomelo
ğŸ§™ğŸ¾	kili melomelo-Ê»uliÊ»uli, tokotaha taula-faÊ»ahikehe, tokotaha taula-faÊ»ahikehe: kili melomelo-Ê»uliÊ»uli
ğŸ§™ğŸ¿	kili Ê»uliÊ»uli, tokotaha taula-faÊ»ahikehe, tokotaha taula-faÊ»ahikehe: kili Ê»uliÊ»uli
ğŸ§™â€â™‚	tangata taula-faÊ»ahikehe
ğŸ§™ğŸ»â€â™‚	kili hinehina, tangata taula-faÊ»ahikehe, tangata taula-faÊ»ahikehe: kili hinehina
ğŸ§™ğŸ¼â€â™‚	kili kelokelo, tangata taula-faÊ»ahikehe, tangata taula-faÊ»ahikehe: kili kelokelo
ğŸ§™ğŸ½â€â™‚	kili melomelo, tangata taula-faÊ»ahikehe, tangata taula-faÊ»ahikehe: kili melomelo
ğŸ§™ğŸ¾â€â™‚	kili melomelo-Ê»uliÊ»uli, tangata taula-faÊ»ahikehe, tangata taula-faÊ»ahikehe: kili melomelo-Ê»uliÊ»uli
ğŸ§™ğŸ¿â€â™‚	kili Ê»uliÊ»uli, tangata taula-faÊ»ahikehe, tangata taula-faÊ»ahikehe: kili Ê»uliÊ»uli
ğŸ§™â€â™€	fefine taula-faÊ»ahikehe
ğŸ§™ğŸ»â€â™€	fefine taula-faÊ»ahikehe, fefine taula-faÊ»ahikehe: kili hinehina, kili hinehina
ğŸ§™ğŸ¼â€â™€	fefine taula-faÊ»ahikehe, fefine taula-faÊ»ahikehe: kili kelokelo, kili kelokelo
ğŸ§™ğŸ½â€â™€	fefine taula-faÊ»ahikehe, fefine taula-faÊ»ahikehe: kili melomelo, kili melomelo
ğŸ§™ğŸ¾â€â™€	fefine taula-faÊ»ahikehe, fefine taula-faÊ»ahikehe: kili melomelo-Ê»uliÊ»uli, kili melomelo-Ê»uliÊ»uli
ğŸ§™ğŸ¿â€â™€	fefine taula-faÊ»ahikehe, fefine taula-faÊ»ahikehe: kili Ê»uliÊ»uli, kili Ê»uliÊ»uli
ğŸ§š	feeli
ğŸ§šğŸ»	feeli, feeli: kili hinehina, kili hinehina
ğŸ§šğŸ¼	feeli, feeli: kili kelokelo, kili kelokelo
ğŸ§šğŸ½	feeli, feeli: kili melomelo, kili melomelo
ğŸ§šğŸ¾	feeli, feeli: kili melomelo-Ê»uliÊ»uli, kili melomelo-Ê»uliÊ»uli
ğŸ§šğŸ¿	feeli, feeli: kili Ê»uliÊ»uli, kili Ê»uliÊ»uli
ğŸ§šâ€â™‚	feeli tangata
ğŸ§šğŸ»â€â™‚	feeli tangata, feeli tangata: kili hinehina, kili hinehina
ğŸ§šğŸ¼â€â™‚	feeli tangata, feeli tangata: kili kelokelo, kili kelokelo
ğŸ§šğŸ½â€â™‚	feeli tangata, feeli tangata: kili melomelo, kili melomelo
ğŸ§šğŸ¾â€â™‚	feeli tangata, feeli tangata: kili melomelo-Ê»uliÊ»uli, kili melomelo-Ê»uliÊ»uli
ğŸ§šğŸ¿â€â™‚	feeli tangata, feeli tangata: kili Ê»uliÊ»uli, kili Ê»uliÊ»uli
ğŸ§šâ€â™€	feeli fefine
ğŸ§šğŸ»â€â™€	feeli fefine, feeli fefine: kili hinehina, kili hinehina
ğŸ§šğŸ¼â€â™€	feeli fefine, feeli fefine: kili kelokelo, kili kelokelo
ğŸ§šğŸ½â€â™€	feeli fefine, feeli fefine: kili melomelo, kili melomelo
ğŸ§šğŸ¾â€â™€	feeli fefine, feeli fefine: kili melomelo-Ê»uliÊ»uli, kili melomelo-Ê»uliÊ»uli
ğŸ§šğŸ¿â€â™€	feeli fefine, feeli fefine: kili Ê»uliÊ»uli, kili Ê»uliÊ»uli
ğŸ§›	tokotaha misi toto
ğŸ§›ğŸ»	kili hinehina, tokotaha misi toto, tokotaha misi toto: kili hinehina
ğŸ§›ğŸ¼	kili kelokelo, tokotaha misi toto, tokotaha misi toto: kili kelokelo
ğŸ§›ğŸ½	kili melomelo, tokotaha misi toto, tokotaha misi toto: kili melomelo
ğŸ§›ğŸ¾	kili melomelo-Ê»uliÊ»uli, tokotaha misi toto, tokotaha misi toto: kili melomelo-Ê»uliÊ»uli
ğŸ§›ğŸ¿	kili Ê»uliÊ»uli, tokotaha misi toto, tokotaha misi toto: kili Ê»uliÊ»uli
ğŸ§›â€â™‚	tangata misi toto
ğŸ§›ğŸ»â€â™‚	kili hinehina, tangata misi toto, tangata misi toto: kili hinehina
ğŸ§›ğŸ¼â€â™‚	kili kelokelo, tangata misi toto, tangata misi toto: kili kelokelo
ğŸ§›ğŸ½â€â™‚	kili melomelo, tangata misi toto, tangata misi toto: kili melomelo
ğŸ§›ğŸ¾â€â™‚	kili melomelo-Ê»uliÊ»uli, tangata misi toto, tangata misi toto: kili melomelo-Ê»uliÊ»uli
ğŸ§›ğŸ¿â€â™‚	kili Ê»uliÊ»uli, tangata misi toto, tangata misi toto: kili Ê»uliÊ»uli
ğŸ§›â€â™€	fefine misi toto
ğŸ§›ğŸ»â€â™€	fefine misi toto, fefine misi toto: kili hinehina, kili hinehina
ğŸ§›ğŸ¼â€â™€	fefine misi toto, fefine misi toto: kili kelokelo, kili kelokelo
ğŸ§›ğŸ½â€â™€	fefine misi toto, fefine misi toto: kili melomelo, kili melomelo
ğŸ§›ğŸ¾â€â™€	fefine misi toto, fefine misi toto: kili melomelo-Ê»uliÊ»uli, kili melomelo-Ê»uliÊ»uli
ğŸ§›ğŸ¿â€â™€	fefine misi toto, fefine misi toto: kili Ê»uliÊ»uli, kili Ê»uliÊ»uli
ğŸ§œ	tokotaha meimeite
ğŸ§œğŸ»	kili hinehina, tokotaha meimeite, tokotaha meimeite: kili hinehina
ğŸ§œğŸ¼	kili kelokelo, tokotaha meimeite, tokotaha meimeite: kili kelokelo
ğŸ§œğŸ½	kili melomelo, tokotaha meimeite, tokotaha meimeite: kili melomelo
ğŸ§œğŸ¾	kili melomelo-Ê»uliÊ»uli, tokotaha meimeite, tokotaha meimeite: kili melomelo-Ê»uliÊ»uli
ğŸ§œğŸ¿	kili Ê»uliÊ»uli, tokotaha meimeite, tokotaha meimeite: kili Ê»uliÊ»uli
ğŸ§œâ€â™‚	tangata meimeite
ğŸ§œğŸ»â€â™‚	kili hinehina, tangata meimeite, tangata meimeite: kili hinehina
ğŸ§œğŸ¼â€â™‚	kili kelokelo, tangata meimeite, tangata meimeite: kili kelokelo
ğŸ§œğŸ½â€â™‚	kili melomelo, tangata meimeite, tangata meimeite: kili melomelo
ğŸ§œğŸ¾â€â™‚	kili melomelo-Ê»uliÊ»uli, tangata meimeite, tangata meimeite: kili melomelo-Ê»uliÊ»uli
ğŸ§œğŸ¿â€â™‚	kili Ê»uliÊ»uli, tangata meimeite, tangata meimeite: kili Ê»uliÊ»uli
ğŸ§œâ€â™€	fefine meimeite
ğŸ§œğŸ»â€â™€	fefine meimeite, fefine meimeite: kili hinehina, kili hinehina
ğŸ§œğŸ¼â€â™€	fefine meimeite, fefine meimeite: kili kelokelo, kili kelokelo
ğŸ§œğŸ½â€â™€	fefine meimeite, fefine meimeite: kili melomelo, kili melomelo
ğŸ§œğŸ¾â€â™€	fefine meimeite, fefine meimeite: kili melomelo-Ê»uliÊ»uli, kili melomelo-Ê»uliÊ»uli
ğŸ§œğŸ¿â€â™€	fefine meimeite, fefine meimeite: kili Ê»uliÊ»uli, kili Ê»uliÊ»uli
ğŸ§	kiÊ»i feeli
ğŸ§ğŸ»	kili hinehina, kiÊ»i feeli, kiÊ»i feeli: kili hinehina
ğŸ§ğŸ¼	kili kelokelo, kiÊ»i feeli, kiÊ»i feeli: kili kelokelo
ğŸ§ğŸ½	kili melomelo, kiÊ»i feeli, kiÊ»i feeli: kili melomelo
ğŸ§ğŸ¾	kili melomelo-Ê»uliÊ»uli, kiÊ»i feeli, kiÊ»i feeli: kili melomelo-Ê»uliÊ»uli
ğŸ§ğŸ¿	kili Ê»uliÊ»uli, kiÊ»i feeli, kiÊ»i feeli: kili Ê»uliÊ»uli
ğŸ§â€â™‚	kiÊ»i feeli tangata
ğŸ§ğŸ»â€â™‚	kili hinehina, kiÊ»i feeli tangata, kiÊ»i feeli tangata: kili hinehina
ğŸ§ğŸ¼â€â™‚	kili kelokelo, kiÊ»i feeli tangata, kiÊ»i feeli tangata: kili kelokelo
ğŸ§ğŸ½â€â™‚	kili melomelo, kiÊ»i feeli tangata, kiÊ»i feeli tangata: kili melomelo
ğŸ§ğŸ¾â€â™‚	kili melomelo-Ê»uliÊ»uli, kiÊ»i feeli tangata, kiÊ»i feeli tangata: kili melomelo-Ê»uliÊ»uli
ğŸ§ğŸ¿â€â™‚	kili Ê»uliÊ»uli, kiÊ»i feeli tangata, kiÊ»i feeli tangata: kili Ê»uliÊ»uli
ğŸ§â€â™€	kiÊ»i feeli fefine
ğŸ§ğŸ»â€â™€	kili hinehina, kiÊ»i feeli fefine, kiÊ»i feeli fefine: kili hinehina
ğŸ§ğŸ¼â€â™€	kili kelokelo, kiÊ»i feeli fefine, kiÊ»i feeli fefine: kili kelokelo
ğŸ§ğŸ½â€â™€	kili melomelo, kiÊ»i feeli fefine, kiÊ»i feeli fefine: kili melomelo
ğŸ§ğŸ¾â€â™€	kili melomelo-Ê»uliÊ»uli, kiÊ»i feeli fefine, kiÊ»i feeli fefine: kili melomelo-Ê»uliÊ»uli
ğŸ§ğŸ¿â€â™€	kili Ê»uliÊ»uli, kiÊ»i feeli fefine, kiÊ»i feeli fefine: kili Ê»uliÊ»uli
ğŸ§	faÊ»ahikehe
ğŸ§â€â™‚	faÊ»ahikehe tangata
ğŸ§â€â™€	faÊ»ahikehe fefine
ğŸ§Ÿ	tÄ“volo
ğŸ§Ÿâ€â™‚	tÄ“volo tangata
ğŸ§Ÿâ€â™€	tÄ“volo fefine
ğŸ’†	tokotaha fotofotaÊ»i
ğŸ’†ğŸ»	kili hinehina, tokotaha fotofotaÊ»i, tokotaha fotofotaÊ»i: kili hinehina
ğŸ’†ğŸ¼	kili kelokelo, tokotaha fotofotaÊ»i, tokotaha fotofotaÊ»i: kili kelokelo
ğŸ’†ğŸ½	kili melomelo, tokotaha fotofotaÊ»i, tokotaha fotofotaÊ»i: kili melomelo
ğŸ’†ğŸ¾	kili melomelo-Ê»uliÊ»uli, tokotaha fotofotaÊ»i, tokotaha fotofotaÊ»i: kili melomelo-Ê»uliÊ»uli
ğŸ’†ğŸ¿	kili Ê»uliÊ»uli, tokotaha fotofotaÊ»i, tokotaha fotofotaÊ»i: kili Ê»uliÊ»uli
ğŸ’†â€â™‚	tangata fotofotaÊ»i
ğŸ’†ğŸ»â€â™‚	kili hinehina, tangata fotofotaÊ»i, tangata fotofotaÊ»i: kili hinehina
ğŸ’†ğŸ¼â€â™‚	kili kelokelo, tangata fotofotaÊ»i, tangata fotofotaÊ»i: kili kelokelo
ğŸ’†ğŸ½â€â™‚	kili melomelo, tangata fotofotaÊ»i, tangata fotofotaÊ»i: kili melomelo
ğŸ’†ğŸ¾â€â™‚	kili melomelo-Ê»uliÊ»uli, tangata fotofotaÊ»i, tangata fotofotaÊ»i: kili melomelo-Ê»uliÊ»uli
ğŸ’†ğŸ¿â€â™‚	kili Ê»uliÊ»uli, tangata fotofotaÊ»i, tangata fotofotaÊ»i: kili Ê»uliÊ»uli
ğŸ’†â€â™€	fefine fotofotaÊ»i
ğŸ’†ğŸ»â€â™€	fefine fotofotaÊ»i, fefine fotofotaÊ»i: kili hinehina, kili hinehina
ğŸ’†ğŸ¼â€â™€	fefine fotofotaÊ»i, fefine fotofotaÊ»i: kili kelokelo, kili kelokelo
ğŸ’†ğŸ½â€â™€	fefine fotofotaÊ»i, fefine fotofotaÊ»i: kili melomelo, kili melomelo
ğŸ’†ğŸ¾â€â™€	fefine fotofotaÊ»i, fefine fotofotaÊ»i: kili melomelo-Ê»uliÊ»uli, kili melomelo-Ê»uliÊ»uli
ğŸ’†ğŸ¿â€â™€	fefine fotofotaÊ»i, fefine fotofotaÊ»i: kili Ê»uliÊ»uli, kili Ê»uliÊ»uli
ğŸ’‡	tokotaha Ê»ulu kosi
ğŸ’‡ğŸ»	kili hinehina, tokotaha Ê»ulu kosi, tokotaha Ê»ulu kosi: kili hinehina
ğŸ’‡ğŸ¼	kili kelokelo, tokotaha Ê»ulu kosi, tokotaha Ê»ulu kosi: kili kelokelo
ğŸ’‡ğŸ½	kili melomelo, tokotaha Ê»ulu kosi, tokotaha Ê»ulu kosi: kili melomelo
ğŸ’‡ğŸ¾	kili melomelo-Ê»uliÊ»uli, tokotaha Ê»ulu kosi, tokotaha Ê»ulu kosi: kili melomelo-Ê»uliÊ»uli
ğŸ’‡ğŸ¿	kili Ê»uliÊ»uli, tokotaha Ê»ulu kosi, tokotaha Ê»ulu kosi: kili Ê»uliÊ»uli
ğŸ’‡â€â™‚	tangata Ê»ulu kosi
ğŸ’‡ğŸ»â€â™‚	kili hinehina, tangata Ê»ulu kosi, tangata Ê»ulu kosi: kili hinehina
ğŸ’‡ğŸ¼â€â™‚	kili kelokelo, tangata Ê»ulu kosi, tangata Ê»ulu kosi: kili kelokelo
ğŸ’‡ğŸ½â€â™‚	kili melomelo, tangata Ê»ulu kosi, tangata Ê»ulu kosi: kili melomelo
ğŸ’‡ğŸ¾â€â™‚	kili melomelo-Ê»uliÊ»uli, tangata Ê»ulu kosi, tangata Ê»ulu kosi: kili melomelo-Ê»uliÊ»uli
ğŸ’‡ğŸ¿â€â™‚	kili Ê»uliÊ»uli, tangata Ê»ulu kosi, tangata Ê»ulu kosi: kili Ê»uliÊ»uli
ğŸ’‡â€â™€	fefine Ê»ulu kosi
ğŸ’‡ğŸ»â€â™€	fefine Ê»ulu kosi, fefine Ê»ulu kosi: kili hinehina, kili hinehina
ğŸ’‡ğŸ¼â€â™€	fefine Ê»ulu kosi, fefine Ê»ulu kosi: kili kelokelo, kili kelokelo
ğŸ’‡ğŸ½â€â™€	fefine Ê»ulu kosi, fefine Ê»ulu kosi: kili melomelo, kili melomelo
ğŸ’‡ğŸ¾â€â™€	fefine Ê»ulu kosi, fefine Ê»ulu kosi: kili melomelo-Ê»uliÊ»uli, kili melomelo-Ê»uliÊ»uli
ğŸ’‡ğŸ¿â€â™€	fefine Ê»ulu kosi, fefine Ê»ulu kosi: kili Ê»uliÊ»uli, kili Ê»uliÊ»uli
ğŸš¶	tokotaha lue
ğŸš¶ğŸ»	kili hinehina, tokotaha lue, tokotaha lue: kili hinehina
ğŸš¶ğŸ¼	kili kelokelo, tokotaha lue, tokotaha lue: kili kelokelo
ğŸš¶ğŸ½	kili melomelo, tokotaha lue, tokotaha lue: kili melomelo
ğŸš¶ğŸ¾	kili melomelo-Ê»uliÊ»uli, tokotaha lue, tokotaha lue: kili melomelo-Ê»uliÊ»uli
ğŸš¶ğŸ¿	kili Ê»uliÊ»uli, tokotaha lue, tokotaha lue: kili Ê»uliÊ»uli
ğŸš¶â€â™‚	tangata lue
ğŸš¶ğŸ»â€â™‚	kili hinehina, tangata lue, tangata lue: kili hinehina
ğŸš¶ğŸ¼â€â™‚	kili kelokelo, tangata lue, tangata lue: kili kelokelo
ğŸš¶ğŸ½â€â™‚	kili melomelo, tangata lue, tangata lue: kili melomelo
ğŸš¶ğŸ¾â€â™‚	kili melomelo-Ê»uliÊ»uli, tangata lue, tangata lue: kili melomelo-Ê»uliÊ»uli
ğŸš¶ğŸ¿â€â™‚	kili Ê»uliÊ»uli, tangata lue, tangata lue: kili Ê»uliÊ»uli
ğŸš¶â€â™€	fefine lue
ğŸš¶ğŸ»â€â™€	fefine lue, fefine lue: kili hinehina, kili hinehina
ğŸš¶ğŸ¼â€â™€	fefine lue, fefine lue: kili kelokelo, kili kelokelo
ğŸš¶ğŸ½â€â™€	fefine lue, fefine lue: kili melomelo, kili melomelo
ğŸš¶ğŸ¾â€â™€	fefine lue, fefine lue: kili melomelo-Ê»uliÊ»uli, kili melomelo-Ê»uliÊ»uli
ğŸš¶ğŸ¿â€â™€	fefine lue, fefine lue: kili Ê»uliÊ»uli, kili Ê»uliÊ»uli
ğŸƒ	tokotaha lele
ğŸƒğŸ»	kili hinehina, tokotaha lele, tokotaha lele: kili hinehina
ğŸƒğŸ¼	kili kelokelo, tokotaha lele, tokotaha lele: kili kelokelo
ğŸƒğŸ½	kili melomelo, tokotaha lele, tokotaha lele: kili melomelo
ğŸƒğŸ¾	kili melomelo-Ê»uliÊ»uli, tokotaha lele, tokotaha lele: kili melomelo-Ê»uliÊ»uli
ğŸƒğŸ¿	kili Ê»uliÊ»uli, tokotaha lele, tokotaha lele: kili Ê»uliÊ»uli
ğŸƒâ€â™‚	tangata lele
ğŸƒğŸ»â€â™‚	kili hinehina, tangata lele, tangata lele: kili hinehina
ğŸƒğŸ¼â€â™‚	kili kelokelo, tangata lele, tangata lele: kili kelokelo
ğŸƒğŸ½â€â™‚	kili melomelo, tangata lele, tangata lele: kili melomelo
ğŸƒğŸ¾â€â™‚	kili melomelo-Ê»uliÊ»uli, tangata lele, tangata lele: kili melomelo-Ê»uliÊ»uli
ğŸƒğŸ¿â€â™‚	kili Ê»uliÊ»uli, tangata lele, tangata lele: kili Ê»uliÊ»uli
ğŸƒâ€â™€	fefine lele
ğŸƒğŸ»â€â™€	fefine lele, fefine lele: kili hinehina, kili hinehina
ğŸƒğŸ¼â€â™€	fefine lele, fefine lele: kili kelokelo, kili kelokelo
ğŸƒğŸ½â€â™€	fefine lele, fefine lele: kili melomelo, kili melomelo
ğŸƒğŸ¾â€â™€	fefine lele, fefine lele: kili melomelo-Ê»uliÊ»uli, kili melomelo-Ê»uliÊ»uli
ğŸƒğŸ¿â€â™€	fefine lele, fefine lele: kili Ê»uliÊ»uli, kili Ê»uliÊ»uli
ğŸ’ƒ	fefine meÊ»e
ğŸ’ƒğŸ»	fefine meÊ»e, fefine meÊ»e: kili hinehina, kili hinehina
ğŸ’ƒğŸ¼	fefine meÊ»e, fefine meÊ»e: kili kelokelo, kili kelokelo
ğŸ’ƒğŸ½	fefine meÊ»e, fefine meÊ»e: kili melomelo, kili melomelo
ğŸ’ƒğŸ¾	fefine meÊ»e, fefine meÊ»e: kili melomelo-Ê»uliÊ»uli, kili melomelo-Ê»uliÊ»uli
ğŸ’ƒğŸ¿	fefine meÊ»e, fefine meÊ»e: kili Ê»uliÊ»uli, kili Ê»uliÊ»uli
ğŸ•º	tangata meÊ»e
ğŸ•ºğŸ»	kili hinehina, tangata meÊ»e, tangata meÊ»e: kili hinehina
ğŸ•ºğŸ¼	kili kelokelo, tangata meÊ»e, tangata meÊ»e: kili kelokelo
ğŸ•ºğŸ½	kili melomelo, tangata meÊ»e, tangata meÊ»e: kili melomelo
ğŸ•ºğŸ¾	kili melomelo-Ê»uliÊ»uli, tangata meÊ»e, tangata meÊ»e: kili melomelo-Ê»uliÊ»uli
ğŸ•ºğŸ¿	kili Ê»uliÊ»uli, tangata meÊ»e, tangata meÊ»e: kili Ê»uliÊ»uli
ğŸ•´ï¸	tangata Ê»i vala tangata kakato Ê»oku maÊ»anu
ğŸ•´ğŸ»	kili hinehina, tangata Ê»i vala tangata kakato Ê»oku maÊ»anu, tangata Ê»i vala tangata kakato Ê»oku maÊ»anu: kili hinehina
ğŸ•´ğŸ¼	kili kelokelo, tangata Ê»i vala tangata kakato Ê»oku maÊ»anu, tangata Ê»i vala tangata kakato Ê»oku maÊ»anu: kili kelokelo
ğŸ•´ğŸ½	kili melomelo, tangata Ê»i vala tangata kakato Ê»oku maÊ»anu, tangata Ê»i vala tangata kakato Ê»oku maÊ»anu: kili melomelo
ğŸ•´ğŸ¾	kili melomelo-Ê»uliÊ»uli, tangata Ê»i vala tangata kakato Ê»oku maÊ»anu, tangata Ê»i vala tangata kakato Ê»oku maÊ»anu: kili melomelo-Ê»uliÊ»uli
ğŸ•´ğŸ¿	kili Ê»uliÊ»uli, tangata Ê»i vala tangata kakato Ê»oku maÊ»anu, tangata Ê»i vala tangata kakato Ê»oku maÊ»anu: kili Ê»uliÊ»uli
ğŸ‘¯	tokoua telinga-lÄpisi
ğŸ‘¯â€â™‚	ongo tangata telinga-lÄpisi
ğŸ‘¯â€â™€	fafine telinga-lÄpisi
ğŸ§–	tokotaha Ê»i loki mao
ğŸ§–ğŸ»	kili hinehina, tokotaha Ê»i loki mao, tokotaha Ê»i loki mao: kili hinehina
ğŸ§–ğŸ¼	kili kelokelo, tokotaha Ê»i loki mao, tokotaha Ê»i loki mao: kili kelokelo
ğŸ§–ğŸ½	kili melomelo, tokotaha Ê»i loki mao, tokotaha Ê»i loki mao: kili melomelo
ğŸ§–ğŸ¾	kili melomelo-Ê»uliÊ»uli, tokotaha Ê»i loki mao, tokotaha Ê»i loki mao: kili melomelo-Ê»uliÊ»uli
ğŸ§–ğŸ¿	kili Ê»uliÊ»uli, tokotaha Ê»i loki mao, tokotaha Ê»i loki mao: kili Ê»uliÊ»uli
ğŸ§–â€â™‚	tangata Ê»i loki mao
ğŸ§–ğŸ»â€â™‚	kili hinehina, tangata Ê»i loki mao, tangata Ê»i loki mao: kili hinehina
ğŸ§–ğŸ¼â€â™‚	kili kelokelo, tangata Ê»i loki mao, tangata Ê»i loki mao: kili kelokelo
ğŸ§–ğŸ½â€â™‚	kili melomelo, tangata Ê»i loki mao, tangata Ê»i loki mao: kili melomelo
ğŸ§–ğŸ¾â€â™‚	kili melomelo-Ê»uliÊ»uli, tangata Ê»i loki mao, tangata Ê»i loki mao: kili melomelo-Ê»uliÊ»uli
ğŸ§–ğŸ¿â€â™‚	kili Ê»uliÊ»uli, tangata Ê»i loki mao, tangata Ê»i loki mao: kili Ê»uliÊ»uli
ğŸ§–â€â™€	fefine Ê»i loki mao
ğŸ§–ğŸ»â€â™€	fefine Ê»i loki mao, fefine Ê»i loki mao: kili hinehina, kili hinehina
ğŸ§–ğŸ¼â€â™€	fefine Ê»i loki mao, fefine Ê»i loki mao: kili kelokelo, kili kelokelo
ğŸ§–ğŸ½â€â™€	fefine Ê»i loki mao, fefine Ê»i loki mao: kili melomelo, kili melomelo
ğŸ§–ğŸ¾â€â™€	fefine Ê»i loki mao, fefine Ê»i loki mao: kili melomelo-Ê»uliÊ»uli, kili melomelo-Ê»uliÊ»uli
ğŸ§–ğŸ¿â€â™€	fefine Ê»i loki mao, fefine Ê»i loki mao: kili Ê»uliÊ»uli, kili Ê»uliÊ»uli
ğŸ§—	tokotaha kaka
ğŸ§—ğŸ»	kili hinehina, tokotaha kaka, tokotaha kaka: kili hinehina
ğŸ§—ğŸ¼	kili kelokelo, tokotaha kaka, tokotaha kaka: kili kelokelo
ğŸ§—ğŸ½	kili melomelo, tokotaha kaka, tokotaha kaka: kili melomelo
ğŸ§—ğŸ¾	kili melomelo-Ê»uliÊ»uli, tokotaha kaka, tokotaha kaka: kili melomelo-Ê»uliÊ»uli
ğŸ§—ğŸ¿	kili Ê»uliÊ»uli, tokotaha kaka, tokotaha kaka: kili Ê»uliÊ»uli
ğŸ§—â€â™‚	tangata kaka
ğŸ§—ğŸ»â€â™‚	kili hinehina, tangata kaka, tangata kaka: kili hinehina
ğŸ§—ğŸ¼â€â™‚	kili kelokelo, tangata kaka, tangata kaka: kili kelokelo
ğŸ§—ğŸ½â€â™‚	kili melomelo, tangata kaka, tangata kaka: kili melomelo
ğŸ§—ğŸ¾â€â™‚	kili melomelo-Ê»uliÊ»uli, tangata kaka, tangata kaka: kili melomelo-Ê»uliÊ»uli
ğŸ§—ğŸ¿â€â™‚	kili Ê»uliÊ»uli, tangata kaka, tangata kaka: kili Ê»uliÊ»uli
ğŸ§—â€â™€	fefine kaka
ğŸ§—ğŸ»â€â™€	fefine kaka, fefine kaka: kili hinehina, kili hinehina
ğŸ§—ğŸ¼â€â™€	fefine kaka, fefine kaka: kili kelokelo, kili kelokelo
ğŸ§—ğŸ½â€â™€	fefine kaka, fefine kaka: kili melomelo, kili melomelo
ğŸ§—ğŸ¾â€â™€	fefine kaka, fefine kaka: kili melomelo-Ê»uliÊ»uli, kili melomelo-Ê»uliÊ»uli
ğŸ§—ğŸ¿â€â™€	fefine kaka, fefine kaka: kili Ê»uliÊ»uli, kili Ê»uliÊ»uli
ğŸ¤º	tokotaha tau heletÄ
ğŸ‡	lova hoosi
ğŸ‡ğŸ»	kili hinehina, lova hoosi, lova hoosi: kili hinehina
ğŸ‡ğŸ¼	kili kelokelo, lova hoosi, lova hoosi: kili kelokelo
ğŸ‡ğŸ½	kili melomelo, lova hoosi, lova hoosi: kili melomelo
ğŸ‡ğŸ¾	kili melomelo-Ê»uliÊ»uli, lova hoosi, lova hoosi: kili melomelo-Ê»uliÊ»uli
ğŸ‡ğŸ¿	kili Ê»uliÊ»uli, lova hoosi, lova hoosi: kili Ê»uliÊ»uli
â›·ï¸	tokotaha heke sinou
ğŸ‚ï¸	tokotaha heke laupapa sinou
ğŸ‚ğŸ»	kili hinehina, tokotaha heke laupapa sinou, tokotaha heke laupapa sinou: kili hinehina
ğŸ‚ğŸ¼	kili kelokelo, tokotaha heke laupapa sinou, tokotaha heke laupapa sinou: kili kelokelo
ğŸ‚ğŸ½	kili melomelo, tokotaha heke laupapa sinou, tokotaha heke laupapa sinou: kili melomelo
ğŸ‚ğŸ¾	kili melomelo-Ê»uliÊ»uli, tokotaha heke laupapa sinou, tokotaha heke laupapa sinou: kili melomelo-Ê»uliÊ»uli
ğŸ‚ğŸ¿	kili Ê»uliÊ»uli, tokotaha heke laupapa sinou, tokotaha heke laupapa sinou: kili Ê»uliÊ»uli
ğŸŒï¸	tokotaha tÄpulu
ğŸŒğŸ»	kili hinehina, tokotaha tÄpulu, tokotaha tÄpulu: kili hinehina
ğŸŒğŸ¼	kili kelokelo, tokotaha tÄpulu, tokotaha tÄpulu: kili kelokelo
ğŸŒğŸ½	kili melomelo, tokotaha tÄpulu, tokotaha tÄpulu: kili melomelo
ğŸŒğŸ¾	kili melomelo-Ê»uliÊ»uli, tokotaha tÄpulu, tokotaha tÄpulu: kili melomelo-Ê»uliÊ»uli
ğŸŒğŸ¿	kili Ê»uliÊ»uli, tokotaha tÄpulu, tokotaha tÄpulu: kili Ê»uliÊ»uli
ğŸŒâ€â™‚	tangata tÄpulu
ğŸŒğŸ»â€â™‚	kili hinehina, tangata tÄpulu, tangata tÄpulu: kili hinehina
ğŸŒğŸ¼â€â™‚	kili kelokelo, tangata tÄpulu, tangata tÄpulu: kili kelokelo
ğŸŒğŸ½â€â™‚	kili melomelo, tangata tÄpulu, tangata tÄpulu: kili melomelo
ğŸŒğŸ¾â€â™‚	kili melomelo-Ê»uliÊ»uli, tangata tÄpulu, tangata tÄpulu: kili melomelo-Ê»uliÊ»uli
ğŸŒğŸ¿â€â™‚	kili Ê»uliÊ»uli, tangata tÄpulu, tangata tÄpulu: kili Ê»uliÊ»uli
ğŸŒâ€â™€	fefine tÄpulu
ğŸŒğŸ»â€â™€	fefine tÄpulu, fefine tÄpulu: kili hinehina, kili hinehina
ğŸŒğŸ¼â€â™€	fefine tÄpulu, fefine tÄpulu: kili kelokelo, kili kelokelo
ğŸŒğŸ½â€â™€	fefine tÄpulu, fefine tÄpulu: kili melomelo, kili melomelo
ğŸŒğŸ¾â€â™€	fefine tÄpulu, fefine tÄpulu: kili melomelo-Ê»uliÊ»uli, kili melomelo-Ê»uliÊ»uli
ğŸŒğŸ¿â€â™€	fefine tÄpulu, fefine tÄpulu: kili Ê»uliÊ»uli, kili Ê»uliÊ»uli
ğŸ„ï¸	tokotaha fÄnifo
ğŸ„ğŸ»	kili hinehina, tokotaha fÄnifo, tokotaha fÄnifo: kili hinehina
ğŸ„ğŸ¼	kili kelokelo, tokotaha fÄnifo, tokotaha fÄnifo: kili kelokelo
ğŸ„ğŸ½	kili melomelo, tokotaha fÄnifo, tokotaha fÄnifo: kili melomelo
ğŸ„ğŸ¾	kili melomelo-Ê»uliÊ»uli, tokotaha fÄnifo, tokotaha fÄnifo: kili melomelo-Ê»uliÊ»uli
ğŸ„ğŸ¿	kili Ê»uliÊ»uli, tokotaha fÄnifo, tokotaha fÄnifo: kili Ê»uliÊ»uli
ğŸ„â€â™‚	tangata fÄnifo
ğŸ„ğŸ»â€â™‚	kili hinehina, tangata fÄnifo, tangata fÄnifo: kili hinehina
ğŸ„ğŸ¼â€â™‚	kili kelokelo, tangata fÄnifo, tangata fÄnifo: kili kelokelo
ğŸ„ğŸ½â€â™‚	kili melomelo, tangata fÄnifo, tangata fÄnifo: kili melomelo
ğŸ„ğŸ¾â€â™‚	kili melomelo-Ê»uliÊ»uli, tangata fÄnifo, tangata fÄnifo: kili melomelo-Ê»uliÊ»uli
ğŸ„ğŸ¿â€â™‚	kili Ê»uliÊ»uli, tangata fÄnifo, tangata fÄnifo: kili Ê»uliÊ»uli
ğŸ„â€â™€	fefine fÄnifo
ğŸ„ğŸ»â€â™€	fefine fÄnifo, fefine fÄnifo: kili hinehina, kili hinehina
ğŸ„ğŸ¼â€â™€	fefine fÄnifo, fefine fÄnifo: kili kelokelo, kili kelokelo
ğŸ„ğŸ½â€â™€	fefine fÄnifo, fefine fÄnifo: kili melomelo, kili melomelo
ğŸ„ğŸ¾â€â™€	fefine fÄnifo, fefine fÄnifo: kili melomelo-Ê»uliÊ»uli, kili melomelo-Ê»uliÊ»uli
ğŸ„ğŸ¿â€â™€	fefine fÄnifo, fefine fÄnifo: kili Ê»uliÊ»uli, kili Ê»uliÊ»uli
ğŸš£	tokotaha Ê»aÊ»alo
ğŸš£ğŸ»	kili hinehina, tokotaha Ê»aÊ»alo, tokotaha Ê»aÊ»alo: kili hinehina
ğŸš£ğŸ¼	kili kelokelo, tokotaha Ê»aÊ»alo, tokotaha Ê»aÊ»alo: kili kelokelo
ğŸš£ğŸ½	kili melomelo, tokotaha Ê»aÊ»alo, tokotaha Ê»aÊ»alo: kili melomelo
ğŸš£ğŸ¾	kili melomelo-Ê»uliÊ»uli, tokotaha Ê»aÊ»alo, tokotaha Ê»aÊ»alo: kili melomelo-Ê»uliÊ»uli
ğŸš£ğŸ¿	kili Ê»uliÊ»uli, tokotaha Ê»aÊ»alo, tokotaha Ê»aÊ»alo: kili Ê»uliÊ»uli
ğŸš£â€â™‚	tangata Ê»aÊ»alo
ğŸš£ğŸ»â€â™‚	kili hinehina, tangata Ê»aÊ»alo, tangata Ê»aÊ»alo: kili hinehina
ğŸš£ğŸ¼â€â™‚	kili kelokelo, tangata Ê»aÊ»alo, tangata Ê»aÊ»alo: kili kelokelo
ğŸš£ğŸ½â€â™‚	kili melomelo, tangata Ê»aÊ»alo, tangata Ê»aÊ»alo: kili melomelo
ğŸš£ğŸ¾â€â™‚	kili melomelo-Ê»uliÊ»uli, tangata Ê»aÊ»alo, tangata Ê»aÊ»alo: kili melomelo-Ê»uliÊ»uli
ğŸš£ğŸ¿â€â™‚	kili Ê»uliÊ»uli, tangata Ê»aÊ»alo, tangata Ê»aÊ»alo: kili Ê»uliÊ»uli
ğŸš£â€â™€	fefine Ê»aÊ»alo
ğŸš£ğŸ»â€â™€	fefine Ê»aÊ»alo, fefine Ê»aÊ»alo: kili hinehina, kili hinehina
ğŸš£ğŸ¼â€â™€	fefine Ê»aÊ»alo, fefine Ê»aÊ»alo: kili kelokelo, kili kelokelo
ğŸš£ğŸ½â€â™€	fefine Ê»aÊ»alo, fefine Ê»aÊ»alo: kili melomelo, kili melomelo
ğŸš£ğŸ¾â€â™€	fefine Ê»aÊ»alo, fefine Ê»aÊ»alo: kili melomelo-Ê»uliÊ»uli, kili melomelo-Ê»uliÊ»uli
ğŸš£ğŸ¿â€â™€	fefine Ê»aÊ»alo, fefine Ê»aÊ»alo: kili Ê»uliÊ»uli, kili Ê»uliÊ»uli
ğŸŠï¸	tokotaha kakau
ğŸŠğŸ»	kili hinehina, tokotaha kakau, tokotaha kakau: kili hinehina
ğŸŠğŸ¼	kili kelokelo, tokotaha kakau, tokotaha kakau: kili kelokelo
ğŸŠğŸ½	kili melomelo, tokotaha kakau, tokotaha kakau: kili melomelo
ğŸŠğŸ¾	kili melomelo-Ê»uliÊ»uli, tokotaha kakau, tokotaha kakau: kili melomelo-Ê»uliÊ»uli
ğŸŠğŸ¿	kili Ê»uliÊ»uli, tokotaha kakau, tokotaha kakau: kili Ê»uliÊ»uli
ğŸŠâ€â™‚	tangata kakau
ğŸŠğŸ»â€â™‚	kili hinehina, tangata kakau, tangata kakau: kili hinehina
ğŸŠğŸ¼â€â™‚	kili kelokelo, tangata kakau, tangata kakau: kili kelokelo
ğŸŠğŸ½â€â™‚	kili melomelo, tangata kakau, tangata kakau: kili melomelo
ğŸŠğŸ¾â€â™‚	kili melomelo-Ê»uliÊ»uli, tangata kakau, tangata kakau: kili melomelo-Ê»uliÊ»uli
ğŸŠğŸ¿â€â™‚	kili Ê»uliÊ»uli, tangata kakau, tangata kakau: kili Ê»uliÊ»uli
ğŸŠâ€â™€	fefine kakau
ğŸŠğŸ»â€â™€	fefine kakau, fefine kakau: kili hinehina, kili hinehina
ğŸŠğŸ¼â€â™€	fefine kakau, fefine kakau: kili kelokelo, kili kelokelo
ğŸŠğŸ½â€â™€	fefine kakau, fefine kakau: kili melomelo, kili melomelo
ğŸŠğŸ¾â€â™€	fefine kakau, fefine kakau: kili melomelo-Ê»uliÊ»uli, kili melomelo-Ê»uliÊ»uli
ğŸŠğŸ¿â€â™€	fefine kakau, fefine kakau: kili Ê»uliÊ»uli, kili Ê»uliÊ»uli
â›¹ï¸	tokotaha tÅpuna pulu
â›¹ğŸ»	kili hinehina, tokotaha tÅpuna pulu, tokotaha tÅpuna pulu: kili hinehina
â›¹ğŸ¼	kili kelokelo, tokotaha tÅpuna pulu, tokotaha tÅpuna pulu: kili kelokelo
â›¹ğŸ½	kili melomelo, tokotaha tÅpuna pulu, tokotaha tÅpuna pulu: kili melomelo
â›¹ğŸ¾	kili melomelo-Ê»uliÊ»uli, tokotaha tÅpuna pulu, tokotaha tÅpuna pulu: kili melomelo-Ê»uliÊ»uli
â›¹ğŸ¿	kili Ê»uliÊ»uli, tokotaha tÅpuna pulu, tokotaha tÅpuna pulu: kili Ê»uliÊ»uli
â›¹â€â™‚	tangata tÅpuna pulu
â›¹ğŸ»â€â™‚	kili hinehina, tangata tÅpuna pulu, tangata tÅpuna pulu: kili hinehina
â›¹ğŸ¼â€â™‚	kili kelokelo, tangata tÅpuna pulu, tangata tÅpuna pulu: kili kelokelo
â›¹ğŸ½â€â™‚	kili melomelo, tangata tÅpuna pulu, tangata tÅpuna pulu: kili melomelo
â›¹ğŸ¾â€â™‚	kili melomelo-Ê»uliÊ»uli, tangata tÅpuna pulu, tangata tÅpuna pulu: kili melomelo-Ê»uliÊ»uli
â›¹ğŸ¿â€â™‚	kili Ê»uliÊ»uli, tangata tÅpuna pulu, tangata tÅpuna pulu: kili Ê»uliÊ»uli
â›¹â€â™€	fefine tÅpuna pulu
â›¹ğŸ»â€â™€	fefine tÅpuna pulu, fefine tÅpuna pulu: kili hinehina, kili hinehina
â›¹ğŸ¼â€â™€	fefine tÅpuna pulu, fefine tÅpuna pulu: kili kelokelo, kili kelokelo
â›¹ğŸ½â€â™€	fefine tÅpuna pulu, fefine tÅpuna pulu: kili melomelo, kili melomelo
â›¹ğŸ¾â€â™€	fefine tÅpuna pulu, fefine tÅpuna pulu: kili melomelo-Ê»uliÊ»uli, kili melomelo-Ê»uliÊ»uli
â›¹ğŸ¿â€â™€	fefine tÅpuna pulu, fefine tÅpuna pulu: kili Ê»uliÊ»uli, kili Ê»uliÊ»uli
ğŸ‹ï¸	tokotaha hiki meÊ»amamafa
ğŸ‹ğŸ»	kili hinehina, tokotaha hiki meÊ»amamafa, tokotaha hiki meÊ»amamafa: kili hinehina
ğŸ‹ğŸ¼	kili kelokelo, tokotaha hiki meÊ»amamafa, tokotaha hiki meÊ»amamafa: kili kelokelo
ğŸ‹ğŸ½	kili melomelo, tokotaha hiki meÊ»amamafa, tokotaha hiki meÊ»amamafa: kili melomelo
ğŸ‹ğŸ¾	kili melomelo-Ê»uliÊ»uli, tokotaha hiki meÊ»amamafa, tokotaha hiki meÊ»amamafa: kili melomelo-Ê»uliÊ»uli
ğŸ‹ğŸ¿	kili Ê»uliÊ»uli, tokotaha hiki meÊ»amamafa, tokotaha hiki meÊ»amamafa: kili Ê»uliÊ»uli
ğŸ‹â€â™‚	tangata hiki meÊ»amamafa
ğŸ‹ğŸ»â€â™‚	kili hinehina, tangata hiki meÊ»amamafa, tangata hiki meÊ»amamafa: kili hinehina
ğŸ‹ğŸ¼â€â™‚	kili kelokelo, tangata hiki meÊ»amamafa, tangata hiki meÊ»amamafa: kili kelokelo
ğŸ‹ğŸ½â€â™‚	kili melomelo, tangata hiki meÊ»amamafa, tangata hiki meÊ»amamafa: kili melomelo
ğŸ‹ğŸ¾â€â™‚	kili melomelo-Ê»uliÊ»uli, tangata hiki meÊ»amamafa, tangata hiki meÊ»amamafa: kili melomelo-Ê»uliÊ»uli
ğŸ‹ğŸ¿â€â™‚	kili Ê»uliÊ»uli, tangata hiki meÊ»amamafa, tangata hiki meÊ»amamafa: kili Ê»uliÊ»uli
ğŸ‹â€â™€	fefine hiki meÊ»amamafa
ğŸ‹ğŸ»â€â™€	fefine hiki meÊ»amamafa, fefine hiki meÊ»amamafa: kili hinehina, kili hinehina
ğŸ‹ğŸ¼â€â™€	fefine hiki meÊ»amamafa, fefine hiki meÊ»amamafa: kili kelokelo, kili kelokelo
ğŸ‹ğŸ½â€â™€	fefine hiki meÊ»amamafa, fefine hiki meÊ»amamafa: kili melomelo, kili melomelo
ğŸ‹ğŸ¾â€â™€	fefine hiki meÊ»amamafa, fefine hiki meÊ»amamafa: kili melomelo-Ê»uliÊ»uli, kili melomelo-Ê»uliÊ»uli
ğŸ‹ğŸ¿â€â™€	fefine hiki meÊ»amamafa, fefine hiki meÊ»amamafa: kili Ê»uliÊ»uli, kili Ê»uliÊ»uli
ğŸš´	tokotaha heka pasikala
ğŸš´ğŸ»	kili hinehina, tokotaha heka pasikala, tokotaha heka pasikala: kili hinehina
ğŸš´ğŸ¼	kili kelokelo, tokotaha heka pasikala, tokotaha heka pasikala: kili kelokelo
ğŸš´ğŸ½	kili melomelo, tokotaha heka pasikala, tokotaha heka pasikala: kili melomelo
ğŸš´ğŸ¾	kili melomelo-Ê»uliÊ»uli, tokotaha heka pasikala, tokotaha heka pasikala: kili melomelo-Ê»uliÊ»uli
ğŸš´ğŸ¿	kili Ê»uliÊ»uli, tokotaha heka pasikala, tokotaha heka pasikala: kili Ê»uliÊ»uli
ğŸš´â€â™‚	tangata heka pasikala
ğŸš´ğŸ»â€â™‚	kili hinehina, tangata heka pasikala, tangata heka pasikala: kili hinehina
ğŸš´ğŸ¼â€â™‚	kili kelokelo, tangata heka pasikala, tangata heka pasikala: kili kelokelo
ğŸš´ğŸ½â€â™‚	kili melomelo, tangata heka pasikala, tangata heka pasikala: kili melomelo
ğŸš´ğŸ¾â€â™‚	kili melomelo-Ê»uliÊ»uli, tangata heka pasikala, tangata heka pasikala: kili melomelo-Ê»uliÊ»uli
ğŸš´ğŸ¿â€â™‚	kili Ê»uliÊ»uli, tangata heka pasikala, tangata heka pasikala: kili Ê»uliÊ»uli
ğŸš´â€â™€	fefine heka pasikala
ğŸš´ğŸ»â€â™€	fefine heka pasikala, fefine heka pasikala: kili hinehina, kili hinehina
ğŸš´ğŸ¼â€â™€	fefine heka pasikala, fefine heka pasikala: kili kelokelo, kili kelokelo
ğŸš´ğŸ½â€â™€	fefine heka pasikala, fefine heka pasikala: kili melomelo, kili melomelo
ğŸš´ğŸ¾â€â™€	fefine heka pasikala, fefine heka pasikala: kili melomelo-Ê»uliÊ»uli, kili melomelo-Ê»uliÊ»uli
ğŸš´ğŸ¿â€â™€	fefine heka pasikala, fefine heka pasikala: kili Ê»uliÊ»uli, kili Ê»uliÊ»uli
ğŸšµ	tokotaha heka pasikala moÊ»unga
ğŸšµğŸ»	kili hinehina, tokotaha heka pasikala moÊ»unga, tokotaha heka pasikala moÊ»unga: kili hinehina
ğŸšµğŸ¼	kili kelokelo, tokotaha heka pasikala moÊ»unga, tokotaha heka pasikala moÊ»unga: kili kelokelo
ğŸšµğŸ½	kili melomelo, tokotaha heka pasikala moÊ»unga, tokotaha heka pasikala moÊ»unga: kili melomelo
ğŸšµğŸ¾	kili melomelo-Ê»uliÊ»uli, tokotaha heka pasikala moÊ»unga, tokotaha heka pasikala moÊ»unga: kili melomelo-Ê»uliÊ»uli
ğŸšµğŸ¿	kili Ê»uliÊ»uli, tokotaha heka pasikala moÊ»unga, tokotaha heka pasikala moÊ»unga: kili Ê»uliÊ»uli
ğŸšµâ€â™‚	tangata heka pasikala moÊ»unga
ğŸšµğŸ»â€â™‚	kili hinehina, tangata heka pasikala moÊ»unga, tangata heka pasikala moÊ»unga: kili hinehina
ğŸšµğŸ¼â€â™‚	kili kelokelo, tangata heka pasikala moÊ»unga, tangata heka pasikala moÊ»unga: kili kelokelo
ğŸšµğŸ½â€â™‚	kili melomelo, tangata heka pasikala moÊ»unga, tangata heka pasikala moÊ»unga: kili melomelo
ğŸšµğŸ¾â€â™‚	kili melomelo-Ê»uliÊ»uli, tangata heka pasikala moÊ»unga, tangata heka pasikala moÊ»unga: kili melomelo-Ê»uliÊ»uli
ğŸšµğŸ¿â€â™‚	kili Ê»uliÊ»uli, tangata heka pasikala moÊ»unga, tangata heka pasikala moÊ»unga: kili Ê»uliÊ»uli
ğŸšµâ€â™€	fefine heka pasikala moÊ»unga
ğŸšµğŸ»â€â™€	fefine heka pasikala moÊ»unga, fefine heka pasikala moÊ»unga: kili hinehina, kili hinehina
ğŸšµğŸ¼â€â™€	fefine heka pasikala moÊ»unga, fefine heka pasikala moÊ»unga: kili kelokelo, kili kelokelo
ğŸšµğŸ½â€â™€	fefine heka pasikala moÊ»unga, fefine heka pasikala moÊ»unga: kili melomelo, kili melomelo
ğŸšµğŸ¾â€â™€	fefine heka pasikala moÊ»unga, fefine heka pasikala moÊ»unga: kili melomelo-Ê»uliÊ»uli, kili melomelo-Ê»uliÊ»uli
ğŸšµğŸ¿â€â™€	fefine heka pasikala moÊ»unga, fefine heka pasikala moÊ»unga: kili Ê»uliÊ»uli, kili Ê»uliÊ»uli
ğŸ¤¸	tokotaha tÄkisi
ğŸ¤¸ğŸ»	kili hinehina, tokotaha tÄkisi, tokotaha tÄkisi: kili hinehina
ğŸ¤¸ğŸ¼	kili kelokelo, tokotaha tÄkisi, tokotaha tÄkisi: kili kelokelo
ğŸ¤¸ğŸ½	kili melomelo, tokotaha tÄkisi, tokotaha tÄkisi: kili melomelo
ğŸ¤¸ğŸ¾	kili melomelo-Ê»uliÊ»uli, tokotaha tÄkisi, tokotaha tÄkisi: kili melomelo-Ê»uliÊ»uli
ğŸ¤¸ğŸ¿	kili Ê»uliÊ»uli, tokotaha tÄkisi, tokotaha tÄkisi: kili Ê»uliÊ»uli
ğŸ¤¸â€â™‚	tangata tÄkisi
ğŸ¤¸ğŸ»â€â™‚	kili hinehina, tangata tÄkisi, tangata tÄkisi: kili hinehina
ğŸ¤¸ğŸ¼â€â™‚	kili kelokelo, tangata tÄkisi, tangata tÄkisi: kili kelokelo
ğŸ¤¸ğŸ½â€â™‚	kili melomelo, tangata tÄkisi, tangata tÄkisi: kili melomelo
ğŸ¤¸ğŸ¾â€â™‚	kili melomelo-Ê»uliÊ»uli, tangata tÄkisi, tangata tÄkisi: kili melomelo-Ê»uliÊ»uli
ğŸ¤¸ğŸ¿â€â™‚	kili Ê»uliÊ»uli, tangata tÄkisi, tangata tÄkisi: kili Ê»uliÊ»uli
ğŸ¤¸â€â™€	fefine tÄkisi
ğŸ¤¸ğŸ»â€â™€	fefine tÄkisi, fefine tÄkisi: kili hinehina, kili hinehina
ğŸ¤¸ğŸ¼â€â™€	fefine tÄkisi, fefine tÄkisi: kili kelokelo, kili kelokelo
ğŸ¤¸ğŸ½â€â™€	fefine tÄkisi, fefine tÄkisi: kili melomelo, kili melomelo
ğŸ¤¸ğŸ¾â€â™€	fefine tÄkisi, fefine tÄkisi: kili melomelo-Ê»uliÊ»uli, kili melomelo-Ê»uliÊ»uli
ğŸ¤¸ğŸ¿â€â™€	fefine tÄkisi, fefine tÄkisi: kili Ê»uliÊ»uli, kili Ê»uliÊ»uli
ğŸ¤¼	kakai fangatua
ğŸ¤¼â€â™‚	ongo tangata fangatua
ğŸ¤¼â€â™€	fafine fangatua
ğŸ¤½	tokotaha polovai
ğŸ¤½ğŸ»	kili hinehina, tokotaha polovai, tokotaha polovai: kili hinehina
ğŸ¤½ğŸ¼	kili kelokelo, tokotaha polovai, tokotaha polovai: kili kelokelo
ğŸ¤½ğŸ½	kili melomelo, tokotaha polovai, tokotaha polovai: kili melomelo
ğŸ¤½ğŸ¾	kili melomelo-Ê»uliÊ»uli, tokotaha polovai, tokotaha polovai: kili melomelo-Ê»uliÊ»uli
ğŸ¤½ğŸ¿	kili Ê»uliÊ»uli, tokotaha polovai, tokotaha polovai: kili Ê»uliÊ»uli
ğŸ¤½â€â™‚	tangata polovai
ğŸ¤½ğŸ»â€â™‚	kili hinehina, tangata polovai, tangata polovai: kili hinehina
ğŸ¤½ğŸ¼â€â™‚	kili kelokelo, tangata polovai, tangata polovai: kili kelokelo
ğŸ¤½ğŸ½â€â™‚	kili melomelo, tangata polovai, tangata polovai: kili melomelo
ğŸ¤½ğŸ¾â€â™‚	kili melomelo-Ê»uliÊ»uli, tangata polovai, tangata polovai: kili melomelo-Ê»uliÊ»uli
ğŸ¤½ğŸ¿â€â™‚	kili Ê»uliÊ»uli, tangata polovai, tangata polovai: kili Ê»uliÊ»uli
ğŸ¤½â€â™€	fefine polovai
ğŸ¤½ğŸ»â€â™€	fefine polovai, fefine polovai: kili hinehina, kili hinehina
ğŸ¤½ğŸ¼â€â™€	fefine polovai, fefine polovai: kili kelokelo, kili kelokelo
ğŸ¤½ğŸ½â€â™€	fefine polovai, fefine polovai: kili melomelo, kili melomelo
ğŸ¤½ğŸ¾â€â™€	fefine polovai, fefine polovai: kili melomelo-Ê»uliÊ»uli, kili melomelo-Ê»uliÊ»uli
ğŸ¤½ğŸ¿â€â™€	fefine polovai, fefine polovai: kili Ê»uliÊ»uli, kili Ê»uliÊ»uli
ğŸ¤¾	tokotaha netipolo
ğŸ¤¾ğŸ»	kili hinehina, tokotaha netipolo, tokotaha netipolo: kili hinehina
ğŸ¤¾ğŸ¼	kili kelokelo, tokotaha netipolo, tokotaha netipolo: kili kelokelo
ğŸ¤¾ğŸ½	kili melomelo, tokotaha netipolo, tokotaha netipolo: kili melomelo
ğŸ¤¾ğŸ¾	kili melomelo-Ê»uliÊ»uli, tokotaha netipolo, tokotaha netipolo: kili melomelo-Ê»uliÊ»uli
ğŸ¤¾ğŸ¿	kili Ê»uliÊ»uli, tokotaha netipolo, tokotaha netipolo: kili Ê»uliÊ»uli
ğŸ¤¾â€â™‚	tangata netipolo
ğŸ¤¾ğŸ»â€â™‚	kili hinehina, tangata netipolo, tangata netipolo: kili hinehina
ğŸ¤¾ğŸ¼â€â™‚	kili kelokelo, tangata netipolo, tangata netipolo: kili kelokelo
ğŸ¤¾ğŸ½â€â™‚	kili melomelo, tangata netipolo, tangata netipolo: kili melomelo
ğŸ¤¾ğŸ¾â€â™‚	kili melomelo-Ê»uliÊ»uli, tangata netipolo, tangata netipolo: kili melomelo-Ê»uliÊ»uli
ğŸ¤¾ğŸ¿â€â™‚	kili Ê»uliÊ»uli, tangata netipolo, tangata netipolo: kili Ê»uliÊ»uli
ğŸ¤¾â€â™€	fefine netipolo
ğŸ¤¾ğŸ»â€â™€	fefine netipolo, fefine netipolo: kili hinehina, kili hinehina
ğŸ¤¾ğŸ¼â€â™€	fefine netipolo, fefine netipolo: kili kelokelo, kili kelokelo
ğŸ¤¾ğŸ½â€â™€	fefine netipolo, fefine netipolo: kili melomelo, kili melomelo
ğŸ¤¾ğŸ¾â€â™€	fefine netipolo, fefine netipolo: kili melomelo-Ê»uliÊ»uli, kili melomelo-Ê»uliÊ»uli
ğŸ¤¾ğŸ¿â€â™€	fefine netipolo, fefine netipolo: kili Ê»uliÊ»uli, kili Ê»uliÊ»uli
ğŸ¤¹	tokotaha hiko
ğŸ¤¹ğŸ»	kili hinehina, tokotaha hiko, tokotaha hiko: kili hinehina
ğŸ¤¹ğŸ¼	kili kelokelo, tokotaha hiko, tokotaha hiko: kili kelokelo
ğŸ¤¹ğŸ½	kili melomelo, tokotaha hiko, tokotaha hiko: kili melomelo
ğŸ¤¹ğŸ¾	kili melomelo-Ê»uliÊ»uli, tokotaha hiko, tokotaha hiko: kili melomelo-Ê»uliÊ»uli
ğŸ¤¹ğŸ¿	kili Ê»uliÊ»uli, tokotaha hiko, tokotaha hiko: kili Ê»uliÊ»uli
ğŸ¤¹â€â™‚	tangata hiko
ğŸ¤¹ğŸ»â€â™‚	kili hinehina, tangata hiko, tangata hiko: kili hinehina
ğŸ¤¹ğŸ¼â€â™‚	kili kelokelo, tangata hiko, tangata hiko: kili kelokelo
ğŸ¤¹ğŸ½â€â™‚	kili melomelo, tangata hiko, tangata hiko: kili melomelo
ğŸ¤¹ğŸ¾â€â™‚	kili melomelo-Ê»uliÊ»uli, tangata hiko, tangata hiko: kili melomelo-Ê»uliÊ»uli
ğŸ¤¹ğŸ¿â€â™‚	kili Ê»uliÊ»uli, tangata hiko, tangata hiko: kili Ê»uliÊ»uli
ğŸ¤¹â€â™€	fefine hiko
ğŸ¤¹ğŸ»â€â™€	fefine hiko, fefine hiko: kili hinehina, kili hinehina
ğŸ¤¹ğŸ¼â€â™€	fefine hiko, fefine hiko: kili kelokelo, kili kelokelo
ğŸ¤¹ğŸ½â€â™€	fefine hiko, fefine hiko: kili melomelo, kili melomelo
ğŸ¤¹ğŸ¾â€â™€	fefine hiko, fefine hiko: kili melomelo-Ê»uliÊ»uli, kili melomelo-Ê»uliÊ»uli
ğŸ¤¹ğŸ¿â€â™€	fefine hiko, fefine hiko: kili Ê»uliÊ»uli, kili Ê»uliÊ»uli
ğŸ§˜	tokotaha tangutu fehauaki
ğŸ§˜ğŸ»	kili hinehina, tokotaha tangutu fehauaki, tokotaha tangutu fehauaki: kili hinehina
ğŸ§˜ğŸ¼	kili kelokelo, tokotaha tangutu fehauaki, tokotaha tangutu fehauaki: kili kelokelo
ğŸ§˜ğŸ½	kili melomelo, tokotaha tangutu fehauaki, tokotaha tangutu fehauaki: kili melomelo
ğŸ§˜ğŸ¾	kili melomelo-Ê»uliÊ»uli, tokotaha tangutu fehauaki, tokotaha tangutu fehauaki: kili melomelo-Ê»uliÊ»uli
ğŸ§˜ğŸ¿	kili Ê»uliÊ»uli, tokotaha tangutu fehauaki, tokotaha tangutu fehauaki: kili Ê»uliÊ»uli
ğŸ§˜â€â™‚	tangata tangutu fehauaki
ğŸ§˜ğŸ»â€â™‚	kili hinehina, tangata tangutu fehauaki, tangata tangutu fehauaki: kili hinehina
ğŸ§˜ğŸ¼â€â™‚	kili kelokelo, tangata tangutu fehauaki, tangata tangutu fehauaki: kili kelokelo
ğŸ§˜ğŸ½â€â™‚	kili melomelo, tangata tangutu fehauaki, tangata tangutu fehauaki: kili melomelo
ğŸ§˜ğŸ¾â€â™‚	kili melomelo-Ê»uliÊ»uli, tangata tangutu fehauaki, tangata tangutu fehauaki: kili melomelo-Ê»uliÊ»uli
ğŸ§˜ğŸ¿â€â™‚	kili Ê»uliÊ»uli, tangata tangutu fehauaki, tangata tangutu fehauaki: kili Ê»uliÊ»uli
ğŸ§˜â€â™€	fefine tangutu fehauaki
ğŸ§˜ğŸ»â€â™€	fefine tangutu fehauaki, fefine tangutu fehauaki: kili hinehina, kili hinehina
ğŸ§˜ğŸ¼â€â™€	fefine tangutu fehauaki, fefine tangutu fehauaki: kili kelokelo, kili kelokelo
ğŸ§˜ğŸ½â€â™€	fefine tangutu fehauaki, fefine tangutu fehauaki: kili melomelo, kili melomelo
ğŸ§˜ğŸ¾â€â™€	fefine tangutu fehauaki, fefine tangutu fehauaki: kili melomelo-Ê»uliÊ»uli, kili melomelo-Ê»uliÊ»uli
ğŸ§˜ğŸ¿â€â™€	fefine tangutu fehauaki, fefine tangutu fehauaki: kili Ê»uliÊ»uli, kili Ê»uliÊ»uli
ğŸ›€	tokotaha kaukau
ğŸ›€ğŸ»	kili hinehina, tokotaha kaukau, tokotaha kaukau: kili hinehina
ğŸ›€ğŸ¼	kili kelokelo, tokotaha kaukau, tokotaha kaukau: kili kelokelo
ğŸ›€ğŸ½	kili melomelo, tokotaha kaukau, tokotaha kaukau: kili melomelo
ğŸ›€ğŸ¾	kili melomelo-Ê»uliÊ»uli, tokotaha kaukau, tokotaha kaukau: kili melomelo-Ê»uliÊ»uli
ğŸ›€ğŸ¿	kili Ê»uliÊ»uli, tokotaha kaukau, tokotaha kaukau: kili Ê»uliÊ»uli
ğŸ›Œ	tokotaha Ê»i mohenga
ğŸ›ŒğŸ»	kili hinehina, tokotaha Ê»i mohenga, tokotaha Ê»i mohenga: kili hinehina
ğŸ›ŒğŸ¼	kili kelokelo, tokotaha Ê»i mohenga, tokotaha Ê»i mohenga: kili kelokelo
ğŸ›ŒğŸ½	kili melomelo, tokotaha Ê»i mohenga, tokotaha Ê»i mohenga: kili melomelo
ğŸ›ŒğŸ¾	kili melomelo-Ê»uliÊ»uli, tokotaha Ê»i mohenga, tokotaha Ê»i mohenga: kili melomelo-Ê»uliÊ»uli
ğŸ›ŒğŸ¿	kili Ê»uliÊ»uli, tokotaha Ê»i mohenga, tokotaha Ê»i mohenga: kili Ê»uliÊ»uli
ğŸ‘­	ongo fafine fetakinima
ğŸ‘­ğŸ»	kili hinehina, ongo fafine fetakinima, ongo fafine fetakinima: kili hinehina
ğŸ‘©ğŸ¼â€ğŸ¤â€ğŸ‘©ğŸ»	kili hinehina, kili kelokelo, ongo fafine fetakinima, ongo fafine fetakinima: kili kelokelo mo e kili hinehina
ğŸ‘­ğŸ¼	kili kelokelo, ongo fafine fetakinima, ongo fafine fetakinima: kili kelokelo
ğŸ‘©ğŸ½â€ğŸ¤â€ğŸ‘©ğŸ»	kili hinehina, kili melomelo, ongo fafine fetakinima, ongo fafine fetakinima: kili melomelo mo e kili hinehina
ğŸ‘©ğŸ½â€ğŸ¤â€ğŸ‘©ğŸ¼	kili kelokelo, kili melomelo, ongo fafine fetakinima, ongo fafine fetakinima: kili melomelo mo e kili kelokelo
ğŸ‘­ğŸ½	kili melomelo, ongo fafine fetakinima, ongo fafine fetakinima: kili melomelo
ğŸ‘©ğŸ¾â€ğŸ¤â€ğŸ‘©ğŸ»	kili hinehina, kili melomelo-Ê»uliÊ»uli, ongo fafine fetakinima, ongo fafine fetakinima: kili melomelo-Ê»uliÊ»uli mo e kili hinehina
ğŸ‘©ğŸ¾â€ğŸ¤â€ğŸ‘©ğŸ¼	kili kelokelo, kili melomelo-Ê»uliÊ»uli, ongo fafine fetakinima, ongo fafine fetakinima: kili melomelo-Ê»uliÊ»uli mo e kili kelokelo
ğŸ‘©ğŸ¾â€ğŸ¤â€ğŸ‘©ğŸ½	kili melomelo, kili melomelo-Ê»uliÊ»uli, ongo fafine fetakinima, ongo fafine fetakinima: kili melomelo-Ê»uliÊ»uli mo e kili melomelo
ğŸ‘­ğŸ¾	kili melomelo-Ê»uliÊ»uli, ongo fafine fetakinima, ongo fafine fetakinima: kili melomelo-Ê»uliÊ»uli
ğŸ‘©ğŸ¿â€ğŸ¤â€ğŸ‘©ğŸ»	kili hinehina, kili Ê»uliÊ»uli, ongo fafine fetakinima, ongo fafine fetakinima: kili Ê»uliÊ»uli mo e kili hinehina
ğŸ‘©ğŸ¿â€ğŸ¤â€ğŸ‘©ğŸ¼	kili kelokelo, kili Ê»uliÊ»uli, ongo fafine fetakinima, ongo fafine fetakinima: kili Ê»uliÊ»uli mo e kili kelokelo
ğŸ‘©ğŸ¿â€ğŸ¤â€ğŸ‘©ğŸ½	kili melomelo, kili Ê»uliÊ»uli, ongo fafine fetakinima, ongo fafine fetakinima: kili Ê»uliÊ»uli mo e kili melomelo
ğŸ‘©ğŸ¿â€ğŸ¤â€ğŸ‘©ğŸ¾	kili melomelo-Ê»uliÊ»uli, kili Ê»uliÊ»uli, ongo fafine fetakinima, ongo fafine fetakinima: kili Ê»uliÊ»uli mo e kili melomelo-Ê»uliÊ»uli
ğŸ‘­ğŸ¿	kili Ê»uliÊ»uli, ongo fafine fetakinima, ongo fafine fetakinima: kili Ê»uliÊ»uli
ğŸ‘«	tangata mo fefine fetakinima
ğŸ‘«ğŸ»	kili hinehina, tangata mo fefine fetakinima, tangata mo fefine fetakinima: kili hinehina
ğŸ‘©ğŸ»â€ğŸ¤â€ğŸ‘¨ğŸ¼	kili hinehina, kili kelokelo, tangata mo fefine fetakinima, tangata mo fefine fetakinima: kili hinehina mo e kili kelokelo
ğŸ‘©ğŸ»â€ğŸ¤â€ğŸ‘¨ğŸ½	kili hinehina, kili melomelo, tangata mo fefine fetakinima, tangata mo fefine fetakinima: kili hinehina mo e kili melomelo
ğŸ‘©ğŸ»â€ğŸ¤â€ğŸ‘¨ğŸ¾	kili hinehina, kili melomelo-Ê»uliÊ»uli, tangata mo fefine fetakinima, tangata mo fefine fetakinima: kili hinehina mo e kili melomelo-Ê»uliÊ»uli
ğŸ‘©ğŸ»â€ğŸ¤â€ğŸ‘¨ğŸ¿	kili hinehina, kili Ê»uliÊ»uli, tangata mo fefine fetakinima, tangata mo fefine fetakinima: kili hinehina mo e kili Ê»uliÊ»uli
ğŸ‘©ğŸ¼â€ğŸ¤â€ğŸ‘¨ğŸ»	kili hinehina, kili kelokelo, tangata mo fefine fetakinima, tangata mo fefine fetakinima: kili kelokelo mo e kili hinehina
ğŸ‘«ğŸ¼	kili kelokelo, tangata mo fefine fetakinima, tangata mo fefine fetakinima: kili kelokelo
ğŸ‘©ğŸ¼â€ğŸ¤â€ğŸ‘¨ğŸ½	kili kelokelo, kili melomelo, tangata mo fefine fetakinima, tangata mo fefine fetakinima: kili kelokelo mo e kili melomelo
ğŸ‘©ğŸ¼â€ğŸ¤â€ğŸ‘¨ğŸ¾	kili kelokelo, kili melomelo-Ê»uliÊ»uli, tangata mo fefine fetakinima, tangata mo fefine fetakinima: kili kelokelo mo e kili melomelo-Ê»uliÊ»uli
ğŸ‘©ğŸ¼â€ğŸ¤â€ğŸ‘¨ğŸ¿	kili kelokelo, kili Ê»uliÊ»uli, tangata mo fefine fetakinima, tangata mo fefine fetakinima: kili kelokelo mo e kili Ê»uliÊ»uli
ğŸ‘©ğŸ½â€ğŸ¤â€ğŸ‘¨ğŸ»	kili hinehina, kili melomelo, tangata mo fefine fetakinima, tangata mo fefine fetakinima: kili melomelo mo e kili hinehina
ğŸ‘©ğŸ½â€ğŸ¤â€ğŸ‘¨ğŸ¼	kili kelokelo, kili melomelo, tangata mo fefine fetakinima, tangata mo fefine fetakinima: kili melomelo mo e kili kelokelo
ğŸ‘«ğŸ½	kili melomelo, tangata mo fefine fetakinima, tangata mo fefine fetakinima: kili melomelo
ğŸ‘©ğŸ½â€ğŸ¤â€ğŸ‘¨ğŸ¾	kili melomelo, kili melomelo-Ê»uliÊ»uli, tangata mo fefine fetakinima, tangata mo fefine fetakinima: kili melomelo mo e kili melomelo-Ê»uliÊ»uli
ğŸ‘©ğŸ½â€ğŸ¤â€ğŸ‘¨ğŸ¿	kili melomelo, kili Ê»uliÊ»uli, tangata mo fefine fetakinima, tangata mo fefine fetakinima: kili melomelo mo e kili Ê»uliÊ»uli
ğŸ‘©ğŸ¾â€ğŸ¤â€ğŸ‘¨ğŸ»	kili hinehina, kili melomelo-Ê»uliÊ»uli, tangata mo fefine fetakinima, tangata mo fefine fetakinima: kili melomelo-Ê»uliÊ»uli mo e kili hinehina
ğŸ‘©ğŸ¾â€ğŸ¤â€ğŸ‘¨ğŸ¼	kili kelokelo, kili melomelo-Ê»uliÊ»uli, tangata mo fefine fetakinima, tangata mo fefine fetakinima: kili melomelo-Ê»uliÊ»uli mo e kili kelokelo
ğŸ‘©ğŸ¾â€ğŸ¤â€ğŸ‘¨ğŸ½	kili melomelo, kili melomelo-Ê»uliÊ»uli, tangata mo fefine fetakinima, tangata mo fefine fetakinima: kili melomelo-Ê»uliÊ»uli mo e kili melomelo
ğŸ‘«ğŸ¾	kili melomelo-Ê»uliÊ»uli, tangata mo fefine fetakinima, tangata mo fefine fetakinima: kili melomelo-Ê»uliÊ»uli
ğŸ‘©ğŸ¾â€ğŸ¤â€ğŸ‘¨ğŸ¿	kili melomelo-Ê»uliÊ»uli, kili Ê»uliÊ»uli, tangata mo fefine fetakinima, tangata mo fefine fetakinima: kili melomelo-Ê»uliÊ»uli mo e kili Ê»uliÊ»uli
ğŸ‘©ğŸ¿â€ğŸ¤â€ğŸ‘¨ğŸ»	kili hinehina, kili Ê»uliÊ»uli, tangata mo fefine fetakinima, tangata mo fefine fetakinima: kili Ê»uliÊ»uli mo e kili hinehina
ğŸ‘©ğŸ¿â€ğŸ¤â€ğŸ‘¨ğŸ¼	kili kelokelo, kili Ê»uliÊ»uli, tangata mo fefine fetakinima, tangata mo fefine fetakinima: kili Ê»uliÊ»uli mo e kili kelokelo
ğŸ‘©ğŸ¿â€ğŸ¤â€ğŸ‘¨ğŸ½	kili melomelo, kili Ê»uliÊ»uli, tangata mo fefine fetakinima, tangata mo fefine fetakinima: kili Ê»uliÊ»uli mo e kili melomelo
ğŸ‘©ğŸ¿â€ğŸ¤â€ğŸ‘¨ğŸ¾	kili melomelo-Ê»uliÊ»uli, kili Ê»uliÊ»uli, tangata mo fefine fetakinima, tangata mo fefine fetakinima: kili Ê»uliÊ»uli mo e kili melomelo-Ê»uliÊ»uli
ğŸ‘«ğŸ¿	kili Ê»uliÊ»uli, tangata mo fefine fetakinima, tangata mo fefine fetakinima: kili Ê»uliÊ»uli
ğŸ‘¬	ongo tangata fetakinima
ğŸ‘¬ğŸ»	kili hinehina, ongo tangata fetakinima, ongo tangata fetakinima: kili hinehina
ğŸ‘¨ğŸ¼â€ğŸ¤â€ğŸ‘¨ğŸ»	kili hinehina, kili kelokelo, ongo tangata fetakinima, ongo tangata fetakinima: kili kelokelo mo e kili hinehina
ğŸ‘¬ğŸ¼	kili kelokelo, ongo tangata fetakinima, ongo tangata fetakinima: kili kelokelo
ğŸ‘¨ğŸ½â€ğŸ¤â€ğŸ‘¨ğŸ»	kili hinehina, kili melomelo, ongo tangata fetakinima, ongo tangata fetakinima: kili melomelo mo e kili hinehina
ğŸ‘¨ğŸ½â€ğŸ¤â€ğŸ‘¨ğŸ¼	kili kelokelo, kili melomelo, ongo tangata fetakinima, ongo tangata fetakinima: kili melomelo mo e kili kelokelo
ğŸ‘¬ğŸ½	kili melomelo, ongo tangata fetakinima, ongo tangata fetakinima: kili melomelo
ğŸ‘¨ğŸ¾â€ğŸ¤â€ğŸ‘¨ğŸ»	kili hinehina, kili melomelo-Ê»uliÊ»uli, ongo tangata fetakinima, ongo tangata fetakinima: kili melomelo-Ê»uliÊ»uli mo e kili hinehina
ğŸ‘¨ğŸ¾â€ğŸ¤â€ğŸ‘¨ğŸ¼	kili kelokelo, kili melomelo-Ê»uliÊ»uli, ongo tangata fetakinima, ongo tangata fetakinima: kili melomelo-Ê»uliÊ»uli mo e kili kelokelo
ğŸ‘¨ğŸ¾â€ğŸ¤â€ğŸ‘¨ğŸ½	kili melomelo, kili melomelo-Ê»uliÊ»uli, ongo tangata fetakinima, ongo tangata fetakinima: kili melomelo-Ê»uliÊ»uli mo e kili melomelo
ğŸ‘¬ğŸ¾	kili melomelo-Ê»uliÊ»uli, ongo tangata fetakinima, ongo tangata fetakinima: kili melomelo-Ê»uliÊ»uli
ğŸ‘¨ğŸ¿â€ğŸ¤â€ğŸ‘¨ğŸ»	kili hinehina, kili Ê»uliÊ»uli, ongo tangata fetakinima, ongo tangata fetakinima: kili Ê»uliÊ»uli mo e kili hinehina
ğŸ‘¨ğŸ¿â€ğŸ¤â€ğŸ‘¨ğŸ¼	kili kelokelo, kili Ê»uliÊ»uli, ongo tangata fetakinima, ongo tangata fetakinima: kili Ê»uliÊ»uli mo e kili kelokelo
ğŸ‘¨ğŸ¿â€ğŸ¤â€ğŸ‘¨ğŸ½	kili melomelo, kili Ê»uliÊ»uli, ongo tangata fetakinima, ongo tangata fetakinima: kili Ê»uliÊ»uli mo e kili melomelo
ğŸ‘¨ğŸ¿â€ğŸ¤â€ğŸ‘¨ğŸ¾	kili melomelo-Ê»uliÊ»uli, kili Ê»uliÊ»uli, ongo tangata fetakinima, ongo tangata fetakinima: kili Ê»uliÊ»uli mo e kili melomelo-Ê»uliÊ»uli
ğŸ‘¬ğŸ¿	kili Ê»uliÊ»uli, ongo tangata fetakinima, ongo tangata fetakinima: kili Ê»uliÊ»uli
ğŸ’	Ê»uma
ğŸ‘©â€â¤â€ğŸ’‹â€ğŸ‘¨	fefine, tangata, Ê»uma, Ê»uma: fefine mo e tangata
ğŸ‘¨â€â¤â€ğŸ’‹â€ğŸ‘¨	tangata, Ê»uma, Ê»uma: tangata mo e tangata
ğŸ‘©â€â¤â€ğŸ’‹â€ğŸ‘©	fefine, Ê»uma, Ê»uma: fefine mo e fefine
ğŸ’‘	ongo tokoua moe mafu
ğŸ‘©â€â¤â€ğŸ‘¨	fefine, ongo tokoua moe mafu, ongo tokoua moe mafu: fefine mo e tangata, tangata
ğŸ‘¨â€â¤â€ğŸ‘¨	ongo tokoua moe mafu, ongo tokoua moe mafu: tangata mo e tangata, tangata
ğŸ‘©â€â¤â€ğŸ‘©	fefine, ongo tokoua moe mafu, ongo tokoua moe mafu: fefine mo e fefine
ğŸ‘ªï¸	fÄmili
ğŸ‘¨â€ğŸ‘©â€ğŸ‘¦	fefine, fÄmili, fÄmili: tangata, fefine mo e tamasiÊ»i, tamasiÊ»i, tangata
ğŸ‘¨â€ğŸ‘©â€ğŸ‘§	fefine, fÄmili, fÄmili: tangata, fefine mo e taÊ»ahine, tangata, taÊ»ahine
ğŸ‘¨â€ğŸ‘©â€ğŸ‘§â€ğŸ‘¦	fefine, fÄmili, fÄmili: tangata, fefine, taÊ»ahine mo e tamasiÊ»i, tamasiÊ»i, tangata, taÊ»ahine
ğŸ‘¨â€ğŸ‘©â€ğŸ‘¦â€ğŸ‘¦	fefine, fÄmili, fÄmili: tangata, fefine, tamasiÊ»i mo e tamasiÊ»i, tamasiÊ»i, tangata
ğŸ‘¨â€ğŸ‘©â€ğŸ‘§â€ğŸ‘§	fefine, fÄmili, fÄmili: tangata, fefine, taÊ»ahine mo e taÊ»ahine, tangata, taÊ»ahine
ğŸ‘¨â€ğŸ‘¨â€ğŸ‘¦	fÄmili, fÄmili: tangata, tangata mo e tamasiÊ»i, tamasiÊ»i, tangata
ğŸ‘¨â€ğŸ‘¨â€ğŸ‘§	fÄmili, fÄmili: tangata, tangata mo e taÊ»ahine, tangata, taÊ»ahine
ğŸ‘¨â€ğŸ‘¨â€ğŸ‘§â€ğŸ‘¦	fÄmili, fÄmili: tangata, tangata, taÊ»ahine mo e tamasiÊ»i, tamasiÊ»i, tangata, taÊ»ahine
ğŸ‘¨â€ğŸ‘¨â€ğŸ‘¦â€ğŸ‘¦	fÄmili, fÄmili: tangata, tangata, tamasiÊ»i mo e tamasiÊ»i, tamasiÊ»i, tangata
ğŸ‘¨â€ğŸ‘¨â€ğŸ‘§â€ğŸ‘§	fÄmili, fÄmili: tangata, tangata, taÊ»ahine mo e taÊ»ahine, tangata, taÊ»ahine
ğŸ‘©â€ğŸ‘©â€ğŸ‘¦	fefine, fÄmili, fÄmili: fefine, fefine mo e tamasiÊ»i, tamasiÊ»i
ğŸ‘©â€ğŸ‘©â€ğŸ‘§	fefine, fÄmili, fÄmili: fefine, fefine mo e taÊ»ahine, taÊ»ahine
ğŸ‘©â€ğŸ‘©â€ğŸ‘§â€ğŸ‘¦	fefine, fÄmili, fÄmili: fefine, fefine, taÊ»ahine mo e tamasiÊ»i, tamasiÊ»i, taÊ»ahine
ğŸ‘©â€ğŸ‘©â€ğŸ‘¦â€ğŸ‘¦	fefine, fÄmili, fÄmili: fefine, fefine, tamasiÊ»i mo e tamasiÊ»i, tamasiÊ»i
ğŸ‘©â€ğŸ‘©â€ğŸ‘§â€ğŸ‘§	fefine, fÄmili, fÄmili: fefine, fefine, taÊ»ahine mo e taÊ»ahine, taÊ»ahine
ğŸ‘¨â€ğŸ‘¦	fÄmili, fÄmili: tangata mo e tamasiÊ»i, tamasiÊ»i, tangata
ğŸ‘¨â€ğŸ‘¦â€ğŸ‘¦	fÄmili, fÄmili: tangata, tamasiÊ»i mo e tamasiÊ»i, tamasiÊ»i, tangata
ğŸ‘¨â€ğŸ‘§	fÄmili, fÄmili: tangata mo e taÊ»ahine, tangata, taÊ»ahine
ğŸ‘¨â€ğŸ‘§â€ğŸ‘¦	fÄmili, fÄmili: tangata, taÊ»ahine mo e tamasiÊ»i, tamasiÊ»i, tangata, taÊ»ahine
ğŸ‘¨â€ğŸ‘§â€ğŸ‘§	fÄmili, fÄmili: tangata, taÊ»ahine mo e taÊ»ahine, tangata, taÊ»ahine
ğŸ‘©â€ğŸ‘¦	fefine, fÄmili, fÄmili: fefine mo e tamasiÊ»i, tamasiÊ»i
ğŸ‘©â€ğŸ‘¦â€ğŸ‘¦	fefine, fÄmili, fÄmili: fefine, tamasiÊ»i mo e tamasiÊ»i, tamasiÊ»i
ğŸ‘©â€ğŸ‘§	fefine, fÄmili, fÄmili: fefine mo e taÊ»ahine, taÊ»ahine
ğŸ‘©â€ğŸ‘§â€ğŸ‘¦	fefine, fÄmili, fÄmili: fefine, taÊ»ahine mo e tamasiÊ»i, tamasiÊ»i, taÊ»ahine
ğŸ‘©â€ğŸ‘§â€ğŸ‘§	fefine, fÄmili, fÄmili: fefine, taÊ»ahine mo e taÊ»ahine, taÊ»ahine
ğŸ—£ï¸	mata talanoa
ğŸ‘¤	Ê»ata Ê»oe sino
ğŸ‘¥	ongo Ê»ata Ê»oe sino
ğŸ‘£	topuvaÊ»e
ğŸ¦°	kulokula, Ê»ulu, Ê»ulu kulokula
ğŸ¦±	mingimingi, Ê»ulu, Ê»ulu mingimingi
ğŸ¦³	hinÄ, Ê»ulu, Ê»ulu hinÄ
ğŸ¦²	kosi, tula, Ê»ulu, Ê»ulu tula
ğŸµ	mataÊ»i-ngeli
ğŸ’	ngeli
ğŸ¦	kolila
ğŸ¶	mataÊ»i-kulÄ«
ğŸ•ï¸	kulÄ«
ğŸ©	kulÄ« pÅ«teli
ğŸº	mataÊ»i-ulofi
ğŸ¦Š	mataÊ»i-fokisi
ğŸ¦	lakÅ«ni
ğŸ±	mataÊ»i-pusi
ğŸˆï¸	pusi
ğŸ¦	mataÊ»i-laione
ğŸ¯	mataÊ»i-taika
ğŸ…	taika
ğŸ†	lÄ“pati
ğŸ´	mataÊ»i-hoosi
ğŸ	hoosi
ğŸ¦„	mataÊ»i-meÊ»atuitaha
ğŸ¦“	sepelÄ
ğŸ¦Œ	tia
ğŸ®	mataÊ»i-pulu
ğŸ‚	pulu pokaÊ»i
ğŸƒ	pafalÅ
ğŸ„	pulu
ğŸ·	mataÊ»i-puaka
ğŸ–	puaka
ğŸ—	puaka fekai
ğŸ½	ihuÊ»i-puaka
ğŸ	sipi tau
ğŸ‘	sipi fefine
ğŸ	kosi
ğŸª	kÄmeli tuÊ»ahulataha
ğŸ«	kÄmeli tuÊ»ahulaua
ğŸ¦™	lama
ğŸ¦’	silafi
ğŸ˜	Ê»elefÄnite
ğŸ¦	lainosolosi
ğŸ¦›	hipopotama
ğŸ­	mataÊ»i-kumÄsiÊ»i
ğŸ	kumÄsiÊ»i
ğŸ€	kumÄ
ğŸ¹	kumÄ-feti
ğŸ°	mataÊ»i-lÄpisi
ğŸ‡	lÄpisi
ğŸ¿ï¸	sikueli
ğŸ¦”	puakatalatala
ğŸ¦‡	peka
ğŸ»	mataÊ»i-pea
ğŸ¨	pea-Ê»uliÊ»uli-moe-hinehina
ğŸ¼	mataÊ»i-pea-Ê»uliÊ»uli-moe-hinehina
ğŸ¦˜	kangikalÅ«
ğŸ¦¡	patisÄ“
ğŸ¾	topuvaÊ»e manu
ğŸ¦ƒ	pÄ«pÄ«
ğŸ”	moa
ğŸ“	moataÊ»ane
ğŸ£	fÅfoaÊ»imoa
ğŸ¤	Ê»uhikiÊ»imoa
ğŸ¥	Ê»uhikiÊ»imoa hanga mai
ğŸ¦ï¸	manupuna
ğŸ§	penikuini
ğŸ•Šï¸	lupe
ğŸ¦…	Ê»ikale
ğŸ¦†	pato
ğŸ¦¢	patolahi
ğŸ¦‰	lulu
ğŸ¦š	pÄ«koka
ğŸ¦œ	kakÄ
ğŸ¸	mataÊ»i-poto
ğŸŠ	kalokataile
ğŸ¢	fonu
ğŸ¦	moko
ğŸ	ngata
ğŸ²	mataÊ»i-talÄkoni
ğŸ‰	talÄkoni
ğŸ¦•	saulopoti
ğŸ¦–	tainosauli nifo mÄsila
ğŸ³	tofuaÊ»a puhi
ğŸ‹	tofuaÊ»a
ğŸ¬	pungopunga
ğŸŸï¸	ika
ğŸ 	ika he hakau
ğŸ¡	sokisoki
ğŸ¦ˆ	Ê»anga
ğŸ™	feke
ğŸš	keleÊ»a
ğŸŒ	Ê»elili
ğŸ¦‹	pepe
ğŸ›	kutu
ğŸœ	lÅ
ğŸ	hone
ğŸ	mongomonga
ğŸ¦—	kÄlihi
ğŸ•·ï¸	hina
ğŸ•¸ï¸	matamatakupenga
ğŸ¦‚	sikipio
ğŸ¦Ÿ	namu
ğŸ¦ 	siemu
ğŸ’	haÊ»inga matalaÊ»iÊ»akau
ğŸŒ¸	matalaÊ»i-seli
ğŸ’®	matalaÊ»iÊ»akau hinehina
ğŸµï¸	potupotutatau
ğŸŒ¹	lose
ğŸ¥€	mae
ğŸŒº	kaute
ğŸŒ»	siolaÊ»Ä
ğŸŒ¼	matalaÊ»iÊ»akau
ğŸŒ·	tiulipe
ğŸŒ±	pulopula
ğŸŒ²	Ê»akau lanumata maÊ»u pÄ“
ğŸŒ³	Ê»akau fakatÅlau
ğŸŒ´	fuÊ»u niu
ğŸŒµ	kakatisi
ğŸŒ¾	haÊ»inga laise
ğŸŒ¿	Ê»akau faitoÊ»o
â˜˜ï¸	sameloki
ğŸ€	kihikihipÄlangi lau Ê»e fÄ
ğŸ	lauÊ»i-mapele
ğŸ‚	lau kuo tÅ
ğŸƒ	lau ngaungaue matangi
ğŸ‡	kÄlepi
ğŸˆ	meleni-pÄlangi
ğŸ‰	meleni
ğŸŠ	moli
ğŸ‹	lemani
ğŸŒ	siaine
ğŸ	fainÄ
ğŸ¥­	mango
ğŸ	Ê»Äpele kula
ğŸ	Ê»Äpele mata
ğŸ	pea
ğŸ‘	piisi
ğŸ’	seli
ğŸ“	sitolÅpeli
ğŸ¥	kiui
ğŸ…	temata
ğŸ¥¥	foÊ»i niu
ğŸ¥‘	Ê»Ävoka
ğŸ†	paingani
ğŸ¥”	pateta
ğŸ¥•	kÄloti
ğŸŒ½	foÊ»i koane
ğŸŒ¶ï¸	polo
ğŸ¥’	kiukamipa
ğŸ¥¬	lÄ“tisi
ğŸ¥¦	kÄpisi
ğŸ„	fakamalu-Ê»a-tÄ“volo
ğŸ¥œ	pÄ«nati
ğŸŒ°	ifi
ğŸ	mÄ
ğŸ¥	mÄ kalipa
ğŸ¥–	mÄ lÅloa
ğŸ¥¨	pani mamio
ğŸ¥¯	pani mama
ğŸ¥	pani
ğŸ§€	siisi
ğŸ–	kanomate moe hui
ğŸ—	vaÊ»eÊ»i-moa
ğŸ¥©	kanomate fahi
ğŸ¥“	pÄ“kani
ğŸ”	hamipaka
ğŸŸ	pateta fakapaku
ğŸ•	pisa
ğŸŒ­	sÅsisi kulÄ« vela
ğŸ¥ª	sanuisi
ğŸŒ®	mÄ pelupelu
ğŸŒ¯	polito
ğŸ¥™	mÄ falati
ğŸ¥š	fuaÊ»imoa
ğŸ³	fakapaku
ğŸ¥˜	fakapaku meÊ»akai
ğŸ²	kulo meÊ»akai
ğŸ¥£	poulu moe sepuni
ğŸ¥—	salati
ğŸ¿	koane fakapaku
ğŸ§‚	masima
ğŸ¥«	meÊ»akai kapa
ğŸ±	puha meÊ»akai fakasiapani
ğŸ˜	pisikete laise
ğŸ™	puluÊ»i laise
ğŸš	laise moho
ğŸ›	laise kale
ğŸœ	kulo mao
ğŸ	sipeketi
ğŸ 	kumala tunu
ğŸ¢	Ê»oteni
ğŸ£	susi
ğŸ¤	Ê»uosiÊ»isiÊ»i fakapaku
ğŸ¥	keke ika
ğŸ¥®	keke mÄhina
ğŸ¡	faikakai fakasiapani
ğŸ¥Ÿ	tÅpai
ğŸ¥ 	pisikete talamonÅ«
ğŸ¥¡	kato meÊ»akai
ğŸ¦€	paka
ğŸ¦	Ê»uo
ğŸ¦	Ê»uosiÊ»isiÊ»i
ğŸ¦‘	ngÅ«feke
ğŸ¦	Ê»aisikilimi molÅ«
ğŸ§	Ê»aisitele
ğŸ¨	Ê»aisikilimi
ğŸ©	keke fakapaku
ğŸª	pisikete
ğŸ‚	keke Ê»aho fÄÊ»eleÊ»i
ğŸ°	keke
ğŸ§	ipukeke
ğŸ¥§	pai
ğŸ«	lole sokaleti
ğŸ¬	lole
ğŸ­	lolepopi
ğŸ®	kasitati
ğŸ¯	kulo hone
ğŸ¼	hinahuhu
ğŸ¥›	ipu huÊ»akau
â˜•ï¸	inu mÄfana
ğŸµ	ipu tÄ«
ğŸ¶	uaine-laise
ğŸ¾	hina moe Ê»umosi
ğŸ·	ipu sioÊ»ata uaine
ğŸ¸ï¸	ipu sioÊ»ata paati
ğŸ¹	Ê»otai
ğŸº	moki pia
ğŸ»	moki fakapaaki
ğŸ¥‚	ipu sioÊ»ata fakapaaki
ğŸ¥ƒ	ipu sioÊ»ata
ğŸ¥¤	ipu moe vaÊ»akauinu
ğŸ¥¢	vaÊ»akau kai
ğŸ½ï¸	huhukai moe helekai moe peleti
ğŸ´	huhukai moe helekai
ğŸ¥„	sÄ“puni
ğŸ”ª	hele paipa
ğŸº	tukuÊ»anga uaine
ğŸŒ	kolope Ê»asi mai Ê»Eulope-Ê»Afilika
ğŸŒï¸	kolope Ê»asi mai ongo Ê»Amelika
ğŸŒ	kolope Ê»asi mai Ê»Ä’sia-Ê»AositelÄ“lia
ğŸŒ	kolope moe ngaahi melitiane
ğŸ—ºï¸	mape Ê»o mÄmani
ğŸ—¾	mape Ê»oe Siapani
ğŸ§­	kÄpasa
ğŸ”ï¸	moÊ»unga Ê»ufiÊ»ufiÊ»aki he sinou
â›°ï¸	moÊ»unga
ğŸŒ‹	moÊ»ungaafi
ğŸ—»	moÊ»unga ko Fusi
ğŸ•ï¸	fakateniti
ğŸ–ï¸	matÄtahi moe fakamalu
ğŸœï¸	toafa
ğŸï¸	motu liÊ»ekina
ğŸï¸	paÊ»ake fakafonua
ğŸŸï¸	fale sipoti
ğŸ›ï¸	fale fakakalisi/loma
ğŸ—ï¸	langa fale
ğŸ§±	piliki
ğŸ˜ï¸	ngaahi fale
ğŸšï¸	lusaÊ»anga
ğŸ ï¸	fale
ğŸ¡	fale moe ngoue
ğŸ¢	fale Ê»Åfisi
ğŸ£	Ê»Åfisi lÄ«tohi fakasiapani
ğŸ¤	Ê»Åfisi lÄ«tohi
ğŸ¥	falemahaki
ğŸ¦	pangikÄ“
ğŸ¨	fale tali-fononga
ğŸ©	fale paÊ»umutu
ğŸª	falekoloa
ğŸ«	faleako
ğŸ¬	falekoloa lahi
ğŸ­ï¸	fale ngÄueÊ»anga
ğŸ¯	pÄlasi fakasiapani
ğŸ°	pÄlasi
ğŸ’’	mali
ğŸ—¼	taua TokiÅ
ğŸ—½	maka fakamanatu tauÊ»atÄina
â›ªï¸	falelotu
ğŸ•Œ	falelotu fakaÊ»isilami
ğŸ•	falelotu fakasiu
â›©ï¸	falelotu fakasiapani
ğŸ•‹	fale mÄÊ»oniÊ»oni fakaÊ»isilami
â›²ï¸	fauniteni
â›ºï¸	teniti
ğŸŒ	fuÊ»ukakapu
ğŸŒƒ	pÅ fetuÊ»uÊ»ia
ğŸ™ï¸	fale lalahi lotokolo
ğŸŒ„	hopo Ê»ae laÊ»Ä he funga moÊ»unga
ğŸŒ…	hopo Ê»ae laÊ»Ä
ğŸŒ†	fale lalahi lotokolo mamalu efiafi
ğŸŒ‡	tÅ Ê»ae laÊ»Ä
ğŸŒ‰	hala kavakava poÊ»uli
â™¨ï¸	vaipuna mao
ğŸ 	hoosi vaÊ»inga
ğŸ¡	veÊ»eteka vaÊ»inga
ğŸ¢	lola vaÊ»inga
ğŸ’ˆ	pou kosiÊ»ulu
ğŸª	teniti sÄkisi
ğŸš‚	mÄ«sini lÄ“lue
ğŸšƒ	sÄliote lÄ“lue
ğŸš„	lÄ“lue oma
ğŸš…	lÄ“lue oma fakasiapani
ğŸš†	lÄ“lue
ğŸš‡ï¸	lÄ“lue lalofonua
ğŸšˆ	kiÊ»i lÄ“lue
ğŸš‰	tauÊ»anga lÄ“lue
ğŸšŠ	talamu
ğŸš	lÄ“lue poutaha
ğŸš	hala lÄ“lue moÊ»unga
ğŸš‹	sÄliote talamu
ğŸšŒ	pasi
ğŸšï¸	pasi lele mai
ğŸš	pasi Ê»uhila
ğŸš	pasi iiki
ğŸš‘ï¸	meÊ»alele falemahaki
ğŸš’	meÊ»alele tÄmateafi
ğŸš“	meÊ»alele polisi
ğŸš”ï¸	meÊ»alele polisi lele mai
ğŸš•	meÊ»alele utakakai
ğŸš–	meÊ»alele utakakai lele mai
ğŸš—	meÊ»alele
ğŸš˜ï¸	meÊ»alele lele mai
ğŸš™	meÊ»alele sipoti
ğŸšš	loli tiliva
ğŸš›	loli uta lalahi
ğŸšœ	mÄ«sini taulani
ğŸï¸	meÊ»alele lova
ğŸï¸	motopaiki
ğŸ›µ	paiki sikuta
ğŸš²ï¸	pasikala
ğŸ›´	sikuta kauleka
ğŸ›¹	papasikeiti
ğŸš	tauÊ»anga pasi
ğŸ›£ï¸	hala lahi
ğŸ›¤ï¸	hala lÄ“lue
ğŸ›¢ï¸	talamulolo
â›½ï¸	pausa
ğŸš¨	maama meÊ»alele polisi
ğŸš¥	maama hala fakalava
ğŸš¦	maama hala tuÊ»utonu
ğŸ›‘	fakaÊ»ilonga tuÊ»u
ğŸš§	fakaÊ»ilonga ngÄue langa
âš“ï¸	taula
â›µï¸	vakalÄ
ğŸ›¶	pÅpao
ğŸš¤	vaka oma
ğŸ›³ï¸	vaka meili
â›´ï¸	vaka uta pÄsese
ğŸ›¥ï¸	vaka mÄ«sini
ğŸš¢	vakalahi
âœˆï¸	vakapuna
ğŸ›©ï¸	vakapuna iiki
ğŸ›«	vakapuna puna hake
ğŸ›¬	vakapuna puna hifo
ğŸ’º	sea
ğŸš	helikopeta
ğŸšŸ	lÄ“lue tÄupe lahi
ğŸš 	lÄ“lue tÄupe moÊ»unga
ğŸš¡	lÄ“lue tÄupe iiki
ğŸ›°ï¸	satelaite
ğŸš€	loketi
ğŸ›¸	peleti puna
ğŸ›ï¸	fafangu hotele
ğŸ§³	katoleta
âŒ›ï¸	sioÊ»ata fuataimi Ê»osi
â³ï¸	sioÊ»ata fuataimi teÊ»eki Ê»osi
âŒšï¸	uasi
â°	uasi fafangu
â±ï¸	uasi sipoti
â²ï¸	uasi talataimi
ğŸ•°ï¸	uasi tuÊ»ulotofale
ğŸ•›ï¸	hoko Ê»ae tahaua
ğŸ•§	haafe taha
ğŸ•ï¸	hoko Ê»ae taha
ğŸ•œ	haafe ua
ğŸ•‘ï¸	hoko Ê»ae ua
ğŸ•	haafe tolu
ğŸ•’ï¸	hoko Ê»ae tolu
ğŸ•	haafe fÄ
ğŸ•“ï¸	hoko Ê»ae fÄ
ğŸ•Ÿ	haafe nima
ğŸ•”ï¸	hoko Ê»ae nima
ğŸ• 	haafe ono
ğŸ••ï¸	hoko Ê»ae ono
ğŸ•¡	haafe fitu
ğŸ•–ï¸	hoko Ê»ae fitu
ğŸ•¢	haafe valu
ğŸ•—ï¸	hoko Ê»ae valu
ğŸ•£	haafe hiva
ğŸ•˜ï¸	hoko Ê»ae hiva
ğŸ•¤	haafe hongofulu
ğŸ•™ï¸	hoko Ê»ae hongofulu
ğŸ•¥	haafe tahataha
ğŸ•šï¸	hoko Ê»ae tahataha
ğŸ•¦	haafe tahaua
ğŸŒ‘	mate Ê»ae mÄhina
ğŸŒ’	mÄhina Ê»ilo Ê»ehe maama
ğŸŒ“	mÄhina tuÊ»u efiafi
ğŸŒ”	mÄhina matofi
ğŸŒ•ï¸	mÄhina kÄtoa
ğŸŒ–	mÄhina lekeleka
ğŸŒ—	mÄhina tuÊ»u hengihengi
ğŸŒ˜	mÄhina silipÅ
ğŸŒ™	mÄhina kalipa
ğŸŒš	mata mate Ê»ae mÄhina
ğŸŒ›	mata mÄhina tuÊ»u efiafi
ğŸŒœï¸	mata mÄhina tuÊ»u hengihengi
ğŸŒ¡ï¸	fuamÄfana
â˜€ï¸	laÊ»Ä
ğŸŒ	mata mÄhina kÄtoa
ğŸŒ	mata e laÊ»Ä
â­ï¸	fetuÊ»u
ğŸŒŸ	fetuÊ»u ngingila
ğŸŒ 	fetuÊ»u Ê»esiafi
ğŸŒŒ	kaniva
â˜ï¸	Ê»ao
â›…ï¸	laÊ»Ä Ê»aoÊ»aofia
â›ˆï¸	Ê»ao moe Ê»uha moe Ê»uhila
ğŸŒ¤ï¸	Ê»aoÊ»aofia siÊ»i
ğŸŒ¥ï¸	Ê»aoÊ»aofia lahi
ğŸŒ¦ï¸	Ê»aoÊ»aofia Ê»uha
ğŸŒ§ï¸	Ê»uha Ê»aoÊ»aofia
ğŸŒ¨ï¸	sinou Ê»aoÊ»aofia
ğŸŒ©ï¸	Ê»uhila Ê»aoÊ»aofia
ğŸŒªï¸	Ê»ahiohio
ğŸŒ«ï¸	kakapu
ğŸŒ¬ï¸	mataÊ»i matangi
ğŸŒ€	saikolone
ğŸŒˆ	Ê»Å«mata
ğŸŒ‚	tukuhifo fakamalu
â˜‚ï¸	teke fakamalu
â˜”ï¸	fakamalu Ê»ihe Ê»uha
â›±ï¸	fakamalu tuÊ»u
âš¡ï¸	volita mÄÊ»olunga
â„ï¸	foÊ»i sinou
â˜ƒï¸	tangata sinou Ê»ihe Ê»ea sinou
â›„ï¸	tangata sinou
â˜„ï¸	fetuÊ»u fuka
ğŸ”¥	afi
ğŸ’§	tulutÄ vai
ğŸŒŠ	peau
ğŸƒ	matahina
ğŸ„	Ê»akau kilisimasi
ğŸ†	fanaÊ»one
ğŸ‡	fanaÊ»one fetapatapaki
ğŸ§¨	Ê»one
âœ¨	fetapatapaki
ğŸˆ	foÊ»i pula
ğŸ‰	paatipuna
ğŸŠ	pulu konifeti
ğŸ‹	Ê»akau kÄtoanga-fetuÊ»u
ğŸ	ongo matapÄ-paini
ğŸ	tamapua fakasiapani
ğŸ	ika fakamanumanu
ğŸ	fafangu-matangi
ğŸ‘	vakai-mÄhina
ğŸ§§	sila kulokula
ğŸ€	lipine
ğŸ	lipine puha
ğŸ—ï¸	lipine fakamanatu
ğŸŸï¸	tikite fakahÅ«
ğŸ«	tikite
ğŸ–ï¸	mÄ“tali fakakautau
ğŸ†ï¸	fakapale
ğŸ…	mÄ“tali fakasipoti
ğŸ¥‡	mÄ“tali fika Ê»uluaki
ğŸ¥ˆ	mÄ“tali fika ua
ğŸ¥‰	mÄ“tali fika tolu
âš½ï¸	soka
âš¾ï¸	peisipolo
ğŸ¥	pulutenisi
ğŸ€	pasiketipolo
ğŸ	volipolo
ğŸˆ	Ê»akapulu fakaÊ»amelika
ğŸ‰	Ê»akapulu
ğŸ¾	tenisi
ğŸ¥	tisi puna
ğŸ³	tekapulu
ğŸ	kilikiti
ğŸ‘	hoki
ğŸ’	hokiÊ»aisi
ğŸ¥	hokiÊ»initiakula
ğŸ“	pingipongo
ğŸ¸	patiminitoni
ğŸ¥Š	letafuhu
ğŸ¥‹	teuteu fangatua
ğŸ¥…	kupenga kolo
â›³ï¸	fuka Ê»ihe luo
â›¸ï¸	sÅ« sikeiti Ê»aisi
ğŸ£	Ê»akau-taumÄtaÊ»u
ğŸ½	falani sipoti
ğŸ¿	heke sinou
ğŸ›·	hekeÊ»anga
ğŸ¥Œ	maka tolo
ğŸ¯	lotomÄlie Ê»oe tÄketi
ğŸ±	pulu fika 8
ğŸ”®	pulu kalisitala
ğŸ§¿	mana nasÄ
ğŸ®ï¸	vaÊ»inga vitiÅ
ğŸ•¹ï¸	Ê»akau vaÊ»inga
ğŸ°	mÄ«sini tÄ paÊ»anga
ğŸ²	taisi
ğŸ§©	laÊ»ilekileki
ğŸ§¸	pea tamapua
â™ ï¸	sipeiti
â™¥ï¸	haati
â™¦ï¸	taimani
â™£ï¸	kalapa
â™Ÿï¸	pate veimau
ğŸƒ	sioka
ğŸ€„ï¸	talakoni kulokula
ğŸ´	sioka matalaÊ»iÊ»akau
ğŸ­ï¸	faiva aati
ğŸ–¼ï¸	Ê»esiaÊ»i tÄ
ğŸ¨	tÄvalivali
ğŸ§µ	filo
ğŸ§¶	filo lalanga
ğŸ‘“ï¸	matasioÊ»ata
ğŸ•¶ï¸	matasioÊ»atalaÊ»Ä
ğŸ¥½	sioÊ»ata malu
ğŸ¥¼	kote kemi
ğŸ‘”	hÄ“kesi
ğŸ‘•	falani
ğŸ‘–	talausese
ğŸ§£	sikaafi
ğŸ§¤	kofunima
ğŸ§¥	kote
ğŸ§¦	sitÅkeni
ğŸ‘—	kofu
ğŸ‘˜	kimono, vala
ğŸ‘™	vala matÄtahi
ğŸ‘š	vala fefine
ğŸ‘›	kato paÊ»anga
ğŸ‘œ	kato
ğŸ‘	peesi teuteu
ğŸ›ï¸	kato faÊ»oÊ»anga fakatau
ğŸ’	kato ako
ğŸ‘	sÅ« fakatangata
ğŸ‘Ÿ	sÅ« lele
ğŸ¥¾	sÅ« puti Ê»eva lalo
ğŸ¥¿	sÅ« fakafefine
ğŸ‘ 	sÅ« Ê»ete
ğŸ‘¡	saniteli fakafefine
ğŸ‘¢	sÅ« puti fakafefine
ğŸ‘‘	kalauni
ğŸ‘’	tatÄ fakafefine
ğŸ©	tatÄ mÄÊ»olunga
ğŸ“ï¸	tatÄ maÊ»u mataÊ»itohi
ğŸ§¢	kepi peisipolo
â›‘ï¸	tatÄ fefeka
ğŸ“¿	kulalotu
ğŸ’„	lipisitiki
ğŸ’	mama
ğŸ’	maka koloa
ğŸ”‡	leÊ»o matafa
ğŸ”ˆï¸	leÊ»o siÊ»i
ğŸ”‰	leÊ»o loto
ğŸ”Š	leÊ»o lahi
ğŸ“¢	sipika
ğŸ“£	meÊ»a fakaleÊ»olahi
ğŸ“¯	meÊ»a fakakÅkÅ
ğŸ””	fafangu
ğŸ”•	fafangu matafa
ğŸ¼	pepa hiva
ğŸµ	nota
ğŸ¶	ngaahi nota
ğŸ™ï¸	maikalofone fakamafolalea
ğŸšï¸	meÊ»atoÊ»o tohoÊ»i
ğŸ›ï¸	meÊ»atoÊ»o puleÊ»i
ğŸ¤	maikalofone
ğŸ§ï¸	sipika Ê»ulu
ğŸ“»ï¸	letiÅ
ğŸ·	sakisefoni
ğŸ¸	kitÄ
ğŸ¹	Ê»Å« kÄ«
ğŸº	meÊ»aifi
ğŸ»	vaiolini
ğŸ¥	nafa
ğŸ“±	foni toÊ»otoÊ»o
ğŸ“²	foni toÊ»otoÊ»o moe ngahau
â˜ï¸	telefoni
ğŸ“	meÊ»a fakaongo
ğŸ“Ÿï¸	foni kikÄ«
ğŸ“ 	foni tohi
ğŸ”‹	maka
ğŸ”Œ	Ê»umosi Ê»uhila
ğŸ’»ï¸	komipiuta fungasino
ğŸ–¥ï¸	komipiuta
ğŸ–¨ï¸	mÄ«sini paaki
âŒ¨ï¸	ngaahi foÊ»i kÄ«
ğŸ–±ï¸	kumÄ fakakomipiuta
ğŸ–²ï¸	polo toho
ğŸ’½	tisi fefeka
ğŸ’¾	tisi molÅ«
ğŸ’¿ï¸	tisi mamata
ğŸ“€	tisi faiva
ğŸ§®	solopani
ğŸ¥	faitÄ heleÊ»uhila
ğŸï¸	Ê»ata heleÊ»uhila
ğŸ“½ï¸	mÄ«sini heleÊ»uhila
ğŸ¬ï¸	papapasi
ğŸ“ºï¸	televÄ«sone
ğŸ“·ï¸	faitÄ
ğŸ“¸	faitÄ moe kasa
ğŸ“¹ï¸	faitÄ vitiÅ
ğŸ“¼	kasete vitiÅ
ğŸ”	sioÊ»ata Ê»esiafi falala ki hema
ğŸ”	sioÊ»ata Ê»esiafi falala ki mataÊ»u
ğŸ•¯ï¸	teÊ»elango
ğŸ’¡	foÊ»i Ê»uhila
ğŸ”¦	kasa
ğŸ®	maama matangi kulokula
ğŸ“”	pepa tohi teuÊ»i
ğŸ“•	tohi mapuni
ğŸ“–	tohi fakaava
ğŸ“—	tohi lanumata
ğŸ“˜	tohi lanupulÅ«
ğŸ“™	tohi lanumoli
ğŸ“šï¸	Ê»Å« tohi
ğŸ““	pepa tohi
ğŸ“’	lÄ“tisa
ğŸ“ƒ	pepa fafatu
ğŸ“œ	takainga tohi
ğŸ“„	pepa hanga hake
ğŸ“°	nusipepa
ğŸ—	nusipepa takainga
ğŸ“‘	vahevahe tohi
ğŸ”–	fakaÊ»ilonga tohi
ğŸ·ï¸	fakaÊ»ilonga
ğŸ’°ï¸	tangai paÊ»anga
ğŸ’´	laÊ»i paÊ»anga fakasiapani
ğŸ’µ	laÊ»i paÊ»anga fakaÊ»amelika
ğŸ’¶	laÊ»i paÊ»anga fakaÊ»eulope
ğŸ’·	laÊ»i paÊ»anga fakapilitania
ğŸ’¸	paÊ»anga moe kapakau
ğŸ’³ï¸	kaati pangikÄ“
ğŸ§¾	lisiti
ğŸ’¹	siate tupulaki, paÊ»anga fakasiapani
ğŸ’±	paÊ»anga fakafetongi
ğŸ’²	fakaÊ»ilonga paÊ»anga mamafa
âœ‰ï¸	sila
ğŸ“§	tohila
ğŸ“¨	sila hÅ«mai
ğŸ“©	sila moe ngahau
ğŸ“¤ï¸	laulau hÅ« atu
ğŸ“¥ï¸	laulau hÅ« mai
ğŸ“¦ï¸	kofukofu
ğŸ“«ï¸	puha meili mapuni moe fuka ki Ê»olunga
ğŸ“ªï¸	puha meili mapuni moe fuka ki lalo
ğŸ“¬ï¸	puha meili ava moe fuka ki Ê»olunga
ğŸ“­ï¸	puha meili ava moe fuka ki lalo
ğŸ“®	puha lÄ«tohi
ğŸ—³ï¸	puha fili moe pepa fili
âœï¸	peni
âœ’ï¸	mataÊ»ipeni
ğŸ–‹ï¸	peniÊ»utu
ğŸ–Šï¸	polopeni
ğŸ–Œï¸	polosi vali
ğŸ–ï¸	sioka tÄvalivali
ğŸ“	pepa fakamanatu
ğŸ’¼	kato leta toÊ»otoÊ»o
ğŸ“	takafi faile
ğŸ“‚	takafi faile ava
ğŸ—‚ï¸	vahevahe takafi faile
ğŸ“…	tohimÄhina
ğŸ“†	tohimÄhina fakaÊ»aho
ğŸ—’ï¸	pepa fakamaÊ»u vilovilo
ğŸ—“ï¸	tohimÄhina fakamaÊ»u vilovilo
ğŸ“‡	tohi fakahinohino fakamaÊ»u vilovilo
ğŸ“ˆ	siate tupulaki
ğŸ“‰	siate maholo
ğŸ“Š	siate pÄ
ğŸ“‹ï¸	papa fakamaÊ»u pepa
ğŸ“Œ	pine
ğŸ“	pine fuopotopoto
ğŸ“	fakamaÊ»u pepa
ğŸ–‡ï¸	fakamaÊ»u pepa sÄ“ini
ğŸ“	lula hangatonu
ğŸ“	lula tapatolu
âœ‚ï¸	helekosi
ğŸ—ƒï¸	puha takafi faile
ğŸ—„ï¸	toloa takafi faile
ğŸ—‘ï¸	kapa veve
ğŸ”’ï¸	loka
ğŸ”“ï¸	taÊ»eloka
ğŸ”	loka moe peni
ğŸ”	loka moe kÄ«
ğŸ”‘	kÄ«
ğŸ—ï¸	kÄ« motuÊ»a
ğŸ”¨	hamala
â›ï¸	toki tÄkelekele
âš’ï¸	hamala moe toki tÄkelekele
ğŸ› ï¸	hamala moe sipana
ğŸ—¡ï¸	hele tui
âš”ï¸	heletÄ fehauaki
ğŸ”«	pekenene
ğŸ¹	kaufana moe ngahau
ğŸ›¡ï¸	pÄ
ğŸ”§	sipana
ğŸ”©	nati moe polota
âš™ï¸	veÊ»eteka
ğŸ—œï¸	fakauÊ»u
âš–ï¸	meÊ»a fuamamafa
ğŸ”—	kupu
â›“ï¸	sÄ“ini
ğŸ§°	puha meÊ»angÄue
ğŸ§²	makinito
âš—ï¸	hina hakaÊ»anga
ğŸ§ª	tiupi kemi
ğŸ§«	tisi kemi
ğŸ§¬	TNA
ğŸ”¬	meÊ»a fakaÊ»ataefu
ğŸ”­	meÊ»a fakaÊ»atafetuÊ»u
ğŸ“¡	tisi satelaite
ğŸ’‰	meÊ»afana faitoÊ»o
ğŸ’Š	foÊ»iÊ»akau
ğŸšª	matapÄ
ğŸ›ï¸	mohenga
ğŸ›‹ï¸	sea mÄlÅlÅÊ»anga moe maama
ğŸš½	po toileti
ğŸš¿	meÊ»a fakapihi kaukau
ğŸ›	topu kaukau
ğŸ§´	hina kilimi milimili
ğŸ§·	pine nÄpikeni
ğŸ§¹	taufale
ğŸ§º	kato lÄlanga
ğŸ§»	takainga pepa
ğŸ§¼	koa
ğŸ§½	oma
ğŸ§¯	meÊ»a tÄmateÊ»i afi
ğŸ›’	saliote tanakiÊ»anga fakatau
ğŸš¬	sikaleti
âš°ï¸	puha tanu
âš±ï¸	hina fakamomofi
ğŸ—¿	Lapanui, moai
ğŸ§	mÄ«sini, mÄ«sini toho paÊ»anga, pangikÄ“, toho paÊ»anga
ğŸš®	kapa veve, veve, Ê»ilonga, Ê»ilonga kapa veve
ğŸš°	inu, vai, vai inu
â™¿ï¸	sea poliÅ
ğŸš¹ï¸	fale mÄlÅlÅ, fale mÄlÅlÅ tangata, tangata
ğŸšºï¸	fale mÄlÅlÅ, fale mÄlÅlÅ fefine, fefine
ğŸš»	fale mÄlÅlÅ
ğŸš¼ï¸	valevale, Ê»ilonga, Ê»ilonga valevale
ğŸš¾	fale mÄlÅlÅ, toileti
ğŸ›‚	Ê»ofisa tohifolau
ğŸ›ƒ	kasitomu, tute
ğŸ›„	maÊ»uÊ»anga katoleta
ğŸ›…	toloa katoleta
âš ï¸	fakatokanga, feÊ»aluÊ»aki
ğŸš¸	feÊ»aluÊ»aki, fÄnau, fÄnau kolosiÊ»anga, kolosiÊ»anga
â›”ï¸	feÊ»aluÊ»aki, hÅ«, tapu, tapu hÅ«
ğŸš«	feÊ»aluÊ»aki, tapu
ğŸš³	feÊ»aluÊ»aki, pasikala, tapu, tapu pasikala
ğŸš­ï¸	ifi tapaka, tapu, tapu ifi tapaka
ğŸš¯	fakaveve, tapu, tapu fakaveve
ğŸš±	inu, tapu, vai, vai taÊ»e inu
ğŸš·	feÊ»aluÊ»aki, lue, tapu, tapu lue
ğŸ“µ	tapu, tapu telefoni, telefoni
ğŸ”	18, tapu, tapu taÊ»u 18 hifo, taÊ»u 18 hifo
â˜¢ï¸	mofi Ê»Ätomi, Ê»ilonga
â˜£ï¸	fakatuÊ»utÄmaki moÊ»ui, Ê»ilonga
â¬†ï¸	hake, ngahau, ngahau ki Ê»olunga, Ê»olunga
â†—ï¸	mataÊ»u, ngahau, ngahau ki Ê»olunga toÊ»omataÊ»u, Ê»olunga
â¡ï¸	mataÊ»u, ngahau, ngahau ki toÊ»omataÊ»u
â†˜ï¸	lalo, mataÊ»u, ngahau, ngahau ki lalo toÊ»omataÊ»u
â¬‡ï¸	hifo, lalo, ngahau, ngahau ki lalo
â†™ï¸	hema, lalo, ngahau, ngahau ki lalo toÊ»ohema
â¬…ï¸	hema, ngahau, ngahau ki toÊ»ohema
â†–ï¸	hema, ngahau, ngahau ki Ê»olunga toÊ»ohema, Ê»olunga
â†•ï¸	hake, hifo, lalo, ngahau, ngahau ki Ê»olunga mo lalo, Ê»olunga
â†”ï¸	hema, mataÊ»u, ngahau, ngahau ki toÊ»ohema mo toÊ»omataÊ»u
â†©ï¸	afe, hema, ngahau, ngahau afe ki toÊ»ohema
â†ªï¸	afe, mataÊ»u, ngahau, ngahau afe ki toÊ»omataÊ»u
â¤´ï¸	afe, hake, ngahau, ngahau afe ki Ê»olunga, Ê»olunga
â¤µï¸	afe, hifo, lalo, ngahau, ngahau afe ki lalo
ğŸ”ƒ	mataÊ»u, ngahau, ngahau vilovilo toÊ»omataÊ»u, vilovilo
ğŸ”„	hema, ngahau, ngahau vilovilo toÊ»ohema, vilovilo
ğŸ”™	FOKI, ngahau, ngahau FOKI
ğŸ”š	NGATA, ngahau, ngahau NGATA
ğŸ”›	FUNGA, ngahau, ngahau FUNGA
ğŸ”œ	OFI, ngahau, ngahau OFI
ğŸ”	TUMUTUMU, hake, ngahau, ngahau TUMUTUMU
ğŸ›	feituÊ»u, feituÊ»u faiÊ»anga lotu, lotu
âš›ï¸	taÊ»elotu, Ê»ilonga, Ê»Ätomi
ğŸ•‰ï¸	HinitÅ«, lotu, omikala
âœ¡ï¸	Siu, TÄ“vita, fetuÊ»u, fetuÊ»u Ê»o TÄ“vita, lotu
â˜¸ï¸	veÊ»eteka Ê»o TÄma
â˜¯ï¸	ingi-iangi
âœï¸	kolosi fakalatina
â˜¦ï¸	kolosi fakakalisi
â˜ªï¸	fetuÊ»u moe kalipa
â˜®ï¸	Ê»ilonga fakamelino
ğŸ•	menola
ğŸ”¯	fetuÊ»u tapaono moe Ê»ila
â™ˆï¸	Sipi tangata (pupunga)
â™‰ï¸	Pulu tau (pupunga)
â™Šï¸	MÄhanga taÊ»ane (pupunga)
â™‹ï¸	Ê»Uo (pupunga)
â™Œï¸	Laione (pupunga)
â™ï¸	TaupoÊ»ou (pupunga)
â™ï¸	Fuatautau (pupunga)
â™ï¸	Sikipio (pupunga)
â™ï¸	Tangata fana (pupunga)
â™‘ï¸	Kositahi (pupunga)
â™’ï¸	FineÊ»utuvai (pupunga)
â™“ï¸	Ongo ika (pupunga)
â›	Tangata toÊ»o ngata (pupunga)
ğŸ”€	meÊ»alolomi tuifio
ğŸ”	meÊ»alolomi toutou
ğŸ”‚	meÊ»alolomi toe tuÊ»otaha
â–¶	meÊ»alolomi tÄ
â©	meÊ»alolomi fakalaka vave
â­	meÊ»alolomi fasi hoko
â¯	meÊ»alolomi tÄ pe tatali
â—€	meÊ»alolomi foki
âª	meÊ»alolomi foki vave
â®	meÊ»alolomi fasi kimuÊ»a
ğŸ”¼	meÊ»alolomi hake
â«	meÊ»alolomi hake vave
ğŸ”½	meÊ»alolomi hifo
â¬	meÊ»alolomi hifo vave
â¸ï¸	meÊ»alolomi tatali
â¹ï¸	meÊ»alolomi taÊ»ofi
âºï¸	meÊ»alolomi hiki
âï¸	meÊ»alolomi toÊ»o
ğŸ¦	fale heleÊ»uhila
ğŸ”…	meÊ»alolomi fakapÅpÅÊ»uli
ğŸ”†	meÊ»alolomi fakamaama
ğŸ“¶	pÄ lave
ğŸ“³	foni tetetete
ğŸ“´	foni toÊ»otoÊ»o tÄmateÊ»i
â™€ï¸	Ê»ilonga fakafefine
â™‚ï¸	Ê»ilonga fakatangata
âš•ï¸	Ê»ilonga tÅketÄ
â™¾ï¸	taÊ»engata
â™»ï¸	Ê»ilonga ngÄueÊ»aki foÊ»ou
âšœ	Ê»ilonga lile
ğŸ”±	tao matatolu
ğŸ“›	kaati hingoa
ğŸ”°	tokotaha langalangafoÊ»ou fakasiapani
â­•ï¸	fuopotopoto mamafa
âœ…	fakaÊ»ilonga sivi hinehina
â˜‘ï¸	pepa fili moe fakaÊ»ilonga sivi
âœ”ï¸	fakaÊ»ilonga sivi mamafa
âœ–ï¸	fakaÊ»ilonga liunga mamafa
âŒ	fakaÊ»ilonga kolosi
â	meÊ»alolomi fakaÊ»ilonga kolosi
â•	fakaÊ»ilonga tÄnaki mamafa
â–	fakaÊ»ilonga kole mamafa
â—	fakaÊ»ilonga vahevahe mamafa
â°	laine fakasÄkisi
â¿	laine fakasÄkisi lÅua
ã€½ï¸	fakaÊ»ilonga liliu faÊ»ahi
âœ³ï¸	fakaÊ»ilonga fakafetuÊ»u huelovalu
âœ´ï¸	fakaÊ»ilonga fakafetuÊ»u tapavalu
â‡ï¸	Ê»ilonga fetapatapaki
â€¼ï¸	fakaÊ»iloÊ»ilonga kalanga
â‰ï¸	fakaÊ»iloÊ»ilonga kalanga-fehuÊ»i
â“ï¸	fakaÊ»ilonga fehuÊ»i
â”	fakaÊ»ilonga fehuÊ»i hinehina
â•	fakaÊ»ilonga kalanga hinehina
â—ï¸	fakaÊ»ilonga kalanga
ã€°ï¸	fakaÊ»ilonga kohi fafasi
Â©ï¸	fakaÊ»ilonga mafai-pulusi
Â®ï¸	fakaÊ»ilonga lÄ“sisita
â„¢ï¸	fakaÊ»ilonga fefakatauÊ»aki
#âƒ£	tatÄ foÊ»i kÄ«, tatÄ foÊ»i kÄ«: #
*âƒ£	tatÄ foÊ»i kÄ«, tatÄ foÊ»i kÄ«: *
0âƒ£	tatÄ foÊ»i kÄ«, tatÄ foÊ»i kÄ«: 0
1âƒ£	tatÄ foÊ»i kÄ«, tatÄ foÊ»i kÄ«: 1
2âƒ£	tatÄ foÊ»i kÄ«, tatÄ foÊ»i kÄ«: 2
3âƒ£	tatÄ foÊ»i kÄ«, tatÄ foÊ»i kÄ«: 3
4âƒ£	tatÄ foÊ»i kÄ«, tatÄ foÊ»i kÄ«: 4
5âƒ£	tatÄ foÊ»i kÄ«, tatÄ foÊ»i kÄ«: 5
6âƒ£	tatÄ foÊ»i kÄ«, tatÄ foÊ»i kÄ«: 6
7âƒ£	tatÄ foÊ»i kÄ«, tatÄ foÊ»i kÄ«: 7
8âƒ£	tatÄ foÊ»i kÄ«, tatÄ foÊ»i kÄ«: 8
9âƒ£	tatÄ foÊ»i kÄ«, tatÄ foÊ»i kÄ«: 9
ğŸ”Ÿ	tatÄ foÊ»i kÄ«, tatÄ foÊ»i kÄ«: 10
ğŸ” 	hÅ« mataÊ»itohi lahi pÄ“
ğŸ”¡	hÅ« mataÊ»itohi siÊ»i pÄ“
ğŸ”¢	hÅ« mataÊ»ifika pÄ“
ğŸ”£	hÅ« fakaÊ»ilonga pÄ“
ğŸ”¤	hÅ« mataÊ»itohi fakalatina
ğŸ…°ï¸	meÊ»alolomi faÊ»ahinga toto A
ğŸ†	meÊ»alolomi faÊ»ahinga toto AB
ğŸ…±ï¸	meÊ»alolomi faÊ»ahinga toto B
ğŸ†‘	meÊ»alolomi CL
ğŸ†’	meÊ»alolomi COOL
ğŸ†“	meÊ»alolomi FREE
â„¹ï¸	fakaÊ»ilonga fakamatala
ğŸ†”	meÊ»alolomi ID
â“‚ï¸	fakaÊ»ilonga M fuopotopoto
ğŸ†•	meÊ»alolomi NEW
ğŸ†–	meÊ»alolomi NG
ğŸ…¾ï¸	meÊ»alolomi faÊ»ahinga toto O
ğŸ†—	meÊ»alolomi OK
ğŸ…¿ï¸	meÊ»alolomi P
ğŸ†˜	meÊ»alolomi SOS
ğŸ†™	meÊ»alolomi UP!
ğŸ†š	meÊ»alolomi VS
ğŸˆ	meÊ»alolomi Â«Ê»i heniÂ» (fakasiapani)
ğŸˆ‚ï¸	fakasiapani, meÊ»alolomi, meÊ»alolomi Â«totongi faifatongiaÂ» (fakasiapani), totongi faifatongia
ğŸˆ·	fakasiapani, meÊ»alolomi, meÊ»alolomi Â«moÊ»ua fakamÄhinaÂ» (fakasiapani), moÊ»ua fakamÄhina
ğŸˆ¶	meÊ»alolomi Â«totongiÂ» (fakasiapani)
ğŸˆ¯	meÊ»alolomi Â«taÊ»ofiÂ» (fakasiapani)
ğŸ‰	meÊ»alolomi Â«maÊ»amaÊ»aÂ» (fakasiapani)
ğŸˆ¹	meÊ»alolomi Â«fakamaÊ»amaÊ»aÂ» (fakasiapani)
ğŸˆš	meÊ»alolomi Â«taÊ»etotongiÂ» (fakasiapani)
ğŸˆ²	meÊ»alolomi Â«tapuÂ» (fakasiapani)
ğŸ‰‘	meÊ»alolomi Â«ala taliÂ» (fakasiapani)
ğŸˆ¸	meÊ»alolomi Â«Ê»ai heniÂ» (fakasiapani)
ğŸˆ´	meÊ»alolomi Â«fika lavaÂ» (fakasiapani)
ğŸˆ³	meÊ»alolomi Â«loki Ê»atÄÂ» (fakasiapani)
ãŠ—ï¸	meÊ»alolomi Â«fakamÄlÅÂ» (fakasiapani)
ãŠ™ï¸	meÊ»alolomi Â«liloliloÂ» (fakasiapani)
ğŸˆº	meÊ»alolomi Â«ava he ngÄueÂ» (fakasiapani)
ğŸˆµ	meÊ»alolomi Â«hala loki Ê»atÄÂ» (fakasiapani)
ğŸ”´	fuopotopoto kulokula
ğŸ”µ	fuopotopoto lanupulÅ«
âš«ï¸	fuopotopoto Ê»uluÊ»uli
âšªï¸	fuopotopoto hinehina
â¬›ï¸	tapafÄ lahi mo Ê»uliÊ»uli
â¬œï¸	tapafÄ lahi mo hinehina
â—¼ï¸	tapafÄ tauloto mo Ê»uliÊ»uli
â—»ï¸	tapafÄ tauloto mo hinehina
â—¾ï¸	tapafÄ siÊ»i mo Ê»uliÊ»uli
â—½ï¸	tapafÄ siÊ»i mo hinehina
â–ªï¸	tapafÄ siÊ»isiÊ»i mo Ê»uliÊ»uli
â–«ï¸	tapafÄ siÊ»isiÊ»i mo hinehina
ğŸ”¶	taiamoni lahi mo lanumoli
ğŸ”·	taiamoni lahi mo lanupulÅ«
ğŸ”¸	taiamoni siÊ»i mo lanumoli
ğŸ”¹	taiamoni siÊ»i mo lanupulÅ«
ğŸ”º	tapatolu ki Ê»olunga kulokula
ğŸ”»	tapatolu kulokula ki lalo
ğŸ’ 	taiamoni moe Ê»ila
ğŸ”˜	meÊ»alolomi lÄ“tio
ğŸ”³	meÊ»alolomi tapafÄ hinehina
ğŸ”²	meÊ»alolomi tapafÄ Ê»uliÊ»uli
ğŸ	fuka, fuka lova, lova
ğŸš©	fuka, fuka tapatolu, tapatolu
ğŸŒ	fehauaki, fuka, fuka fehauaki, siapani
ğŸ´	fuka, fuka Ê»uliÊ»uli, Ê»uliÊ»uli
ğŸ³ï¸	fuka, fuka hinehina, hinehina
ğŸ³â€ğŸŒˆ	fuka, fuka Ê»Å«mata, Ê»Å«mata
ğŸ´â€â˜ 	fuka, fuka kaihaÊ»atahi, kaihaÊ»atahi
ğŸ‡¦ğŸ‡¨	fuka, fuka: Motu Ê»Asenisini
ğŸ‡¦ğŸ‡©	fuka, fuka: Ê»Anitola
ğŸ‡¦ğŸ‡ª	fuka, fuka: Ê»Alepea Fakatahataha
ğŸ‡¦ğŸ‡«	fuka, fuka: Ê»AfikÄnisitani
ğŸ‡¦ğŸ‡¬	fuka, fuka: Anitikua mo Palaputa
ğŸ‡¦ğŸ‡®	fuka, fuka: Anikuila
ğŸ‡¦ğŸ‡±	fuka, fuka: Ê»Alipania
ğŸ‡¦ğŸ‡²	fuka, fuka: Ê»Ä€menia
ğŸ‡¦ğŸ‡´	fuka, fuka: Ê»Angikola
ğŸ‡¦ğŸ‡¶	fuka, fuka: Ê»AnitÄtika
ğŸ‡¦ğŸ‡·	fuka, fuka: Ê»Asenitina
ğŸ‡¦ğŸ‡¸	fuka, fuka: HaÊ»amoa Ê»Amelika
ğŸ‡¦ğŸ‡¹	fuka, fuka: Ê»Aositulia
ğŸ‡¦ğŸ‡º	fuka, fuka: Ê»AositelÄ“lia
ğŸ‡¦ğŸ‡¼	fuka, fuka: Ê»Alupa
ğŸ‡¦ğŸ‡½	fuka, fuka: Ê»Otumotu Ê»Alani
ğŸ‡¦ğŸ‡¿	fuka, fuka: Ê»Asapaisani
ğŸ‡§ğŸ‡¦	fuka, fuka: Posinia mo HesikÅvina
ğŸ‡§ğŸ‡§	fuka, fuka: PÄpeitosi
ğŸ‡§ğŸ‡©	fuka, fuka: PengilÄtesi
ğŸ‡§ğŸ‡ª	fuka, fuka: Pelesiume
ğŸ‡§ğŸ‡«	fuka, fuka: Pekano Faso
ğŸ‡§ğŸ‡¬	fuka, fuka: Pulukalia
ğŸ‡§ğŸ‡­	fuka, fuka: Paleini
ğŸ‡§ğŸ‡®	fuka, fuka: Puluniti
ğŸ‡§ğŸ‡¯	fuka, fuka: Penini
ğŸ‡§ğŸ‡±	fuka, fuka: SÄ PatÄ“lemi
ğŸ‡§ğŸ‡²	fuka, fuka: PÄ“muta
ğŸ‡§ğŸ‡³	fuka, fuka: Pulunei
ğŸ‡§ğŸ‡´	fuka, fuka: PolÄ«via
ğŸ‡§ğŸ‡¶	fuka, fuka: Kalipiane fakahÅlani
ğŸ‡§ğŸ‡·	fuka, fuka: PalÄsili
ğŸ‡§ğŸ‡¸	fuka, fuka: Pahama
ğŸ‡§ğŸ‡¹	fuka, fuka: PÅ«tani
ğŸ‡§ğŸ‡»	fuka, fuka: Motu Puveti
ğŸ‡§ğŸ‡¼	fuka, fuka: Potisiuana
ğŸ‡§ğŸ‡¾	fuka, fuka: Pelalusi
ğŸ‡§ğŸ‡¿	fuka, fuka: Pelise
ğŸ‡¨ğŸ‡¦	fuka, fuka: KÄnata
ğŸ‡¨ğŸ‡¨	fuka, fuka: Ê»Otumotu Koko
ğŸ‡¨ğŸ‡©	fuka, fuka: Kongo - Kinisasa
ğŸ‡¨ğŸ‡«	fuka, fuka: Lepupelika Ê»Afilika Lotoloto
ğŸ‡¨ğŸ‡¬	fuka, fuka: Kongo - Palasavila
ğŸ‡¨ğŸ‡­	fuka, fuka: Suisilani
ğŸ‡¨ğŸ‡®	fuka, fuka: Matafonua Ê»AivolÄ«
ğŸ‡¨ğŸ‡°	fuka, fuka: Ê»Otumotu Kuki
ğŸ‡¨ğŸ‡±	fuka, fuka: Sili
ğŸ‡¨ğŸ‡²	fuka, fuka: Kameluni
ğŸ‡¨ğŸ‡³	fuka, fuka: Siaina
ğŸ‡¨ğŸ‡´	fuka, fuka: Kolomipia
ğŸ‡¨ğŸ‡µ	fuka, fuka: Motu Kilipatoni
ğŸ‡¨ğŸ‡·	fuka, fuka: Kosita Lika
ğŸ‡¨ğŸ‡º	fuka, fuka: Kiupa
ğŸ‡¨ğŸ‡»	fuka, fuka: MuiÊ»i VÄ“te
ğŸ‡¨ğŸ‡¼	fuka, fuka: Kulasao
ğŸ‡¨ğŸ‡½	fuka, fuka: Motu Kilisimasi
ğŸ‡¨ğŸ‡¾	fuka, fuka: Saipalesi
ğŸ‡¨ğŸ‡¿	fuka, fuka: SÄ“kia
ğŸ‡©ğŸ‡ª	fuka, fuka: Siamane
ğŸ‡©ğŸ‡¬	fuka, fuka: Tieko KÄsia
ğŸ‡©ğŸ‡¯	fuka, fuka: Siputi
ğŸ‡©ğŸ‡°	fuka, fuka: TenimaÊ»ake
ğŸ‡©ğŸ‡²	fuka, fuka: Tominika
ğŸ‡©ğŸ‡´	fuka, fuka: Lepupelika Tominika
ğŸ‡©ğŸ‡¿	fuka, fuka: Ê»Alisilia
ğŸ‡ªğŸ‡¦	fuka, fuka: Siuta mo Melila
ğŸ‡ªğŸ‡¨	fuka, fuka: Ê»Ekuetoa
ğŸ‡ªğŸ‡ª	fuka, fuka: Ê»EsitÅnia
ğŸ‡ªğŸ‡¬	fuka, fuka: Ê»Isipite
ğŸ‡ªğŸ‡­	fuka, fuka: Sahala fakahihifo
ğŸ‡ªğŸ‡·	fuka, fuka: Ê»Elitulia
ğŸ‡ªğŸ‡¸	fuka, fuka: Sipeini
ğŸ‡ªğŸ‡¹	fuka, fuka: Ê»ÄªtiÅpia
ğŸ‡ªğŸ‡º	fuka, fuka: Ê»Eulope fakatahataha
ğŸ‡«ğŸ‡®	fuka, fuka: Finilani
ğŸ‡«ğŸ‡¯	fuka, fuka: Fisi
ğŸ‡«ğŸ‡°	fuka, fuka: Ê»Otumotu Fokulani
ğŸ‡«ğŸ‡²	fuka, fuka: MikolonÄ«sia
ğŸ‡«ğŸ‡´	fuka, fuka: Ê»Otumotu Faloe
ğŸ‡«ğŸ‡·	fuka, fuka: FalanisÄ“
ğŸ‡¬ğŸ‡¦	fuka, fuka: Kaponi
ğŸ‡¬ğŸ‡§	fuka, fuka: PilitÄnia
ğŸ‡¬ğŸ‡©	fuka, fuka: KelenatÄ
ğŸ‡¬ğŸ‡ª	fuka, fuka: SeÅsia
ğŸ‡¬ğŸ‡«	fuka, fuka: Kuiana fakafalanisÄ“
ğŸ‡¬ğŸ‡¬	fuka, fuka: KuenisÄ«
ğŸ‡¬ğŸ‡­	fuka, fuka: Kana
ğŸ‡¬ğŸ‡®	fuka, fuka: SipalÄlitÄ
ğŸ‡¬ğŸ‡±	fuka, fuka: Kulinilani
ğŸ‡¬ğŸ‡²	fuka, fuka: Kamipia
ğŸ‡¬ğŸ‡³	fuka, fuka: Kini
ğŸ‡¬ğŸ‡µ	fuka, fuka: Kuatalupe
ğŸ‡¬ğŸ‡¶	fuka, fuka: Ê»Ekueta Kini
ğŸ‡¬ğŸ‡·	fuka, fuka: Kalisi
ğŸ‡¬ğŸ‡¸	fuka, fuka: Ê»Otumotu SeÅsia-tonga mo Saniuisi-tonga
ğŸ‡¬ğŸ‡¹	fuka, fuka: Kuatamala
ğŸ‡¬ğŸ‡º	fuka, fuka: Kuamu
ğŸ‡¬ğŸ‡¼	fuka, fuka: Kini-Pisau
ğŸ‡¬ğŸ‡¾	fuka, fuka: Kuiana
ğŸ‡­ğŸ‡°	fuka, fuka: Hongi Kongi SAR Siaina
ğŸ‡­ğŸ‡²	fuka, fuka: Ê»Otumotu Heati mo Makitonali
ğŸ‡­ğŸ‡³	fuka, fuka: Honitulasi
ğŸ‡­ğŸ‡·	fuka, fuka: Kuloisia
ğŸ‡­ğŸ‡¹	fuka, fuka: Haiti
ğŸ‡­ğŸ‡º	fuka, fuka: Hungakalia
ğŸ‡®ğŸ‡¨	fuka, fuka: Ê»Otumotu Kaneli
ğŸ‡®ğŸ‡©	fuka, fuka: Ê»InitonÄ“sia
ğŸ‡®ğŸ‡ª	fuka, fuka: Ê»Aealani
ğŸ‡®ğŸ‡±	fuka, fuka: Ê»Isileli
ğŸ‡®ğŸ‡²	fuka, fuka: Motu Mani
ğŸ‡®ğŸ‡³	fuka, fuka: Ê»Initia
ğŸ‡®ğŸ‡´	fuka, fuka: Potu fonua moana Ê»Initia fakapilitÄnia
ğŸ‡®ğŸ‡¶	fuka, fuka: Ê»Ilaaki
ğŸ‡®ğŸ‡·	fuka, fuka: Ê»Ilaani
ğŸ‡®ğŸ‡¸	fuka, fuka: Ê»Aisilani
ğŸ‡®ğŸ‡¹	fuka, fuka: Ê»Äªtali
ğŸ‡¯ğŸ‡ª	fuka, fuka: SelusÄ«
ğŸ‡¯ğŸ‡²	fuka, fuka: Samaika
ğŸ‡¯ğŸ‡´	fuka, fuka: Soatane
ğŸ‡¯ğŸ‡µ	fuka, fuka: Siapani
ğŸ‡°ğŸ‡ª	fuka, fuka: KeniÄ
ğŸ‡°ğŸ‡¬	fuka, fuka: KÄ«kisitani
ğŸ‡°ğŸ‡­	fuka, fuka: KamipÅtia
ğŸ‡°ğŸ‡®	fuka, fuka: Kilipasi
ğŸ‡°ğŸ‡²	fuka, fuka: Komolosi
ğŸ‡°ğŸ‡³	fuka, fuka: SÄ Kitisi mo Nevisi
ğŸ‡°ğŸ‡µ	fuka, fuka: KÅlea tokelau
ğŸ‡°ğŸ‡·	fuka, fuka: KÅlea tonga
ğŸ‡°ğŸ‡¼	fuka, fuka: Kueiti
ğŸ‡°ğŸ‡¾	fuka, fuka: Ê»Otumotu Keimeni
ğŸ‡°ğŸ‡¿	fuka, fuka: Kasakitani
ğŸ‡±ğŸ‡¦	fuka, fuka: Lau
ğŸ‡±ğŸ‡§	fuka, fuka: Lepanoni
ğŸ‡±ğŸ‡¨	fuka, fuka: SÄ LÅ«sia
ğŸ‡±ğŸ‡®	fuka, fuka: Likitenisiteini
ğŸ‡±ğŸ‡°	fuka, fuka: SÄ«langikÄ
ğŸ‡±ğŸ‡·	fuka, fuka: Laipelia
ğŸ‡±ğŸ‡¸	fuka, fuka: Lesoto
ğŸ‡±ğŸ‡¹	fuka, fuka: Lituania
ğŸ‡±ğŸ‡º	fuka, fuka: Lakisimipeki
ğŸ‡±ğŸ‡»	fuka, fuka: Lativia
ğŸ‡±ğŸ‡¾	fuka, fuka: LÄ«pia
ğŸ‡²ğŸ‡¦	fuka, fuka: Moloko
ğŸ‡²ğŸ‡¨	fuka, fuka: Monako
ğŸ‡²ğŸ‡©	fuka, fuka: Molotova
ğŸ‡²ğŸ‡ª	fuka, fuka: Monitenikalo
ğŸ‡²ğŸ‡«	fuka, fuka: SÄ MÄtini (fakafalanisÄ“)
ğŸ‡²ğŸ‡¬	fuka, fuka: Matakasika
ğŸ‡²ğŸ‡­	fuka, fuka: Ê»Otumotu MÄsolo
ğŸ‡²ğŸ‡°	fuka, fuka: MasetÅnia
ğŸ‡²ğŸ‡±	fuka, fuka: MÄli
ğŸ‡²ğŸ‡²	fuka, fuka: MianimÄ (Pema)
ğŸ‡²ğŸ‡³	fuka, fuka: MongokÅlia
ğŸ‡²ğŸ‡´	fuka, fuka: Makau SAR Siaina
ğŸ‡²ğŸ‡µ	fuka, fuka: Ê»Otumotu Maliana tokelau
ğŸ‡²ğŸ‡¶	fuka, fuka: MÄtiniki
ğŸ‡²ğŸ‡·	fuka, fuka: Maulitenia
ğŸ‡²ğŸ‡¸	fuka, fuka: MoÊ»ungaselati
ğŸ‡²ğŸ‡¹	fuka, fuka: Malita
ğŸ‡²ğŸ‡º	fuka, fuka: Maulitiusi
ğŸ‡²ğŸ‡»	fuka, fuka: Malativisi
ğŸ‡²ğŸ‡¼	fuka, fuka: Malaui
ğŸ‡²ğŸ‡½	fuka, fuka: Mekisikou
ğŸ‡²ğŸ‡¾	fuka, fuka: MalÄ“sia
ğŸ‡²ğŸ‡¿	fuka, fuka: MosÄ“mipiki
ğŸ‡³ğŸ‡¦	fuka, fuka: Namipia
ğŸ‡³ğŸ‡¨	fuka, fuka: Niu KaletÅnia
ğŸ‡³ğŸ‡ª	fuka, fuka: Nisia
ğŸ‡³ğŸ‡«	fuka, fuka: Motu NÅfoliki
ğŸ‡³ğŸ‡¬	fuka, fuka: Naisilia
ğŸ‡³ğŸ‡®	fuka, fuka: Nikalakua
ğŸ‡³ğŸ‡±	fuka, fuka: HÅlani
ğŸ‡³ğŸ‡´	fuka, fuka: NoauÄ“
ğŸ‡³ğŸ‡µ	fuka, fuka: Nepali
ğŸ‡³ğŸ‡·	fuka, fuka: Naulu
ğŸ‡³ğŸ‡º	fuka, fuka: NiuÄ“
ğŸ‡³ğŸ‡¿	fuka, fuka: NuÊ»usila
ğŸ‡´ğŸ‡²	fuka, fuka: Ê»Omani
ğŸ‡µğŸ‡¦	fuka, fuka: PanamÄ
ğŸ‡µğŸ‡ª	fuka, fuka: PelÅ«
ğŸ‡µğŸ‡«	fuka, fuka: Polinisia fakafalanisÄ“
ğŸ‡µğŸ‡¬	fuka, fuka: Papuaniukini
ğŸ‡µğŸ‡­	fuka, fuka: Filipaini
ğŸ‡µğŸ‡°	fuka, fuka: PÄkisitani
ğŸ‡µğŸ‡±	fuka, fuka: Polani
ğŸ‡µğŸ‡²	fuka, fuka: SÄ Piea mo Mikeloni
ğŸ‡µğŸ‡³	fuka, fuka: Ê»Otumotu Pitikeni
ğŸ‡µğŸ‡·	fuka, fuka: PuÄ“to Liko
ğŸ‡µğŸ‡¸	fuka, fuka: Potu Palesitaine
ğŸ‡µğŸ‡¹	fuka, fuka: Potukali
ğŸ‡µğŸ‡¼	fuka, fuka: Palau
ğŸ‡µğŸ‡¾	fuka, fuka: Palakuai
ğŸ‡¶ğŸ‡¦	fuka, fuka: KatÄ
ğŸ‡·ğŸ‡ª	fuka, fuka: LÄ“unioni
ğŸ‡·ğŸ‡´	fuka, fuka: LomÄ“nia
ğŸ‡·ğŸ‡¸	fuka, fuka: SÄ“pia
ğŸ‡·ğŸ‡º	fuka, fuka: LÅ«sia
ğŸ‡·ğŸ‡¼	fuka, fuka: LuanitÄ
ğŸ‡¸ğŸ‡¦	fuka, fuka: Saute Ê»Alepea
ğŸ‡¸ğŸ‡§	fuka, fuka: Ê»Otumotu Solomone
ğŸ‡¸ğŸ‡¨	fuka, fuka: Ê»Otumotu Seiseli
ğŸ‡¸ğŸ‡©	fuka, fuka: SÅ«teni
ğŸ‡¸ğŸ‡ª	fuka, fuka: SuÄ“teni
ğŸ‡¸ğŸ‡¬	fuka, fuka: Singapoa
ğŸ‡¸ğŸ‡­	fuka, fuka: SÄ Helena
ğŸ‡¸ğŸ‡®	fuka, fuka: SilÅvenia
ğŸ‡¸ğŸ‡¯	fuka, fuka: SivolopÄti mo Sani Maieni
ğŸ‡¸ğŸ‡°	fuka, fuka: SilÅvakia
ğŸ‡¸ğŸ‡±	fuka, fuka: Siela Leone
ğŸ‡¸ğŸ‡²	fuka, fuka: SÄ Malino
ğŸ‡¸ğŸ‡³	fuka, fuka: Senekalo
ğŸ‡¸ğŸ‡´	fuka, fuka: SÅmalia
ğŸ‡¸ğŸ‡·	fuka, fuka: Suliname
ğŸ‡¸ğŸ‡¸	fuka, fuka: SÅ«tani fakatonga
ğŸ‡¸ğŸ‡¹	fuka, fuka: Sao TomÄ“ mo Pilinisipe
ğŸ‡¸ğŸ‡»	fuka, fuka: Ê»Ele Salavatoa
ğŸ‡¸ğŸ‡½	fuka, fuka: SÄ MÄtini (fakahÅlani)
ğŸ‡¸ğŸ‡¾	fuka, fuka: SÄ«lia
ğŸ‡¸ğŸ‡¿	fuka, fuka: Suasilani
ğŸ‡¹ğŸ‡¦	fuka, fuka: Tulisitani ta Kunuha
ğŸ‡¹ğŸ‡¨	fuka, fuka: Ê»Otumotu Tuki mo Kaikosi
ğŸ‡¹ğŸ‡©	fuka, fuka: SÄti
ğŸ‡¹ğŸ‡«	fuka, fuka: Potu fonua tonga fakafalanisÄ“
ğŸ‡¹ğŸ‡¬	fuka, fuka: Toko
ğŸ‡¹ğŸ‡­	fuka, fuka: Tailani
ğŸ‡¹ğŸ‡¯	fuka, fuka: Tasikitani
ğŸ‡¹ğŸ‡°	fuka, fuka: Tokelau
ğŸ‡¹ğŸ‡±	fuka, fuka: Timoa hahake
ğŸ‡¹ğŸ‡²	fuka, fuka: TÅ«kimenisitani
ğŸ‡¹ğŸ‡³	fuka, fuka: TunÄ«sia
ğŸ‡¹ğŸ‡´	fuka, fuka: Tonga
ğŸ‡¹ğŸ‡·	fuka, fuka: Toake
ğŸ‡¹ğŸ‡¹	fuka, fuka: Tilinitati mo Topako
ğŸ‡¹ğŸ‡»	fuka, fuka: TÅ«valu
ğŸ‡¹ğŸ‡¼	fuka, fuka: Taiuani
ğŸ‡¹ğŸ‡¿	fuka, fuka: TenisÄnia
ğŸ‡ºğŸ‡¦	fuka, fuka: Ê»ÅªkalaÊ»ine
ğŸ‡ºğŸ‡¬	fuka, fuka: Ê»IukanitÄ
ğŸ‡ºğŸ‡²	fuka, fuka: Ê»Otumotu siÊ»i Ê»o Ê»Amelika
ğŸ‡ºğŸ‡³	fuka, fuka: Ê»Åª fonua fakatahataha
ğŸ‡ºğŸ‡¸	fuka, fuka: PuleÊ»anga fakatahataha Ê»Amelika
ğŸ‡ºğŸ‡¾	fuka, fuka: Ê»Ulukuai
ğŸ‡ºğŸ‡¿	fuka, fuka: Ê»Usipekitani
ğŸ‡»ğŸ‡¦	fuka, fuka: Kolo Vatikani
ğŸ‡»ğŸ‡¨	fuka, fuka: SÄ Viniseni mo Kulenatini
ğŸ‡»ğŸ‡ª	fuka, fuka: Venesuela
ğŸ‡»ğŸ‡¬	fuka, fuka: Ê»Otumotu Vilikini fakapilitÄnia
ğŸ‡»ğŸ‡®	fuka, fuka: Ê»Otumotu Vilikini fakaÊ»amelika
ğŸ‡»ğŸ‡³	fuka, fuka: Vietinami
ğŸ‡»ğŸ‡º	fuka, fuka: Vanuatu
ğŸ‡¼ğŸ‡«	fuka, fuka: Ê»Uvea mo Futuna
ğŸ‡¼ğŸ‡¸	fuka, fuka: HaÊ»amoa
ğŸ‡½ğŸ‡°	fuka, fuka: KÅsovo
ğŸ‡¾ğŸ‡ª	fuka, fuka: Iemeni
ğŸ‡¾ğŸ‡¹	fuka, fuka: Maiote
ğŸ‡¿ğŸ‡¦	fuka, fuka: Ê»Afilika tonga
ğŸ‡¿ğŸ‡²	fuka, fuka: Semipia
ğŸ‡¿ğŸ‡¼	fuka, fuka: Simipapuei
ğŸ»	faÊ»ahinga 1â€“2, hinehina, kili, kili hinehina
ğŸ¼	faÊ»ahinga 3, kelokelo, kili, kili kelokelo
ğŸ½	faÊ»ahinga 4, kili, kili melomelo, melomelo
ğŸ¾	faÊ»ahinga 5, kili, kili melomelo-Ê»uliÊ»uli, melomelo, Ê»uliÊ»uli
ğŸ¿	faÊ»ahinga 6, kili, kili Ê»uliÊ»uli, Ê»uliÊ»uli
